
cancer risk	alcohol intake
irritation	chemotherapy
cancer risk	smoking
risk	diet soda
amino acids	aging
risks	diagnostic
meat intake	infertility
inflammation	depression
meat molecule	inflammation
inflammatory reaction	egg
toxin	alzheimer
disability	heart disease
cancer risk	veganism
pain	drugs
eating nuts	ldl
fish intake	brain
lead poisoning	ayurvedic
eggs	diabetes risk
increased risk	dairy intake
eating eggs	cholesterol levels
risks	iron supplements
cancer mortality	poultry exposure
risk	iron supplements
death	nut consumption
stomach cancer	salt intake
tea	blood pressure
intake	ldl-cholesterol
rosy glow	cardiovascular health
fat	prevotella
vegans	cancer risk
disorder	gluten intolerance
disease risk	obesity
glaucoma risk	carrot consumption