
upload	upload
leucocythemia	leucocythemia
stents	stent
passionateness	passionateness
shooting	shooting
pollution	pollution
tranquilizer	tranquilizer
sprouting	sprout
tea	tea
drunk	drunk
orthopedic	orthopedic
metabolomics	metabolomic
goji	goji
energy	energy
cdc	cdc
oncovirinae	oncovirinae
ibuprofen	ibuprofen
housefly	housefly
celebrator	celebrator
vegetarianism	vegetarianism
leucocythemias	leucocythemia
magnecyl	magnecyl
rachitis	rachitis
hand-picked	hand-picked
berberi	berberi
nitroglyn	nitroglyn
czechoslovakia	czechoslovakia
telling	tell
squatting	squat
authenticate	authenticate
diferuloylmethane	diferuloylmethane
quick-pep	quick-pep
gold	gold
synergist	synergist
dieticians	dietician
tgi	tgi
apoplexy	apoplexy
synergism	synergism
dehydrogenases	dehydrogenase
commission	commission
durazolam	durazolam
lunchtime	lunchtime
salt	salt
fragaria	fragaria
lymphomas	lymphoma
metformin	metformin
blood	blood
indigestibleness	indigestibleness
health-aarp	health-aarp
biometals	biometal
microtus	microtus
exciting	exciting
purslanes	purslane
commentation	commentation
illness-free	illness-free
rapamycin	rapamycin
straining	strain
neurosteroids	neurosteroid
blogs	blog
excitatory	excitatory
preterm	preterm
pigs	pig
pregnanacy	pregnanacy
antiperspirant	antiperspirant
sweetens	sweeten
peppermint	peppermint
pyrosis	pyrosis
harm	harm
isoglucose	isoglucose
mesotheliomas	mesothelioma
neugc	neugc
harp	harp
radioisotopes	radioisotope
seedman	seedman
swishing	swish
salting	salt
root	root
salami	salami
acetysal	acetysal
sphincter	sphincter
hesperitin	hesperitin
cachectin	cachectin
parencephalon	parencephalon
verruca	verruca
gojis	gojis
overeating	overeat
embanox	embanox
cancer	cancer
imc-c225	imc-c225
antihistamine	antihistamine
mammalia	mammalia
arsenate	arsenate
c-section	c-section
pile	pile
tma	tma
willet	willet
pill	pill
acamol	acamol
signatures	signature
cobalamin	cobalamin
flashing	flash
lav-htlv-iii	lav-htlv-iii
hungriness	hungriness
hate	hate
intropin	intropin
dinners	dinner
sertraline	sertraline
africanisation	africanisation
ceylon	ceylon
cytoskeleton	cytoskeleton
angiogenesis	angiogenesis
pasteurizations	pasteurization
traveling	travel
indonesia	indonesia
tnf	tnf
sodas	soda
radiations	radiation
cords	cord
pyroses	pyrose
polysorbates	polysorbate
cma	cma
kempner	kempner
granularity	granularity
cancers	cancer
nightclubs	nightclub
suidae	suidae
vaccination	vaccination
women	woman
woman	woman
remid	remid
venoms	venom
miscarriages	miscarriage
enliven	enliven
syndrome	syndrome
tor	tor
adenoviruses	adenovirus
antiangiogenesis	antiangiogenesis
toy	toy
gamma-hexachlorocyclohexane	gamma-hexachlorocyclohexane
cnn	cnn
vaccinating	vaccinate
drugs	drug
lunchmeat	lunchmeat
apo-dimenhydrinate	apo-dimenhydrinate
cod	cod
pima	pima
rose	rise
rosa	rosa
osteoarthritides	osteoarthritide
piglets	piglet
rooting	root
findings	finding
cow	cow
clathrotropis	clathrotropis
bruise	bruise
tegaserod	tegaserod
abilities	ability
bellis	bellis
microwaving	microwave
yersinia	yersinia
sneaky	sneaky
spermidine	spermidine
hominids	hominid
subscript	subscript
cpt	cpt
ici46474	ici46474
christmas	christmas
rheum	rheum
dannon	dannon
buckwheat	buckwheat
gout	gout
normalities	normality
metabolism	metabolism
calendula	calendula
acidic	acidic
braeburn	braeburn
eco-atkin	eco-atkin
probiotics	probiotic
endocannabinoid	endocannabinoid
chicken	chicken
childbirth	childbirth
trustfulness	trustfulness
sorrel	sorrel
bloat	bloat
fibromyomas	fibromyoma
metabolite	metabolite
salads	salad
half-pound	half-pound
muscle	muscle
deglutition	deglutition
alendronate	alendronate
jelly	jelly
chlorination	chlorination
colonoscopy	colonoscopy
specializer	specializer
ammunition	ammunition
condyle	condyle
electroencephalography	electroencephalography
disorientation	disorientation
k-casein	k-casein
oregano	oregano
surgeries	surgery
inspector	inspector
porcini	porcinus
fuhrman	fuhrman
sensuous	sensuous
fatter	fatter
pineapple	pineapple
legume	legume
cck-33	cck-33
n-dimethylethylamine	n-dimethylethylamine
clamor	clamor
eire	eire
impatience	impatience
adventists	adventist
sandwichman	sandwichman
horsenettle	horsenettle
esophagus	esophagus
herbalife	herbalife
teresa	teresa
neuron	neuron
tum	tum
crabapples	crabapple
rousettus	rousettus
hamsters	hamster
7-epi-taxol	7-epi-taxol
huntington	huntington
palsy	palsy
soreness	soreness
semi-vegetarians	semi-vegetarian
genes	gene
food-poisoning	food-poisoning
tvp	tvp
creatine	creatine
gargling	gargle
volunteerism	volunteerism
lizardfish	lizardfish
shots	shot
gerontotoxin	gerontotoxin
cup	cup
smam-1	smam-1
afzelia	afzelia
masculinity	masculinity
acephen	acephen
thrombus	thrombus
toronjas	toronja
teat	teat
celery	celery
tear	tear
barbequing	barbeque
fibromyalgia	fibromyalgia
teas	tea
attack	attack
micronase	micronase
ossification	ossification
patinopecten	patinopecten
talapia	talapia
ingredient	ingredient
donating	donate
pimpinella	pimpinella
plasticisation	plasticisation
services	service
lignans	lignan
marketing	marketing
cricetinae	cricetinae
speech	speech
watch	watch
ephedra	ephedra
comatose	comatose
triacylglycerols	triacylglycerol
pimenta	pimenta
dopamine	dopamine
acne-promoting	acne-promoting
thigh	thigh
caucasian	caucasian
2-thiol-l-histidine-betaine	2-thiol-l-histidine-betaine
fosamax	fosamax
campylobacter	campylobacter
manor	manor
amends	amends
croakers	croaker
staph	staph
deception	deception
holidays	holiday
dying	die
pneumonias	pneumonia
dwarfism	dwarfism
hypoesthesia	hypoesthesia
donation	donation
non-vegetarians	non-vegetarian
shoot	shoot
diverticula	diverticula
abbess	abbess
familiarise	familiarise
levotryptophan	levotryptophan
c225	c225
spearmints	spearmint
constipate	constipate
gooseberry	gooseberry
diaphragm	diaphragm
cellcristin	cellcristin
pervading	pervade
tnf-alpha	tnf-alpha
belladonnas	belladonna
toxaphene	toxaphene
systolic	systolic
rashness	rashness
dyslipidemia	dyslipidemia
work-site	work-site
aubergine	aubergine
familiarisation	familiarisation
memory	memory
pecans	pecan
netus	netus
teff	teff
farmers	farmer
cooked-meat	cooked-meat
sleeplessness	sleeplessness
naturruhe	naturruhe
currants	currant
squashes	squash
stare	stare
plantaglucide	plantaglucide
stari	stari
progens	progen
cannery	cannery
megacolon	megacolon
synflex	synflex
epifrin	epifrin
philipines	philipine
paralyzation	paralyzation
stars	star
teen	teen
lifestyle	lifestyle
sinusitides	sinusitide
bypass	bypass
conveniences	convenience
mangifera	mangifera
recipient	recipient
low-calorie	low-calorie
turmeric	turmeric
nitrong	nitrong
mcdougall	mcdougall
meateater	meateater
oestrogenic	oestrogenic
dasheen	dasheen
cytoprotectant	cytoprotectant
legumes	legume
nicety	nicety
physicians'	physician
enteramine	enteramine
candies	candy
foenumgraecums	foenumgraecum
lifeguard	lifeguard
antinutrient	antinutrient
golden	golden
presyncopes	presyncope
eragrostis	eragrostis
phthalates	phthalate
steroid	steroid
vomiting	vomit
flowers	flower
dates	date
thyroidal	thyroidal
grouping	group
omega	omega
lemmings	lemming
analog	analog
absorptance	absorptance
broccomax	broccomax
detoxifying	detoxify
susadrin	susadrin
nasalisation	nasalisation
remissness	remissness
odontoclasts	odontoclast
psidium	psidium
trigylcerides	trigylceride
nih-aarp	nih-aarp
servings-a-day	servings-a-day
dose-response	dose-response
frier	frier
fries	fries
lethicin	lethicin
tahinus	tahinus
celebrater	celebrater
ultrapasteurizations	ultrapasteurization
adhesives	adhesive
bagels	bagel
cyanophyceae	cyanophyceae
dimedrol	dimedrol
asthmas	asthma
diamorf	diamorf
rachitides	rachitide
coconuts	coconut
aphthae	aphthae
reflexology	reflexology
tell	tell
sski	sski
3'r-zeaxanthin	3
purgation	purgation
counselling	counsel
nitrospan	nitrospan
luteolin	luteolin
agaves	agave
drinking	drinking
anus	anus
socks	sock
analogously	analogously
sesamums	sesamum
cloves	clove
water	water
quinine	quinine
semenogelase	semenogelase
pureduct	pureduct
raisins	raisin
apples	apple
bacteroide	bacteroide
canadians	canadian
sugar-sweetened	sugar-sweetened
triphala	triphala
titanium	titanium
reactor	reactor
mammotropin	mammotropin
inuits	inuit
kidneys	kidney
4-(1-hydroxy-2-(methylamino)ethyl)-1	4
parasitosis	parasitosis
pesticides	pesticide
fiber-eating	fiber-eating
sprains	sprain
subsidization	subsidization
therapy	therapy
toxoplasma	toxoplasma
heterocyclic	heterocyclic
hypercholesteremias	hypercholesteremia
ephedras	ephedras
ddt	ddt
tonga	tonga
superoxide	superoxide
powerhouse	powerhouse
alphadine	alphadine
sunchoke	sunchoke
pharmaceutics	pharmaceutic
tannings	tanning
11-epicortisol	11-epicortisol
des	des
strep	strep
nitro-dur	nitro-dur
lyphan	lyphan
cube	cube
listeria	listeria
quinbisul	quinbisul
foeniculums	foeniculum
shock	shock
graining	graining
pancake	pancake
paralysis	paralysis
adulthood	adulthood
atkin	atkin
cortisol	cortisol
flakes	flake
entrées	entrées
dulse	dulse
l-carnosine	l-carnosine
areca	areca
reassured	reassure
treatment	treatment
diazepam	diazepam
onxol	onxol
anacin3	anacin3
citations	citation
brag	brag
hydrogenisation	hydrogenisation
allopurinol	allopurinol
dha	dha
cesium	cesium
serviceableness	serviceableness
withdrawing	withdraw
chestnut	chestnut
betadine	betadine
amaranth	amaranth
lymphocyte	lymphocyte
lipid-lowering	lipid-lowering
abelmoschus	abelmoschus
brca	brca
portulacas	portulaca
huntingtons	huntington
therapeutics	therapeutics
thiomersalate	thiomersalate
tolerant	tolerant
not-necessarily-so-healthy	not-necessarily-so-healthy
xray	xray
farmworkers	farmworker
celeriac	celeriac
latex	latex
fineness	fineness
fruition	fruition
livestock	livestock
thiamine	thiamine
nonsmoker	nonsmoker
massager	massager
postmenopause	postmenopause
digestibility	digestibility
pulsing	pulse
angioplasty	angioplasty
computational	computational
cdcp	cdcp
ssri	ssri
groundbreak	groundbreak
anise	anise
autoimmune	autoimmune
applebee	applebee
urticarias	urticarias
chamomiles	chamomile
grape	grape
retinaldehyde	retinaldehyde
blinder	blinder
fruiting	fruit
graph	graph
misleading	mislead
sodium	sodium
statin	statin
freezer	freezer
onkocristin	onkocristin
antidiabetic	antidiabetic
reticulosarcoma	reticulosarcoma
anesthetize	anesthetize
fluorosis	fluorosis
vegetate	vegetate
dicrostonyx	dicrostonyx
cancer-promoting	cancer-promoting
sunchokes	sunchoke
bach	bach
looper	looper
optics	optics
anti-cancer	anti-cancer
proxen	proxen
pound	pound
paleo	paleo
billions	billion
prolactin	prolactin
relax	relax
raftered	rafter
milisucre	milisucre
phillippines	phillippine
mustards	mustard
elettaria	elettaria
non-vegetarian	non-vegetarian
baby	baby
diospyro	diospyro
blossoms	blossom
uteri	uteri
colfarit	colfarit
thioneine	thioneine
dmh	dmh
upcoming	upcome
lunch	lunch
bacteriophages	bacteriophage
ananas	ananas
paraosmias	paraosmia
uterus	uterus
workplaces	workplace
dna	dna
lying	lie
bioavailabilities	bioavailability
beverages	beverage
ecotrin	ecotrin
butyrates	butyrate
dnp	dnp
texa	texa
brew	brew
curry	curry
retinopathy	retinopathy
hostacyclin	hostacyclin
dysosmias	dysosmia
doc	doc
partially-hydrogenated	partially-hydrogenated
dog	dog
arteriographies	arteriography
gamma-imido-atp	gamma-imido-atp
contaminants	contaminant
hypoxemia	hypoxemia
don	don
4-benzodiazepin-2-one	4-benzodiazepin-2-one
familiarity	familiarity
broth	broth
dos	do
stamp	stamp
manias	mania
coleslaw	coleslaw
3,4-methylenedioxyamphetamine	3,4-methylenedioxyamphetamine
iodization	iodization
silencer	silencer
cholesterol-lowering	cholesterol-lowering
brewery	brewery
superbug	superbug
dwarf	dwarf
garbanzos	garbanzo
cervixes	cervix
cigarette	cigarette
octopoda	octopoda
listerine	listerine
myths	myth
2-bis(p-chlorophenyl)ethane	2-bis
cabbages	cabbage
computation	computation
singapore	singapore
levopa	levopa
zeranol	zeranol
microdialysis	microdialysis
fortifying	fortify
toxicants	toxicant
vidine	vidine
colitis	colitis
pyrus	pyrus
anisakis	anisakis
amauroses	amaurose
vldl	vldl
tabouli	taboulus
bumped	bump
strawberries	strawberry
lungs	lung
stickers	sticker
grain	grain
oxygen	oxygen
petroleums	petroleum
cholesterol/heart	cholesterol/heart
phosphorus	phosphorus
estragole	estragole
lanoxin-pg	lanoxin-pg
streak	streak
uti	uti
picking	pick
numb	numb
exanthem	exanthem
mutagenic	mutagenic
diabetics	diabetic
nutate	nutate
poisoner	poisoner
light-headedness	light-headedness
bumper	bumper
vaginitis	vaginitis
cantaloupe	cantaloupe
veterans	veteran
bivalvias	bivalvia
ici47699	ici47699
glyburide	glyburide
necks	neck
monkfish	monkfish
ball	ball
halflifes	halflife
smoking	smoking
gerontotoxins	gerontotoxin
squashe	squashe
paradox	paradox
cups	cup
retailing	retailing
mania	mania
reguval	reguval
hardcore	hardcore
work-from-home	work-from-home
winnings	winnings
mango	mango
dub	dub
nicotiana	nicotiana
jibe	jibe
wy-4036	wy-4036
celeries	celery
pumpkin	pumpkin
nuns	nun
leguminosae	leguminosae
happier	happier
dvd	dvd
weight-reducing	weight-reducing
seitan	seitan
cholesterol	cholesterol
orbit	orbit
phosphoric	phosphoric
zingerone	zingerone
metabolife	metabolife
iceman	iceman
lymphocytes	lymphocyte
juiciness	juiciness
singing	singing
hamster	hamster
euterpe	euterpe
endometriosis	endometriosis
balm	balm
platelets	platelet
meat-induced	meat-induced
revatio	revatio
maguey	maguey
dexitac	dexitac
mastectomies	mastectomy
hiziki	hiziki
exercitation	exercitation
roundup	roundup
mao-a	mao-a
seizure	seizure
macropus	macropus
alzheimer's	alzheimer
herbalism	herbalism
quinbisan	quinbisan
scan	scan
scam	scam
cute	cute
fragmentation	fragmentation
thyme	thyme
landfill	landfill
secale	secale
cacaos	cacao
kappa-carrageenan	kappa-carrageenan
womb	womb
beeturia	beeturia
workers	worker
mao-b	mao-b
synucleins	synuclein
polymyositides	polymyositide
childhood	childhood
star	star
sticker	sticker
cardiovascular	cardiovascular
dye	dye
gingerols	gingerol
paxene	paxene
disoriented	disoriented
low-dose	low-dose
aleuts	aleut
apaurin	apaurin
mrsa	mrsa
treat	treat
wool	wool
agent	agent
abortion	abortion
starving	starve
glaucoma	glaucoma
neurons	neuron
sealer	sealer
dynasty	dynasty
loop	loop
3r	3r
kiwifruit	kiwifruit
3s	3
seeds	seed
addicts	addict
segmentectomy	segmentectomy
dehydroisoandrosterone	dehydroisoandrosterone
vioxx	vioxx
quinoa	quinoa
bronchiolitis	bronchiolitis
ractopamine	ractopamine
thyroid	thyroid
nuts	nut
lymphocytic	lymphocytic
nitrobid	nitrobid
expec	expec
bats	bat
apple	apple
chlorella	chlorella
downloads	download
arteriography	arteriography
nuloraz	nuloraz
twin	twin
cadaverine	cadaverine
placentome	placentome
winning	win
steamer	steamer
organoleptic	organoleptic
starved	starve
undaria	undaria
antidepressants	antidepressant
chlordelazine	chlordelazine
formula	formula
stem	stem
swabbing	swab
gargle	gargle
goitrogens	goitrogen
liposuctions	liposuction
stomacher	stomacher
peanuts	peanut
kombucha	kombucha
colibacillosis	colibacillosis
loss	loss
lorazepam-ratiopharm	lorazepam-ratiopharm
humoring	humor
workforce	workforce
gamma-666	gamma-666
flavourous	flavourous
4-butanediamine	4-butanediamine
methylphenidate	methylphenidate
worm	worm
dizzy	dizzy
cucurbitas	cucurbita
spoiling	spoil
microparticles	microparticle
coronaries	coronary
wort	wort
diospyros	diospyro
flavorful	flavorful
lemonoids	lemonoid
irritating	irritating
tinted	tint
prevotella	prevotella
fibrosis	fibrosis
1-methyl-4-phenyl-1	1-methyl-4-phenyl-1
anti-smoking	anti-smoking
rickets	rickets
scfa	scfa
solupsan	solupsan
macro-autophagies	macro-autophagy
love	love
bantu	bantu
concerta	concerta
n-hexacosanol	n-hexacosanol
fryer	fryer
nerveous	nerveous
pimiento	pimiento
hominini	homininus
bellacarotin	bellacarotin
ear	ear
impotence	impotence
açai	açai
taufon	taufon
tachigalia	tachigalia
blende	blende
sperm	sperm
hominins	hominin
immunisation	immunisation
juice	juice
glycyrrhiza	glycyrrhiza
whiteness	whiteness
degenerate	degenerate
implantation	implantation
weakling	weakling
soldier	soldier
cubes	cube
ebv	ebv
mn-sod	mn-sod
all-trans-retinol	all-trans-retinol
hospitals	hospital
twinkie	twinkie
pneumonitis	pneumonitis
formulas	formula
post-menopause	post-menopause
worksites	worksite
octopuses	octopus
defendant	defendant
portfolio	portfolio
tisane	tisane
mayo	mayo
veg	veg
hunter	hunter
stomachic	stomachic
irritability	irritability
electrodes	electrode
urtias	urtias
anti-inflammation	anti-inflammation
pentastomidas	pentastomida
cavity	cavity
neuromodulator	neuromodulator
endometrioses	endometriose
pathogen	pathogen
maté	maté
acetamidophenol	acetamidophenol
fibroses	fibrose
reticulolymphosarcomas	reticulolymphosarcoma
eec	eec
eeg	eeg
porphyra	porphyra
blood-letting	blood-letting
cyp19	cyp19
conspirative	conspirative
nitrocard	nitrocard
tetocid	tetocid
cubist	cubist
retina	retina
foenumgraecum	foenumgraecum
horsemeat	horsemeat
cubism	cubism
macular	macular
billberry	billberry
kimchi	kimchi
roselles	roselle
watering	water
gravy	gravy
uproot	uproot
açaí	açaí
horsebean	horsebean
interleukin-1	interleukin-1
egg	egg
donix	donix
optimax	optimax
dhea	dhea
peeing	pee
anti-fever	anti-fever
anguish	anguish
refraction	refraction
camomiles	camomile
waistline	waistline
pectin	pectin
25mg/kg	25mg/kg
dehydration	dehydration
cheerios	cheerio
silence	silence
oncoviruses	oncovirus
carbohydrates	carbohydrate
vincristine	vincristine
veggy	veggy
nine-gram	nine-gram
conundrum	conundrum
packet	packet
dyes	dye
dyer	dyer
cocoa	cocoa
end-of-year	end-of-year
jellybeans	jellybean
topectomies	topectomy
ursus	ursus
adolescence	adolescence
gerson	gerson
cocos	coco
whortleberries	whortleberry
pithecellobium	pithecellobium
boston	boston
cumins	cumin
weight-loss	weight-loss
amyloidosis	amyloidosis
centrum	centrum
peaches	peach
bacteroid	bacteroid
amentias	amentia
sensitizer	sensitizer
lactating	lactating
clamorous	clamorous
too-good-to-be-true	too-good-to-be-true
beta-alanylhistidine	beta-alanylhistidine
eyeballs	eyeball
taxol	taxol
sprite	sprite
latices	latex
pediculi	pediculi
computers	computer
nomads	nomad
paclitaxel	paclitaxel
brands	brand
case-control	case-control
density	density
antidepressant	antidepressant
pineapples	pineapple
toothpastes	toothpaste
neck	neck
infertility	infertility
atrophies	atrophy
mealtime	mealtime
bologna	bologna
tearing	tear
nitroderm	nitroderm
feathering	feather
migraines	migraine
choleras	cholera
l-glucose	l-glucose
affordability	affordability
assessment	assessment
neu5gc-rich	neu5gc-rich
nathan	nathan
donee	donee
florist	florist
faint	faint
leucine	leucine
ellagic	ellagic
mycotoxin	mycotoxin
apap	apap
meteors	meteor
guideline	guideline
nazism	nazism
concordance	concordance
tadpoles	tadpole
kb-53	kb-53
amyloidoses	amyloidose
agaricales	agaricale
beta-caroten-3-ol	beta-caroten-3-ol
sleeping	sleep
cheering	cheer
steviol	steviol
sarcocystis	sarcocystis
melqx	melqx
complainer	complainer
papaveretum	papaveretum
bullet	bullet
oncogens	oncogen
bone-softening	bone-softening
flavonol	flavonol
ultrapasteurization	ultrapasteurization
ritaline	ritaline
hb-420	hb-420
slippery	slippery
semi-vegetarian	semi-vegetarian
environment	environment
lanoxicaps	lanoxicap
synthase	synthase
airplane	airplane
aubergines	aubergine
platelet	platelet
endocannabinoids	endocannabinoid
hb-419	hb-419
autophagies	autophagy
vasovagal	vasovagal
airsickness	airsickness
cannibalization	cannibalization
mammalgia	mammalgia
spice-eaters	spice-eater
happinesses	happiness
skinned	skin
epa	epa
neurocysticercosis	neurocysticercosis
hashishs	hashish
firmicutes	firmicute
agaricaceae	agaricaceae
hemocuprein	hemocuprein
polyarthralgia	polyarthralgia
digitize	digitize
non-smokers	non-smoker
disadine	disadine
vetoron	vetoron
zyma	zyma
trash-picker	trash-picker
jalapeno	jalapeno
alerts	alert
clocks	clock
apes	ape
aper	aper
genotoxic	genotoxic
5-androsten-3-beta-hydroxy-17-one	5-androsten-3-beta-hydroxy-17-one
trompillos	trompillo
nutriceutical	nutriceutical
saffron	saffron
singer	singer
cell	cell
propaphenin	propaphenin
malaya	malaya
hypericum	hypericum
adult-onset	adult-onset
acylpyrin	acylpyrin
shark	shark
television	television
techno	techno
alpha-gal	alpha-gal
neurotoxins	neurotoxin
stevias	stevia
zeaxanthin	zeaxanthin
milkshake	milkshake
ovary	ovary
tremarctos	tremarcto
hemorrhoids	hemorrhoid
skeletonization	skeletonization
zepri	zepri
penicillins	penicillin
birthing	birthing
hemorrhage	hemorrhage
flier	flier
disorienting	disorient
spinach	spinach
shake	shake
dinnertimes	dinnertime
spice	spice
screen	screen
degradation	degradation
psychosis	psychosis
crataegus	crataegus
acetildenafil	acetildenafil
saturation	saturation
absorbency	absorbency
updating	update
rosehip	rosehip
digitization	digitization
hiccough	hiccough
feminizations	feminization
shaky	shaky
keynote	keynote
bookplates	bookplate
lopurin	lopurin
bagging	bag
spicy	spicy
pancakes	pancake
breasts	breast
lipomuls	lipomul
weren	weren
psychopharmaceuticals	psychopharmaceutical
amino	amino
endostatins	endostatin
nutraceuticals	nutraceutical
adipocyte	adipocyte
habited	habit
1-trichloro-2	1-trichloro-2
engorgement	engorgement
amine	amine
iga2	iga2
iga1	iga1
greening	greening
elderly	elderly
ad-36	ad-36
dreams	dream
milligrams	milligram
trick	trick
antioxidative	antioxidative
digestibleness	digestibleness
running	run
telomerase	telomerase
vodka	vodka
xeranol	xeranol
illiciums	illicium
pro-vegetarian	pro-vegetarian
twinning	twin
peppers	pepper
rabies	rabies
pounding	pound
autism	autism
complying	comply
bulging	bulge
appetite	appetite
2,2'-dipyridyl	2,2
hiatus	hiatus
sp(1-11)	sp
orgasms	orgasm
psychoses	psychosis
amaurosis	amaurosis
dyeing	dye
clethrionomys	clethrionomy
linseed	linseed
pounds	pound
herpesvirus	herpesvirus
pvp-iodines	pvp-iodine
chemicals	chemical
microparticle	microparticle
canderel	canderel
larodopa	larodopa
adolescents	adolescent
polyphagia	polyphagia
sustenance	sustenance
datril	datril
eye	eye
nutritionist	nutritionist
alkalize	alkalize
triacylglycerol	triacylglycerol
hydroxytryptamine	hydroxytryptamine
journalists	journalist
taxman	taxman
angiography	angiography
beverage	beverage
cappari	cappari
stesolid	stesolid
half-vegan	half-vegan
neti	netus
scaling	scale
horror	horror
livers	liver
apoe	apoe
gras	gras
callerya	callerya
stone-forming	stone-forming
diagnostics	diagnostic
spinally	spinally
alactasia	alactasia
monocyte	monocyte
whitening/brightening	whitening/brightening
incorporation	incorporation
charts	chart
sterility	sterility
okras	okra
arterialise	arterialise
sweetening	sweeten
u.s.there	u.s.there
neurocysticercoses	neurocysticercose
radicalism	radicalism
grapefruit	grapefruit
madoera	madoera
balsalmic	balsalmic
specialness	specialness
morinda	morinda
carotid	carotid
coronary	coronary
phytosteroids	phytosteroid
antacid	antacid
insomnias	insomnia
raab	raab
zacin	zacin
underweight	underweight
bilophila	bilophila
myelopathy	myelopathy
acetaminophen	acetaminophen
enema	enema
celtic	celtic
endorphins	endorphin
poppies	poppy
shelf-life	shelf-life
ssri's	ssri
acid-binding	acid-binding
yellowness	yellowness
safflower	safflower
lupus	lupus
button	button
hummus	hummus
microbiomes	microbiome
iodation	iodation
overtrain	overtrain
leiomyoma	leiomyoma
pseudoaphakias	pseudoaphakia
sedoval	sedoval
androtop	androtop
news	news
green	green
paleolithic	paleolithic
hives	hive
grained	grain
contamination	contamination
sensation	sensation
calm-x	calm-x
israel	israel
african	african
leafy	leafy
athletics	athletics
melatonin	melatonin
auras	aura
glucitol	glucitol
play	play
molecularly	molecularly
plaything	plaything
lanacordin	lanacordin
mesquites	mesquite
bluefish	bluefish
raft	raft
taxes	tax
humorousness	humorousness
packets	packet
fat	fat
portobello	portobello
usepa	usepa
petting	petting
seeder	seeder
refractive	refractive
suicide	suicide
applesauce	applesauce
dyerberg	dyerberg
rubberplant	rubberplant
suppers	supper
tranquility	tranquility
chocolate	chocolate
tnfalpha	tnfalpha
dilanacin	dilanacin
cassias	cassia
portion	portion
algae	algae
fever	fever
nanomole	nanomole
pop-tart	pop-tart
algal	algal
supermarket	supermarket
receiving	receive
amphetamine-like	amphetamine-like
leaky	leaky
tragic	tragic
physician	physician
biomagnification	biomagnification
neurotransmitter	neurotransmitter
burner	burner
honeys	honey
microcystin	microcystin
cervix	cervix
fda	fda
aromatase	aromatase
pcdes	pcde
vegan	vegan
acetaco	acetaco
hiatal	hiatal
circumference	circumference
finalize	finalize
mangos	mango
catfishes	catfish
intestines	intestine
grille	grille
stuff	stuff
petrogale	petrogale
7-trimethylxanthine	7-trimethylxanthine
faustan	faustan
booking	book
monkey	monkey
aricept	aricept
disability	disability
corylus	corylus
malignant	malignant
phaseolus	phaseolus
n-methyl-4-phenyl-1	n-methyl-4-phenyl-1
foie	foie
snacks	snack
thankfully	thankfully
puberties	puberty
contaminative	contaminative
spermatozoon	spermatozoon
strain	strain
habitue	habitue
hunt	hunt
alkaline	alkaline
laugher	laugher
computable	computable
nutrition	nutrition
cereal	cereal
lactation	lactation
producer	producer
stevioside	stevioside
sugar	sugar
hypercholesteremia	hypercholesteremia
heteropneustes	heteropneuste
glyconutrient	glyconutrient
who	who
whr	whr
popping	pop
pacemaker	pacemaker
cyclamates	cyclamate
tweens	tween
drinks	drink
bursine	bursine
defecations	defecation
scallion	scallion
gluten-free	gluten-free
berberine	berberine
colitides	colitide
anti-aging	anti-aging
adhatoda	adhatoda
damned	damned
polyarthritides	polyarthritide
cashier	cashier
doppler	doppler
squatness	squatness
peanut	peanut
diet	diet
tranquilization	tranquilization
win	win
β-casomorphin	β-casomorphin
butter	butter
graphitisation	graphitisation
mcfas	mcfa
azarcon	azarcon
a1	a1
a2	a2
oyster	oyster
bacteroides	bacteroide
piggery	piggery
deformity	deformity
headache	headache
fib	fib
gala	gala
fig	fig
arteries	artery
low-fat	low-fat
amalika	amalika
calciferols	calciferol
venison	venison
magueys	maguey
b6	b6
cambodians	cambodian
neoplasias	neoplasia
finality	finality
teats	teat
astroglias	astroglia
eskimos	eskimo
ad	ad
aggressions	aggression
ah	ah
flavanols	flavanol
diff	diff
al	al
masers	maser
oxidant	oxidant
genitalium	genitalium
salsa	salsa
finalist	finalist
aleut	aleut
proxy	proxy
hypospadia	hypospadia
immortalise	immortalise
folksy	folksy
arvicolines	arvicoline
folk	folk
5-alpha	5-alpha
pancreatitis	pancreatitis
aspalathus	aspalathus
aleve	aleve
lunchtimes	lunchtime
exudation	exudation
excitable	excitable
appendicitis	appendicitis
virus	virus
d2	d2
d3	d3
refinery	refinery
cuttlefish	cuttlefish
leprosies	leprosy
bt	bt
fatigues	fatigue
selenium	selenium
sudden	sudden
residencies	residency
trickery	trickery
glibenclamide	glibenclamide
tooth	tooth
alzheimer	alzheimer
scoring	score
sanitizers	sanitizer
adreson	adreson
digitek	digitek
familiar	familiar
β-casomorphins	β-casomorphin
breathe	breathe
flu	flu
ct	ct
fly	fly
urate	urate
hepatotoxicity	hepatotoxicity
fennel	fennel
buddhist	buddhist
heatstroke	heatstroke
voter	voter
breaths	breath
neurobehavioral	neurobehavioral
sulforaphane	sulforaphane
epa/dha	epa/dha
propulcid	propulcid
epithelioma	epithelioma
schism	schism
soymilk	soymilk
fernandez	fernandez
larynx	larynx
adenylylimidodiphosphate	adenylylimidodiphosphate
pseudopleuronectes	pseudopleuronecte
attacks	attack
caregiver	caregiver
nutty	nutty
won	win
corpses	corpse
testoderm	testoderm
colonizer	colonizer
allspices	allspice
parturitions	parturition
eh	eh
aspartame	aspartame
elmo	elmo
chards	chard
foe	foe
arvicolinae	arvicolinae
salon	salon
bloating	bloat
pentastomida	pentastomida
tears	tear
dims	dim
whiff	whiff
h7	h7
oils	oils
alert	alert
pteropus	pteropus
overconsumption	overconsumption
dagynil	dagynil
emissions	emission
whiting	whiting
burgers	burger
mcfa	mcfa
pteropodidae	pteropodidae
shiitake	shiitake
acarbose	acarbose
cementoclasts	cementoclast
plop	plop
syrup	syrup
bleminol	bleminol
chewing	chew
fish-oil	fish-oil
rash	rash
endotenons	endotenon
starch	starch
tamsulosin	tamsulosin
germinoblastomas	germinoblastoma
jellybean	jellybean
feather	feather
tauphon	tauphon
meningiomatosis	meningiomatosis
transcription	transcription
masculinization	masculinization
piperine	piperine
micristin	micristin
lanoxin	lanoxin
zing	zing
apigen	apigen
ib	ib
cholecalciferol	cholecalciferol
portal	portal
zinc	zinc
prescriptions	prescription
raftman	raftman
limes	lime
chlamy	chlamy
iq	iq
gastroenterology	gastroenterology
fry	fry
iu	iu
criminus	criminus
bioenergetic	bioenergetic
lively	lively
delusions	delusion
supplement	supplement
anodes	anode
kalaallit	kalaallit
fsi	fsus
fetus	fetus
applebee's	applebee
noses	nose
clamorously	clamorously
erythroxylon	erythroxylon
subscription	subscription
grader	grader
oreganos	oregano
mono-jod	mono-jod
sparkling	sparkling
acetate	acetate
ftc	ftc
graded	grade
ability	ability
steatohepatitides	steatohepatitide
centenarians	centenarian
belling	bell
knew	know
oxidation	oxidation
quarter-teaspoon	quarter-teaspoon
knee	knee
patented	patented
cuminums	cuminum
atopic	atopic
prandase	prandase
veganism	veganism
lipocyte	lipocyte
lb	lb
lipotoxicity	lipotoxicity
estrogen-receptor	estrogen-receptor
plasticise	plasticise
rhinolophus	rhinolophus
patentee	patentee
cookbooks	cookbook
ll	ll
leukemia	leukemia
micrograms	microgram
ly	ly
cardamom	cardamom
cardamon	cardamon
www	www
apo-lorazepam	apo-lorazepam
picker	picker
ailuropoda	ailuropoda
mussels	mussel
tolerance	tolerance
porter	porter
oxidase	oxidase
plum	plum
mycobacterium	mycobacterium
primates	primate
blackness	blackness
ms	m
deep-fry	deep-fry
greenhouse	greenhouse
thai	thai
feeling	feeling
phisohex	phisohex
flyer	flyer
appetites	appetite
dream	dream
anorectal	anorectal
disc	disc
worrisome	worrisome
rays	ray
5-ht	5-ht
oxidate	oxidate
immortality	immortality
underarm	underarm
seal	seal
hydrogenate	hydrogenate
prozac	prozac
zits	zit
oj	oj
nettlesome	nettlesome
rescue	rescue
harmane	harmane
sports	sport
fructan	fructan
cookery	cookery
lunching	lunch
berberis	berberis
walnut	walnut
douchings	douching
dinate	dinate
ph	ph
maple	maple
pm	pm
sitting	sit
formol	formol
meningiomatoses	meningiomatose
kisser	kisser
pr	pr
pheasants	pheasant
salad	salad
supplementation	supplementation
convenience	convenience
hershey’s	hershey
expositive	expositive
instilling	instil
salmonella-positive	salmonella-positive
revulsion	revulsion
grouper	grouper
emission	emission
seminin	seminin
serotonin	serotonin
plasticize	plasticize
tongues	tongue
blending	blend
brand	brand
wyland	wyland
iq45b	iq45b
bronchiolitides	bronchiolitide
blindness	blindness
relapse	relapse
capers	caper
seat	seat
veggie	veggie
houseflies	housefly
seas	sea
re	re
placenta	placenta
gamma-seminoprotein	gamma-seminoprotein
commentary	commentary
sorbilax	sorbilax
belly	belly
confection	confection
seed	seed
skeletal	skeletal
cocoanut	cocoanut
zygout	zygout
cocas	coca
poisoning	poisoning
belle	belle
phage	phage
email	email
teenager	teenager
calendar	calendar
intern	intern
oxomethane	oxomethane
metabonomic	metabonomic
manful	manful
lavenders	lavender
sublingual	sublingual
ambulances	ambulance
flower	flower
calorie-cutting	calorie-cutting
aviomarin	aviomarin
chanterelle	chanterelle
gyrectomies	gyrectomy
cyclicity	cyclicity
antibiotic	antibiotic
tv	tv
ayurveda	ayurveda
buttermilk	buttermilk
risking	risk
ruler	ruler
subcription	subcription
uc	uc
ergocalciferols	ergocalciferol
uh	uh
flammulina	flammulina
monoamine	monoamine
antiglycemic	antiglycemic
sanitizer	sanitizer
ngx4010	ngx4010
military	military
deformities	deformity
medihaler-epi	medihaler-epi
uv	uv
waters	water
organism	organism
pleasantry	pleasantry
plasticity	plasticity
births	birth
nazis	nazis
gasman	gasman
diamorphine	diamorphine
ve	ve
organist	organist
brake	brake
diagnosable	diagnosable
multibillion	multibillion
birthe	birthe
preview	preview
anises	anise
snack	snack
halogenation	halogenation
euterpes	euterpe
sorbate	sorbate
gas	gas
phacochoerus	phacochoerus
overweight	overweight
gasolines	gasoline
wiseness	wiseness
spice-eater	spice-eater
timor	timor
promiscuous	promiscuous
bladder	bladder
defectiveness	defectiveness
subsidize	subsidize
planting	plant
talents	talent
dragon	dragon
hydrogenation	hydrogenation
scans	scan
vegetative	vegetative
capsules	capsule
cayenne	cayenne
fluoxetin	fluoxetin
prosthodontist	prosthodontist
allopurin	allopurin
braggadocio	braggadocio
goldswite	goldswite
bragg	bragg
nuggets	nugget
spores	spore
argon	argon
apneas	apneas
porphyras	porphyra
antioncogenes	antioncogene
atrial	atrial
sedentary	sedentary
gel	gel
naproxen	naproxen
hemp	hemp
saturate	saturate
coca-cola	coca-cola
labeling	labeling
watchfulness	watchfulness
sustinence	sustinence
colocasia	colocasia
cellularity	cellularity
grapefruits	grapefruit
transglutaminase	transglutaminase
brain	brain
norus	norus
flavourer	flavourer
cognitions	cognition
hypoesthesias	hypoesthesia
osteoclast	osteoclast
exposition	exposition
pms-lindane	pms-lindane
ready-to-eat	ready-to-eat
dress	dress
onion	onion
blackberries	blackberry
3-trihydroxybenzene	3-trihydroxybenzene
healing	healing
gosling	gosling
novo-sertraline	novo-sertraline
patinopectens	patinopecten
easy-to-understand	easy-to-understand
gastroenteritides	gastroenteritide
therapies	therapy
stroking	stroke
earthquake	earthquake
brussels	brussels
nightmare	nightmare
ducking	duck
hens	hen
nitrosamines	nitrosamine
ralgro	ralgro
mk412a	mk412a
sinkiang	sinkiang
atheromas	atheroma
cauliflower	cauliflower
shrimp	shrimp
regret	regret
hypesthesia	hypesthesia
scale	scale
vegetation	vegetation
oncornavirus	oncornavirus
herr	herr
segmentectomies	segmentectomy
quart	quart
peeling	peel
soups	soup
iceberg	iceberg
eragrosti	eragrostus
scaly	scaly
herb	herb
microcephaly	microcephaly
excitableness	excitableness
habitation	habitation
inactivity	inactivity
smoke	smoke
angioplasties	angioplasty
benzene	benzene
fertilizer	fertilizer
dimetabs	dimetab
weblogs	weblog
statins	statin
chlorophyllous	chlorophyllous
ounce	ounce
concussions	concussion
morbidness	morbidness
atherogenesis	atherogenesis
youth	youth
carcass	carcass
twins	twin
hiccup	hiccup
virgin	virgin
committal	committal
squeamish	squeamish
foodist	foodist
angiogram	angiogram
polymyositis	polymyositis
volunteers	volunteer
marrow	marrow
myodes	myode
prostates	prostate
protons	proton
capparis	capparis
americanise	americanise
tadpole	tadpole
benylin	benylin
gmo	gmo
enterotype	enterotype
xenobiotic	xenobiotic
cerebellum	cerebellum
booster	booster
cider	cider
drinkings	drinking
bugs	bug
canning	canning
colonization	colonization
curiouser	curiouser
h2s2	h2s2
h2s3	h2s3
hershey's	hershey
audition	audition
maser	maser
fertilization	fertilization
avenas	avenas
obesogen	obesogen
bumps	bump
jamming	jam
anode	anode
subsiding	subside
yorker	yorker
roucol	roucol
contaminant	contaminant
2-diphenylmethoxy-n	2-diphenylmethoxy-n
amlas	amlas
americanism	americanism
normality	normality
pseudocomas	pseudocoma
levonorepinephrine	levonorepinephrine
polopirin	polopirin
orthostasis	orthostasis
rancidity	rancidity
juicer	juicer
hamarin	hamarin
wallabies	wallaby
singers	singer
hypoxia	hypoxia
phytates	phytate
virginal	virginal
amylum	amylum
campbell	campbell
poenumgraecums	poenumgraecum
acetous	acetous
portentously	portentously
presyncope	presyncope
maples	maple
aren	aren
vaseline	vaseline
benzole	benzole
allergies	allergy
3-(2-aminoethyl)-1h-indol-5-ol	3
taxpayers	taxpayer
bladder-infecting	bladder-infecting
riskiest	riskiest
octopodiformes	octopodiforme
gasoline	gasoline
lipid	lipid
youths	youth
steaming	steam
caffeine	caffeine
thymes	thyme
cannibalize	cannibalize
xenoestrogens	xenoestrogen
ativan	ativan
esophagitides	esophagitide
menus	menu
cellulite	cellulite
sugary	sugary
ejaculation	ejaculation
andira	andira
mastitis	mastitis
pvp-i	pvp-i
pulmonary	pulmonary
evolution	evolution
providines	providine
neurological	neurological
clamoring	clamor
betacarotene	betacarotene
acupuncture	acupuncture
methylmalonic	methylmalonic
acidity	acidity
prioress	prioress
complaint	complaint
pediatrics	pediatrics
lady	lady
neurohormones	neurohormone
ulcer	ulcer
iosat	iosat
anchovies	anchovy
imcc225	imcc225
bismuth	bismuth
myeloma-multiple	myeloma-multiple
cannibalism	cannibalism
downturn	downturn
disabling	disable
amines	amine
implant	implant
flashes	flash
avena	avena
wrist	wrist
flasher	flasher
allergist	allergist
transannon	transannon
dimethylguanylguanidine	dimethylguanylguanidine
camel	camel
tremors	tremor
bump	bump
precursor	precursor
post-menopauses	post-menopause
dripping	drip
fiber	fiber
ruptures	rupture
leucotomies	leucotomy
cgmp	cgmp
scabene	scabene
lumpectomy	lumpectomy
intelligence	intelligence
winner	winner
ruptured	rupture
siluriformes	siluriforme
gum	gum
pectinidae	pectinidae
salicylates	salicylate
winemaker	winemaker
gut	gut
secalins	secalin
liquimeth	liquimeth
guy	guy
desks	desk
pharyngitides	pharyngitide
sausages	sausage
dysfunction	dysfunction
upscale	upscale
fakeer	fakeer
smelling	smell
documentary	documentary
paratuberculosis	paratuberculosis
foodborne	foodborne
worrying	worry
esophagitis	esophagitis
lain	lain
endometrium	endometrium
phyto-estrogen	phyto-estrogen
porgies	porgy
nutriceuticals	nutriceutical
non-hodgkin	non-hodgkin
ingestion	ingestion
dopar	dopar
prostatic	prostatic
bacteria	bacterium
ultrasonography	ultrasonography
assessor	assessor
cannibalisms	cannibalism
nitrites	nitrite
hyperfiltration	hyperfiltration
neuroregulator	neuroregulator
whipping	whipping
charity	charity
cox-2	cox-2
cox-1	cox-1
sneak	sneak
confections	confection
ixodida	ixodida
swap	swap
basil	basil
caricas	carica
dichlorodiphenyltrichloroethane	dichlorodiphenyltrichloroethane
flavoring	flavor
splinter	splinter
colectomies	colectomy
tick	tick
carter	carter
swab	swab
nitrodur	nitrodur
leafies	leafy
amnesias	amnesia
chlorophenothane	chlorophenothane
jell-o	jell-o
2.4g/100g	2.4
flounders	flounder
novolorazem	novolorazem
fibroadenomas	fibroadenoma
thyroprotect	thyroprotect
vole	vole
musa	musa
abdomen	abdomen
amylase	amylase
fenugreeks	fenugreek
anacardium	anacardium
subsidise	subsidise
pediculus	pediculus
cuminum	cuminum
cholera	cholera
contaminate	contaminate
hfcs	hfc
burn	burn
enamels	enamel
nuremburg	nuremburg
pharmacists	pharmacist
paratuberculoses	paratuberculose
baptisia	baptisia
contusions	contusion
zitazonium	zitazonium
lamb	lamb
lame	lame
burp	burp
norepinephrine	norepinephrine
acrylamide	acrylamide
syncope	syncope
tensely	tensely
coffee-drinking	coffee-drinking
oncology	oncology
galactopyranose	galactopyranose
4-methylenedioxyamphetamine	4-methylenedioxyamphetamine
bibles	bible
marijuanas	marijuana
megadoses	megadose
parasitization	parasitization
decaf	decaf
hyperemesis	hyperemesis
somatotropin	somatotropin
soyfoods	soyfood
7-tetrahydroxyflavone	7-tetrahydroxyflavone
centenarian	centenarian
peeled	peel
drinkers	drinker
almond	almond
pigment	pigment
pulsed	pulsed
casein	casein
mute	mute
relapses	relapse
low-age	low-age
geriatrics	geriatrics
reassurance	reassurance
pulses	pulse
cycad	cycad
molecule	molecule
butt	butt
permanente	permanente
milkfat	milkfat
scanning	scanning
aluminum	aluminum
colors	color
accident	accident
safeness	safeness
lard	lard
defense	defense
spoonful	spoonful
hispanic	hispanic
chlorellas	chlorella
internment	internment
yam	yam
grading	grade
beating	beat
yal	yal
saoott	saoott
shakiness	shakiness
pistacia	pistacia
disclose	disclose
chard	chard
mastictree	mastictree
fecundity	fecundity
holotranscobalamin	holotranscobalamin
ngx-4010	ngx-4010
tipuric	tipuric
polyarthritis	polyarthritis
cephalodynia	cephalodynia
chart	chart
prion-infected	prion-infected
l-dopa	l-dopa
voting	voting
ncx911	ncx911
teething	teethe
wasn	wasn
betadines	betadine
ham	ham
tridil	tridil
marjorams	marjoram
imitrex	imitrex
brush	brush
paraosmia	paraosmia
caramel	caramel
buttoned	button
obesity-causing	obesity-causing
yellowed	yellowed
leucosis/sarcoma	leucosis/sarcoma
preserver	preserver
odors	odor
incontinence	incontinence
suppository	suppository
fluximeter	fluximeter
wart	wart
blood-thinner	blood-thinner
fagine	fagine
chant	chant
hcb	hcb
jewish	jewish
ceratonia	ceratonia
hydroponic	hydroponic
video	video
thymoleptics	thymoleptic
dyslipidemias	dyslipidemia
updates	update
submariner	submariner
vegetables	vegetable
exercising	exercise
tint	tint
yanomamo	yanomamo
cocktail	cocktail
tubulicid	tubulicid
arthropathies	arthropathy
walnuts	walnut
melissas	melissa
vote	vote
chocolates	chocolate
disease	disease
eaters	eater
antihistamines	antihistamine
hiv/aids	hiv/aids
aorta	aorta
redness	redness
bolete	bolete
phenylbutazone	phenylbutazone
smoothies	smoothie
secalin	secalin
oxidoreductases	oxidoreductase
sickness	sickness
disruptor	disruptor
endocrine-disrupting	endocrine-disrupt
leurocristine	leurocristine
toxocaras	toxocara
hen	hen
hep	hep
nanoparticles	nanoparticle
deletion	deletion
lean-type	lean-type
vomisin	vomisin
catechin	catechin
analogist	analogist
coloring	color
hey	hey
leucocythaemia	leucocythaemia
vaginosis	vaginosis
hfc	hfc
nonfat	nonfat
magnesium	magnesium
edibility	edibility
bowels	bowels
uveitis	uveitis
immunoglobulins	immunoglobulin
honeybush	honeybush
nauseate	nauseate
histone	histone
supercomputer	supercomputer
arkansa	arkansa
novo-lorazem	novo-lorazem
naphthalene	naphthalene
dimenhydrinate	dimenhydrinate
airways	airway
crohn	crohn
smart	smart
inhumanely	inhumanely
tomatoes	tomato
sirtuin	sirtuin
corsica	corsica
norovirus	norovirus
d-glucose	d-glucose
chai	chaus
randomness	randomness
temesta	temesta
life-year	life-year
pleurotus	pleurotus
manchuria	manchuria
subsidies	subsidy
waxy	waxy
enematas	enemata
cramps	cramp
neurosciences	neuroscience
dimethylglyoxal	dimethylglyoxal
p'-ddt	p
fiction	fiction
no-calorie	no-calorie
thiamin	thiamin
hip	hip
mammalian	mammalian
squash	squash
hiv	hiv
pruner	pruner
dispril	dispril
cortifair	cortifair
bear	bear
grandfather	grandfather
stools	stool
bean	bean
aneurysms	aneurysm
häagen-daz	häagen-daz
tapping	tap
misalignment	misalignment
bergamot	bergamot
straighten	straighten
bilberries	bilberry
floret	floret
trofan	trofan
bruises	bruise
romaine	romaine
bruiser	bruiser
slimming	slim
oxalates	oxalate
infarction	infarction
nsaids	nsaid
necking	neck
brewing	brewing
peeler	peeler
dietitians	dietitian
lactescence	lactescence
n-methyl-gamma-(4-(trifluoromethyl)phenoxy)benzenepropanamine	n-methyl-gamma
hospital	hospital
carcinogenic	carcinogenic
paraprotein	paraprotein
sprout	sprout
ibuprofen-zinc	ibuprofen-zinc
chef	chef
steams	steam
suspendol	suspendol
lassitude	lassitude
chickpea	chickpea
reisetabletten-ratiopharm	reisetabletten-ratiopharm
meal	meal
pwawgs	pwawg
meat	meat
chafe	chafe
chew	chew
blacking	black
fissures	fissure
reductionism	reductionism
pruning	pruning
suppositories	suppository
numbing	numbing
reductionist	reductionist
phytostanols	phytostanol
beef	beef
skimming	skim
butters	butter
chia	chia
prostatectomies	prostatectomy
mothers	mother
granny	granny
bleach	bleach
pomegranate	pomegranate
spoilation	spoilation
betaisodonas	betaisodona
killer	killer
beet	beet
beer	beer
butapirazol	butapirazol
p-acetamidophenol	p-acetamidophenol
pickers	picker
rhoxal-sertraline	rhoxal-sertraline
cartilages	cartilage
cliniclean	cliniclean
nitrite	nitrite
thanksgive	thanksgive
honeyed	honey
enterococcus	enterococcus
phlebothrombosis	phlebothrombosis
corpse	corpse
muteness	muteness
celeriacs	celeriac
adulterating	adulterate
vivarin	vivarin
ethnicity	ethnicity
sustainable	sustainable
nasality	nasality
hop	hop
liquor	liquor
catabolism	catabolism
vanity	vanity
libido	libido
nicotianas	nicotiana
detoxication	detoxication
gradation	gradation
autophagocytosis	autophagocytosis
stent	stent
chip	chip
migraine	migraine
testosterone	testosterone
adulteration	adulteration
ardeytropin	ardeytropin
vietnamese	vietnamese
lentil	lentil
hpv	hpv
indoles	indole
chlorpromazine	chlorpromazine
flavonols	flavonol
interception	interception
aging	age
waterman	waterman
ejaculate	ejaculate
dented	dent
celebrity	celebrity
thrombocytes	thrombocyte
malignancy	malignancy
low-methionine	low-methionine
listener	listener
xenohormesis	xenohormesis
doable	doable
8-methyl-n-vanillyl-6-nonenamide	8-methyl-n-vanillyl-6-nonenamide
bulge	bulge
urethra	urethra
counterintuitively	counterintuitively
dandelion	dandelion
mehp	mehp
hiroshima	hiroshima
snacking	snack
malignance	malignance
ssri’s	ssri
leaner	leaner
haplorhini	haplorhinus
zostrix	zostrix
boniness	boniness
methanal	methanal
microbiome	microbiome
entrees	entree
fast-food	fast-food
vision	vision
mislabele	mislabele
dietetics	dietetics
nanism	nanism
exudates	exudate
bacteriocides	bacteriocide
crimini	criminus
confusion	confusion
blank	blank
fibbing	fib
deceiver	deceiver
arthralgia	arthralgia
polyradiculoneuritis	polyradiculoneuritis
complainant	complainant
cymbopogons	cymbopogon
yul	yul
xrays	xray
tryptan	tryptan
trimethylamine	trimethylamine
lipotropes	lipotrope
waist-to-height	waist-to-height
tryptophan-to-protein	tryptophan-to-protein
bloody	bloody
asia	asia
disablement	disablement
lemonin	lemonin
iletin	iletin
x-radiation	x-radiation
xanthone	xanthone
glues	glue
muscular	muscular
androstenolone	androstenolone
hum	hum
blood-based	blood-based
maligner	maligner
memo	memo
ultramarathon	ultramarathon
parturition	parturition
daonil	daonil
internships	internship
itching	itch
guidelines	guideline
isogel	isogel
choy	choy
anthocyanidins	anthocyanidin
greta	greta
bell	bell
bellying	belly
video-of-the-day	video-of-the-day
sensitiveness	sensitiveness
cspus	cspus
8-isotestosterone	8-isotestosterone
acid/base	acid/base
gluey	gluey
okra	okra
floppy	floppy
radicals	radical
mycotoxins	mycotoxin
cadium	cadium
barbecue	barbecue
leiomyomas	leiomyoma
xeno	xeno
dna-mutating	dna-mutating
alkylphenol	alkylphenol
trigger	trigger
menu	menu
hamburgers	hamburger
adulteress	adulteress
ritalin	ritalin
lanicor	lanicor
genitalia	genitalium
fecundability	fecundability
trustee	trustee
workplace	workplace
mastalgia	mastalgia
undeniable	undeniable
charities	charity
pre-order	pre-order
thrill	thrill
codex	codex
cough	cough
endorphin	endorphin
retroviruses	retrovirus
atherosclerotic	atherosclerotic
chickpeas	chickpea
duralozam	duralozam
downloading	download
chug	chug
supplementary	supplementary
lymphosarcoma	lymphosarcoma
gingivitides	gingivitide
sneakiness	sneakiness
notoriety	notoriety
guam	guam
c-erbb2	c-erbb2
sustainability	sustainability
dentist	dentist
caffedrine	caffedrine
kaiser	kaiser
hypervirulent	hypervirulent
microbiota	microbiota
asbestos	asbestos
isoflavones	isoflavone
ci-981	ci-981
cervicitis	cervicitis
apoptosis	apoptosis
frap	frap
morphia	morphia
amp-pnp	amp-pnp
deceitfulness	deceitfulness
canful	canful
rooted	root
gamma-caseins	gamma-casein
flavonoid	flavonoid
runniness	runniness
beta	beta
shocker	shocker
sauerkraut	sauerkraut
adenomatous	adenomatous
cupful	cupful
sesamum	sesamum
beriberi	beriberi
epidemics	epidemic
sensory	sensory
poenumgraecum	poenumgraecum
hatefulness	hatefulness
biopsy	biopsy
pimentas	pimenta
hypospadias	hypospadia
periodontist	periodontist
quotes	quote
pumpkins	pumpkin
carcinomas	carcinoma
lobotomy	lobotomy
refinement	refinement
vietnameses	vietnamese
periodontists	periodontist
7-flavanpentol	7-flavanpentol
tartness	tartness
elettarias	elettaria
vitamin	vitamin
metamucil	metamucil
scalar	scalar
il-1	il-1
mangoes	mango
crystallize	crystallize
bhangs	bhang
hepatotoxin	hepatotoxin
jumbo	jumbo
platichthys	platichthy
manure	manure
grandparents	grandparent
estro-feminal	estro-feminal
epotenons	epotenon
6-tetrahydropyridine	6-tetrahydropyridine
carrots	carrot
genitive	genitive
microvasculature	microvasculature
reaction	reaction
phytin	phytin
ibd	ibd
enterocyte	enterocyte
airplanes	airplane
endotoxemias	endotoxemia
pms-tryptophan	pms-tryptophan
faker	faker
hhv-4	hhv-4
rosiness	rosiness
reactions	reaction
ibs	ib
anthocyanin	anthocyanin
papaya	papaya
nutrasweet	nutrasweet
veggiecation	veggiecation
scabisan	scabisan
sinestron	sinestron
livestocks	livestock
ice	ice
spike	spike
2'-dipyridyl	2
spiky	spiky
orangeness	orangeness
glycotoxins	glycotoxin
zea	zea
wehamine	wehamine
icu	icu
mesquite	mesquite
molding	molding
icy	icy
wools	wool
bacteriodetes	bacteriodete
zen	zen
usfda	usfda
spill	spill
re-uptake	re-uptake
anemic	anemic
anemia	anemia
amyloidal	amyloidal
idare	idare
anthropoids	anthropoid
carbinol	carbinol
sneezy	sneezy
thymus	thymus
pharmadines	pharmadine
convulsion	convulsion
soothing	soothing
delusion	delusion
broccoli	broccoli
rule	rule
linum	linum
burritos	burrito
nitroglycerin	nitroglycerin
celebes	celebe
hurting	hurt
diverticulitides	diverticulitide
flavorer	flavorer
presomen	presomen
tumorigenesis	tumorigenesis
sneeze	sneeze
rowanberries	rowanberry
caryophyllus	caryophyllus
tearfulness	tearfulness
spine	spine
salprofen	salprofen
fat-restricted	fat-restricted
stryphnodendron	stryphnodendron
parasite	parasite
trill	trill
imaginary	imaginary
frosted	frost
hydroxyhomosildenafil	hydroxyhomosildenafil
raphanus	raphanus
comment	comment
iga	iga
bio-equivalent	bio-equivalent
anacardiums	anacardium
organotin	organotin
igf	igf
binding	binding
phytochemicals	phytochemical
tingle	tingle
phytoteroid	phytoteroid
olea	olea
preparation	preparation
uk-92	uk-92
tingly	tingly
safety	safety
dresser	dresser
pseudo-allergic	pseudo-allergic
gallstone	gallstone
agism	agism
astrocyte	astrocyte
placentas	placenta
remittal	remittal
gums	gum
zit	zit
harman	harman
avitaminoses	avitaminose
toleration	toleration
alkalinity	alkalinity
pediatrician	pediatrician
pentamethylenediamine	pentamethylenediamine
wines	wine
emperor	emperor
breakfast	breakfast
evolvement	evolvement
syncopes	syncope
tumorigeneses	tumorigenese
nettle	nettle
immunity	immunity
phytonutrient	phytonutrient
usftc	usftc
raillietina	raillietina
boiler	boiler
methanol	methanol
abortifacient	abortifacient
avitaminosis	avitaminosis
crystalization	crystalization
eritron	eritron
tetrabid	tetrabid
4'-ddt	4
moderateness	moderateness
celiac	celiac
musclemeat	musclemeat
culture	culture
petunidin	petunidin
eyeground	eyeground
arius	arius
clastogens	clastogen
6-methylcompactin	6-methylcompactin
desserts	dessert
yorkers	yorker
superpep	superpep
crystalline	crystalline
tick-bite	tick-bite
cicer	cicer
conspiracy	conspiracy
linseeds	linseed
viruses	virus
sustanon	sustanon
benzodiazepines	benzodiazepine
smells	smell
mastodynia	mastodynia
qaly	qaly
spearmint	spearmint
cacosmia	cacosmia
speaker	speaker
spinning	spin
doctorate	doctorate
vitis	vitis
sustainment	sustainment
death	death
steak	steak
mercury	mercury
lipitor	lipitor
kiddy	kiddy
hyperphagia	hyperphagia
firmicute	firmicute
operations	operation
l-leucine	l-leucine
ds-dna	ds-dna
pretzel	pretzel
steam	steam
idaho	idaho
guts	gut
lenoxin	lenoxin
listening	listen
catarrh	catarrh
oranges	orange
acai	acai
tricks	trick
bioaccumulation	bioaccumulation
benzochloryl	benzochloryl
shellfish	shellfish
sesames	sesame
fleeing	flee
e-mails	e-mail
anginine	anginine
carrot	carrot
iom	iom
shaker	shaker
texas	texa
shaken	shake
sardines	sardine
farm	farm
acetaldehyde	acetaldehyde
balloonist	balloonist
colonic	colonic
androgel	androgel
mcmuffin	mcmuffin
1-dimethylethyl)-4-methoxyphenol	1-dimethylethyl
passe	passe
poultries	poultry
atorvastatin	atorvastatin
polyglucoses	polyglucose
kraft	kraft
ponv	ponv
dementia	dementia
cigarettes	cigarette
cerebri	cerebri
providine	providine
licked	lick
billings	billing
pork	pork
oxidases	oxidase
anticancer	anticancer
endometria	endometria
fats	fat
vegetarian	vegetarian
aggressive	aggressive
acer	acer
citrate	citrate
sardinia	sardinia
scented	scented
anti-aromatase	anti-aromatase
cilantros	cilantro
duramorph	duramorph
anchovy	anchovy
pops	pop
sensed	sense
morindas	morinda
grocery	grocery
isn	isn
referent	referent
endosprin	endosprin
cricetidae	cricetidae
cantaloupes	cantaloupe
psoriases	psoriase
laxative	laxative
pandemic	pandemic
concord	concord
laubeel	laubeel
acid	acid
inhumanly	inhumanly
weeds	weed
arsenic	arsenic
article	article
hyperpigmentation	hyperpigmentation
ache	ache
parachute	parachute
milurite	milurite
port	port
ballooning	ballooning
bagful	bagful
marmine	marmine
guys	guy
pharmacy	pharmacy
sedatives	sedative
claudication	claudication
handwashing	handwashing
semen	semen
skipper	skipper
production	production
ius	ius
billberries	billberry
pasta	pasta
piglet	piglet
anhedonias	anhedonia
wallaby	wallaby
reigning	reign
cigars	cigar
dialyzer	dialyzer
igf-i-smc	igf-i-smc
varices	varice
marines	marine
choosy	choosy
palsies	palsy
carnitine	carnitine
hemps	hemp
heatstrokes	heatstroke
degenerative	degenerative
triptone	triptone
nervousness	nervousness
half-cup	half-cup
fruitfulness	fruitfulness
shorten	shorten
formalin	formalin
bergamottin	bergamottin
placebo-controlled	placebo-controlled
shorter	shorter
osteoporoses	osteoporose
viewpoint	viewpoint
capsaicine	capsaicine
2-phenyl-3-hydroxy-benzopyran-4-ones	2-phenyl-3-hydroxy-benzopyran-4-one
sporting	sport
digitisation	digitisation
diastolic	diastolic
full-blown	full-blown
psoriasis	psoriasis
i-2190a	i-2190a
alkalizer	alkalizer
nanograms	nanogram
specialization	specialization
productiveness	productiveness
sustac	sustac
fathers	father
nits	nit
sustak	sustak
gen-sertraline	gen-sertraline
myocardium	myocardium
outpouching	outpouch
courage	courage
clocking	clock
omega-3	omega-3
cookbook	cookbook
perlinganit	perlinganit
syndromes	syndrome
insecticides	insecticide
alpha-neurotoxins	alpha-neurotoxin
varicose	varicose
zearalanol	zearalanol
mevacor	mevacor
fattiness	fattiness
acne	acne
gastroenteritis	gastroenteritis
carcinoma	carcinoma
fishery	fishery
internship	internship
epilepsy	epilepsy
defector	defector
bindery	bindery
milurit	milurit
sardine	sardine
raillietinas	raillietina
lotion	lotion
larvae	larva
sealing	seal
degeneration	degeneration
sensate	sensate
l-methionine	l-methionine
scurvy	scurvy
absorber	absorber
barnard	barnard
nonagenarians	nonagenarian
lumbago	lumbago
swordfish	swordfish
hyperthermia	hyperthermia
anoxia	anoxia
finale	finale
clock	clock
osteoporosis	osteoporosis
agenesis	agenesis
niue	niue
sensor	sensor
credence	credence
spices	spice
habituation	habituation
besitran	besitran
bivalvia	bivalvia
depressant	depressant
polyphagias	polyphagia
leucotomy	leucotomy
endothelium	endothelium
creamer	creamer
poultry	poultry
naprosin	naprosin
noroviruses	norovirus
isoflavone	isoflavone
specialisation	specialisation
diphenylhydramin	diphenylhydramin
fukushima	fukushima
puppets	puppet
multiplicity	multiplicity
octopus	octopus
kb53	kb53
bacteroidetes	bacteroidete
shin	shin
randomization	randomization
zyloprim	zyloprim
jam	jam
wolfberries	wolfberry
proxies	proxy
absorptivity	absorptivity
fiber-deficient	fiber-deficient
pregnancy	pregnancy
schisms	schism
shortening	shorten
turkey	turkey
wcrf	wcrf
detoxing	detox
pasteurization	pasteurization
strema	strema
trisan	trisan
doses	dose
parodontoses	parodontose
dilatation	dilatation
hybrin	hybrin
dynastic	dynastic
atkins	atkin
morphine	morphine
tactic	tactic
branded	brand
amppnp	amppnp
leeks	leek
watchman	watchman
penis	penis
cavities	cavity
caper	caper
scabecid	scabecid
trisweet	trisweet
diacetyl	diacetyl
butadione	butadione
lavage	lavage
pudding	pudding
wrinkle	wrinkle
fibrositis	fibrositis
biotransformation	biotransformation
olives	olive
chili's	chili
preladenant	preladenant
toxicity	toxicity
sibazon	sibazon
fibroatheromas	fibroatheroma
hypolactasia	hypolactasia
2-phenyl-chromenes	2-phenyl-chromenes
burmeses	burmese
ratio-sertraline	ratio-sertraline
americanisation	americanisation
eggnog	eggnog
truvia	truvia
herring	herr
alloprin	alloprin
recurrent	recurrent
thimerosal	thimerosal
octogenarian	octogenarian
worry	worry
watcher	watcher
rafts	raft
nicotine	nicotine
boosting	boost
epinephrine	epinephrine
digoxin	digoxin
bleed	bleed
lutein	lutein
ritalin-sr	ritalin-sr
eudaemonic	eudaemonic
neurohumors	neurohumor
eudaemonia	eudaemonia
recurse	recurse
senate	senate
pneumovax	pneumovax
triglyceride	triglyceride
multi-level	multi-level
gastric	gastric
planted	plant
dyspepsias	dyspepsia
trioxopurine	trioxopurine
coughs	cough
shot	shot
emails	email
pizza	pizza
allpargin	allpargin
gels	gel
crowding	crowd
planter	planter
axilla	axilla
newborns	newborn
anomalies	anomaly
receipts	receipt
artichokes	artichoke
discomfort	discomfort
cyanidanol-3	cyanidanol-3
absorbing	absorb
guava	guava
penny	penny
diphenylbutazone	diphenylbutazone
predime	predime
whistling	whistle
ammonia	ammonia
tissue	tissue
morbidities	morbidity
crocus	crocus
refiner	refiner
proficiency	proficiency
oxidizer	oxidizer
billing	billing
nostril	nostril
dressing	dress
krebiozen	krebiozen
frost	frost
reactionism	reactionism
lovastatin	lovastatin
dismutase	dismutase
monocytes	monocyte
leanness	leanness
gene	gene
anxieties	anxiety
epic	epic
nonsmokers	nonsmoker
waist	waist
grill	grill
food-poisoning-related	food-poisoning-related
caramelization	caramelization
cherry	cherry
sunburn	sunburn
babies	baby
splintered	splintered
folacin	folacin
femininity	femininity
life-or-death	life-or-death
stress	stress
crisco	crisco
sneezings	sneezing
galactosemias	galactosemia
ducks	duck
foxgloves	foxglove
fibrocystic	fibrocystic
kiddie	kiddie
bottled	bottled
alvit-55	alvit-55
dairy	dairy
neogluconin	neogluconin
textiloma	textiloma
alzheimers	alzheimer
skeletonise	skeletonise
gladem	gladem
menopause	menopause
froot	froot
health-promoting	health-promoting
sedative	sedative
gerd	gerd
addiction	addiction
paralyses	paralysis
veteran	veteran
lycopene	lycopene
blue-green	blue-green
bones	bone
boner	boner
eater	eater
plaice	plaice
7-tetrahydroxy-flavone	7-tetrahydroxy-flavone
neuropathy	neuropathy
receivables	receivables
boned	bone
job	job
eaten	eat
autopsy	autopsy
aneurysm	aneurysm
jog	jog
downplay	downplay
katrum	katrum
lemonoid	lemonoid
billion	billion
gravidarum	gravidarum
vceac	vceac
parodontosis	parodontosis
miracle	miracle
bandages	bandage
tastiness	tastiness
sheep	sheep
rinse	rinse
hypoascorbemia	hypoascorbemia
illex	illex
adherence	adherence
macroautophagies	macroautophagy
alpha-carotene	alpha-carotene
kingdom	kingdom
haters	hater
clove	clove
puppet	puppet
xenoestrogen	xenoestrogen
musculature	musculature
cephalalgias	cephalalgia
blueberries	blueberry
neu5gc	neu5gc
testicle	testicle
treatments	treatment
cocainise	cocainise
pro-oxidant	pro-oxidant
abortively	abortively
fsus	fsus
oklahoma	oklahoma
scleroses	sclerosis
bunny	bunny
mozart	mozart
recipes	recipe
sarcopenias	sarcopenia
dextrose	dextrose
recrudescence	recrudescence
nolvadex	nolvadex
hijiki	hijiki
straightening	straighten
plastic	plastic
transient	transient
crabapple	crabapple
plant	plant
arginine-rich	arginine-rich
acromegaly	acromegaly
kaposus	kaposus
spaghetti	spaghetti
scfas	scfa
sailor	sailor
servant	servant
salmonella	salmonella
proteins	protein
istradefylline	istradefylline
jock	jock
proctosigmoidoscopies	proctosigmoidoscopy
dogging	dog
purpleness	purpleness
jobs	job
medicine	medicine
teethe	teethe
nephrolith	nephrolith
adhd	adhd
glowing	glowing
piling	pile
mineralisation	mineralisation
lactate	lactate
larder	larder
rosehips	rosehip
alternate-day	alternate-day
copaifera	copaifera
detox	detox
holiness	holiness
humorous	humorous
adventist	adventist
apoprotein	apoprotein
retinene	retinene
after-surgery	after-surgery
endotheliums	endothelium
thymoanaleptics	thymoanaleptic
cereals	cereal
cowman	cowman
defenses	defens
anxiety	anxiety
flexitarian	flexitarian
macroalgae	macroalgae
immunization	immunization
immune-boosting	immune-boosting
dieldrin	dieldrin
sparkler	sparkler
dioxygen	dioxygen
goose	goose
whacker	whacker
multimillion	multimillion
algotropyl	algotropyl
hyperthermias	hyperthermia
judaism	judaism
signs	sign
glumida	glumida
gustation	gustation
client	client
pain-killer	pain-killer
booker	booker
lump	lump
bodyworks	bodywork
gnathostomiases	gnathostomiase
kiwifruits	kiwifruit
lemongrass	lemongrass
roosevelt	roosevelt
dinner	dinner
wreath	wreath
fragrance	fragrance
provatene	provatene
sdz202-250	sdz202-250
farmer	farmer
rubbing	rub
bioaccumulate	bioaccumulate
worms	worm
crowd	crowd
portulaca	portulaca
cycling	cycling
fatigue	fatigue
pre-school	pre-school
nitro-bid	nitro-bid
scallops	scallop
placebo	placebo
repost	repost
2-dipyridyl	2-dipyridyl
mastalgias	mastalgia
agribusiness	agribusiness
bikes	bike
mutagen	mutagen
aggressiveness	aggressiveness
salmonelloses	salmonellosis
americanization	americanization
passeres	passere
drink	drink
teffs	teff
lung	lung
buddhistic	buddhistic
amyloid	amyloid
radicchio	radicchio
digitalis	digitalis
bacterium	bacterium
recurrences	recurrence
pregnenedione	pregnenedione
ergocalciferol	ergocalciferol
idalprem	idalprem
plate	plate
flowering	flowering
cycle	cycle
aura	aura
sids	sid
diacetylmorphine	diacetylmorphine
freaks	freak
pathogens	pathogen
inflammation	inflammation
fissure	fissure
optic	optic
subfecundity	subfecundity
lustral	lustral
organochlorines	organochlorine
bread	bread
chlorazine	chlorazine
counseling	counseling
restaurant	restaurant
fibroids	fibroid
radiography	radiography
gnathostomiasis	gnathostomiasis
cicers	cicer
commissioning	commission
hippophaine	hippophaine
bacon	bacon
cacosmias	cacosmia
sc-18862	sc-18862
zearanol	zearanol
vasculotropin	vasculotropin
kale	kale
disburse	disburse
phytostanol	phytostanol
diphenylhydramine	diphenylhydramine
dramanate	dramanate
vertebra	vertebra
knees	knee
sign	sign
mgus	mgus
scramble	scramble
sclerosis	sclerosis
rinds	rind
download	download
placebos	placebo
chaus	chaus
grenade	grenade
roots	root
antarctica	antarctica
lurk	lurk
sub-fertility	sub-fertility
adenylimidodiphosphate	adenylimidodiphosphate
oregon	oregon
exclamatory	exclamatory
arthritides	arthritide
metabonomics	metabonomic
heartbeats	heartbeat
guacamole	guacamole
taster	taster
scorer	scorer
candy	candy
delitex	delitex
scores	score
omnopon	omnopon
recipe	recipe
tax-payers	tax-payer
cornstarch	cornstarch
egg-free	egg-free
preservation	preservation
adrenaline	adrenaline
aminazine	aminazine
loser	loser
propionate	propionate
cyclist	cyclist
plays	play
opioid	opioid
cardiologists	cardiologist
control	control
pwawg	pwawg
lemons	lemon
work-sites	work-site
recurrently	recurrently
immunostimulatory	immunostimulatory
receptor	receptor
pulse	pulse
muffins	muffin
mesclun	mesclun
specialty	specialty
grandmothers	grandmother
philippine	philippine
inflaming	inflame
intercourse	intercourse
whistlings	whistling
environ	environ
rhabdomyolysis	rhabdomyolysis
soldiership	soldiership
streaker	streaker
benadryl	benadryl
retinitis	retinitis
petrogales	petrogale
scent	scent
cyclohexatriene	cyclohexatriene
metadate	metadate
streaked	streak
monsanto	monsanto
trinitrolong	trinitrolong
mintage	mintage
asthma	asthma
cattlemen	cattlemen
sc18862	sc18862
rancher	rancher
roughage	roughage
scrambled	scramble
hemorrhoid	hemorrhoid
blood-brain	blood-brain
scrambler	scrambler
allspice	allspice
teens	teens
stoned	stone
polypeptides	polypeptide
autopsies	autopsy
caregivers	caregiver
audio	audio
mesothelioma	mesothelioma
intake	intake
vertebrae	vertebra
silent	silent
kfc	kfc
catergen	catergen
capsidol	capsidol
bivalves	bivalve
raisin	raisin
nitrosamine	nitrosamine
chartist	chartist
1-methyl-4-phenyl-1,2,3,6-tetrahydropyridine	1-methyl-4-phenyl-1
mortality	mortality
persin	persin
chartism	chartism
stones	stone
quercetin-3-rutinoside	quercetin-3-rutinoside
headphones	headphone
relanium	relanium
brushing	brushing
nanocrystal	nanocrystal
kawa	kawa
fallout	fallout
aromatherapies	aromatherapy
geronto	geronto
cadbury	cadbury
preservative	preservative
gastrojejunostomy	gastrojejunostomy
abdomens	abdomen
athlete	athlete
salmonellosis	salmonellosis
banning	ban
cassia	cassia
endometriomas	endometrioma
prebiotic	prebiotic
plant-eater	plant-eater
p1496	p1496
taiwan	taiwan
trigonella	trigonella
kava	kava
eco-atkins	eco-atkin
deliciousness	deliciousness
petroselinums	petroselinum
pbdes	pbde
quinoas	quinoa
grapes	grape
nsc-125973	nsc-125973
wheelchair	wheelchair
anzatax	anzatax
multivitamin	multivitamin
kid	kid
solprin	solprin
diabeta	diabeta
inventory	inventory
oryza	oryza
pop-tarts	pop-tart
graphs	graph
conflicts	conflict
textilomas	textiloma
morbidity	morbidity
strokes	stroke
euratom	euratom
phosphate	phosphate
angiograms	angiograms
editor-in-chief	editor-in-chief
persea	persea
vaccine	vaccine
hips	hip
high-meat	high-meat
arecas	arecas
gentleman	gentleman
diastase	diastase
nutritionfact	nutritionfact
laxness	laxness
oxidisation	oxidisation
ludwig	ludwig
nsaid	nsaid
interns	intern
kissing	kiss
menstruation	menstruation
tighter	tighter
coxas	coxa
teeth	tooth
sprouts	sprout
slippage	slippage
traveller	traveller
choosemyplate.gov	choosemyplate.gov
raspberry	raspberry
mioscene	mioscene
antibody	antibody
phthalate	phthalate
interne	interne
fatness	fatness
moldy	moldy
lettuce	lettuce
molds	mold
noncaloric	noncaloric
leukocyte	leukocyte
menstruating	menstruate
plegias	plegia
near-vegan	near-vegan
hive	hive
anaprox	anaprox
intestine	intestine
surgeons	surgeon
ciguatera	ciguatera
stickiness	stickiness
hypoascorbemias	hypoascorbemia
myocytes	myocyte
millets	millet
ficus	ficus
organotins	organotin
pseudoaphakia	pseudoaphakia
cyanobacteria	cyanobacteria
grandfathers	grandfather
riboflavin	riboflavin
half-teaspoon	half-teaspoon
tired	tired
assessors	assessor
aggression	aggression
lead	lead
amputations	amputation
sunlight	sunlight
assess	assess
gasification	gasification
lambda-carrageenan	lambda-carrageenan
tetradotoxin	tetradotoxin
gentlemen	gentleman
torcetrapib	torcetrapib
endotoxin	endotoxin
lead-soldered	lead-soldered
ganjas	ganja
pre-orders	pre-order
cherries	cherry
oryzanol	oryzanol
sausage	sausage
leaders	leader
rhabdomyolyses	rhabdomyolys
aves	aves
offal	offal
slovakia	slovakia
cortland	cortland
obesity	obesity
receptors	receptor
cup-and-a-half	cup-and-a-half
cancer-or-e-coli	cancer-or-e-coli
cianidanol	cianidanol
lorazepam	lorazepam
excitement	excitement
familiarizing	familiarize
cupcakes	cupcake
burrito	burrito
theanine	theanine
osteoclasts	osteoclast
pedameth	pedameth
sesame	sesame
tokelau	tokelau
pharmacopeia	pharmacopeia
rutabaga	rutabaga
methoxypropiocin	methoxypropiocin
lemming	lem
buddhists	buddhist
balloons	balloon
n-(4-hydroxyphenyl)acetanilide	n
fibroadenoma	fibroadenoma
marihuanas	marihuana
lipoplasty	lipoplasty
childbirths	childbirth
restructure	restructure
aneurism	aneurism
cankerous	cankerous
kiwis	kiwi
weed	weed
basils	basil
glucocorticoids	glucocorticoid
balloon	balloon
hydrogenization	hydrogenization
orthopedics	orthopedic
leek	leek
accent	accent
nauseous	nauseous
allerdryl	allerdryl
naprosyn	naprosyn
cold-steeping	cold-steeping
pills	pill
minerals	mineral
latina	latina
surgeon	surgeon
lilly110140	lilly110140
withdrawn	withdraw
lilly-110140	lilly-110140
phosphorous	phosphorous
lipoplasties	lipoplasty
lipoid	lipoid
saffrons	saffron
creutzfeldt-jakob	creutzfeldt-jakob
nightshades	nightshade
whitecoat	whitecoat
sniff	sniff
ulcerate	ulcerate
meats	meat
conspirator	conspirator
hearer	hearer
hemlock	hemlock
latino	latino
scathing	scathing
downer	downer
4-(2-aminoethyl)-1	4
benzoate	benzoate
varix	varix
epithelium	epithelium
iciness	iciness
spence	spence
pithecolobium	pithecolobium
ageism	ageism
plotosus	plotosus
bokhoor	bokhoor
pleasantness	pleasantness
habitability	habitability
rheumatoid	rheumatoid
gallbladders	gallbladder
tmao	tmao
citruline	citruline
bivalve	bivalve
omega-3s	omega-3
osteoclastogeneses	osteoclastogenese
pervasiveness	pervasiveness
multiplication	multiplication
povidone-iodine	povidone-iodine
glucose	glucose
platypus	platypus
sweetleaf	sweetleaf
neuroregulators	neuroregulator
enlivenment	enlivenment
subsidisation	subsidisation
max-caro	max-caro
flomax	flomax
invasiveness	invasiveness
roughages	roughage
m&m's	m
ambulation	ambulation
lumper	lumper
goiters	goiter
hesperetin-7-rutinoside	hesperetin-7-rutinoside
xanturic	xanturic
surgery	surgery
africanise	africanise
glucosinolate	glucosinolate
4'-dichlorodiphenyltrichloroethane	4
outpouchings	outpouching
backaches	backache
pharynx	pharynx
delusionary	delusionary
foodstuffs	foodstuff
methylmercury	methylmercury
bagman	bagman
motrin	motrin
phthiraptera	phthiraptera
receptivity	receptivity
thyramine	thyramine
polonium	polonium
defection	defection
check	check
anthrax	anthrax
metabolization	metabolization
matcha	matcha
malignment	malignment
sleeper	sleeper
watermelons	watermelon
marjoram	marjoram
grandparent	grandparent
nonagenarian	nonagenarian
tempeh	tempeh
cardamons	cardamon
crowberries	crowberry
post-surgery	post-surgery
discs	disc
earthquakes	earthquake
stress-response	stress-response
chefs	chef
gravies	gravy
rawboned	rawbon
pinapple	pinapple
menthas	mentha
tranquillize	tranquillize
spoil	spoil
glyphosate	glyphosate
ticker	ticker
filberts	filbert
citation	citation
anisaki	anisaki
cartilage	cartilage
barbeque	barbeque
cardamoms	cardamom
trimethylamine-n-oxide	trimethylamine-n-oxide
hypesthesias	hypesthesia
polycose	polycose
epicholesterol	epicholesterol
sparus	sparus
personnel	personnel
sunburns	sunburn
endocrine-disrupt	endocrine-disrupt
rutin	rutin
myth	myth
inventories	inventory
bergamots	bergamot
toronja	toronja
glycol	glycol
familiarization	familiarization
macintosh	macintosh
galactopyranoside	galactopyranoside
mutation	mutation
neurotoxin	neurotoxin
calciol	calciol
pleuronectes	pleuronecte
penicillin	penicillin
neurotoxic	neurotoxic
mk217	mk217
irony	irony
recursive	recursive
bandage	bandage
alerting	alert
caterpillar	caterpillar
latice	latice
irons	iron
thaus	thaus
roast	roast
glucoraphanin	glucoraphanin
spillage	spillage
product	product
lover	lover
vinegar	vinegar
hydrate	hydrate
hater	hater
megadose	megadose
thanksgiving	thanksgive
oncornaviruses	oncornavirus
halflife	halflife
traveler	traveler
spool	spool
flora	flora
marijuana	marijuana
employee	employee
hexachlorane	hexachlorane
employed	employ
enemata	enemata
madura	madura
helicopters	helicopter
burger	burger
breastmilk	breastmilk
nightmares	nightmare
confliction	confliction
spoon	spoon
anthocyanidin	anthocyanidin
employer	employer
puberty	puberty
quinamm	quinamm
molasse	molasse
mindset	mindset
androderm	androderm
formaldehyde	formaldehyde
herbivore	herbivore
pigmentations	pigmentation
half-life	half-life
margarine	margarine
electroencephalogram	electroencephalogram
dasheens	dasheen
lipectomy	lipectomy
praxel	praxel
microlissencephalies	microlissencephaly
herbivory	herbivory
hexachlorobenzene	hexachlorobenzene
win-win-win	win-win-win
lbs	lb
antistrumin	antistrumin
taxation	taxation
fibrillation	fibrillation
environs	environs
ici-46474	ici-46474
defecation	defecation
hysterectomies	hysterectomy
fenamine	fenamine
aflatoxin	aflatoxin
b-lymphocyte	b-lymphocyte
africanization	africanization
justicia	justicia
pcb-free	pcb-free
osteoclastogenesis	osteoclastogenesis
ageing	ageing
glucocorticoid	glucocorticoid
recrudescences	recrudescence
phytonutrients	phytonutrient
spore	spore
lentils	lentil
doctor	doctor
saliva	saliva
sunfishes	sunfish
ldl	ldl
remission	remission
irgasan-dp300	irgasan-dp300
sport	sport
leukemias	leukemia
geese	goose
edibleness	edibleness
marshmallow	marshmallow
flaxseeds	flaxseed
sunny-side-up	sunny-side-up
goiter	goiter
docs	doc
sarafem	sarafem
medications	medication
rolfing	rolf
enlarger	enlarger
remittance	remittance
homing	homing
philippines	philippine
carer	carer
mammectomy	mammectomy
leukoviruses	leukovirus
melanoma	melanoma
exclaim	exclaim
ballet	ballet
pollutant	pollutant
labels	label
myplate	myplate
genotoxins	genotoxin
armpit	armpit
colonist	colonist
strains	strain
benzoates	benzoate
fetuses	fetus
ici-46	ici-46
hydroxyacetanilide	hydroxyacetanilide
splinters	splinter
thrower	thrower
doer	doer
graphic	graphic
mangosteens	mangosteen
beta-glucans	beta-glucan
authenticity	authenticity
moods	mood
withdrawal	withdrawal
moderatism	moderatism
paprika	paprika
pads	pad
microcephalies	microcephaly
clam	clam
fuji	fujus
lumpectomies	lumpectomy
hepatitides	hepatitide
deadening	deaden
orange-scented	orange-scented
carbs	carb
angers	anger
biodramina	biodramina
lie	lie
dilatations	dilatation
smell	smell
blender	blender
paralysation	paralysation
hypericums	hypericum
rubberplants	rubberplant
feathers	feather
fume	fume
dogs	dog
homer	homer
benzodiazepine	benzodiazepine
tension	tension
hydroxytyramine	hydroxytyramine
winsome	winsome
plantains	plantain
athletes	athlete
cephalodynias	cephalodynia
sun-dried	sun-dried
dialyses	dialysis
supplements	supplement
dietetic	dietetic
winsomeness	winsomeness
dormicum	dormicum
pepper	pepper
malabar-nut	malabar-nut
destiny	destiny
ejaculator	ejaculator
tablespoons	tablespoon
soured	sour
metastases	metastase
latinos	latino
polyradiculoneuropathies	polyradiculoneuropathy
inflame	inflame
double-blind	double-blind
antiseptic	antiseptic
care2	care2
pain	pain
calcium	calcium
pepsi	pepsi
supper	supper
licking	lick
pigmentation	pigmentation
canker	canker
cucumbers	cucumber
albumin	albumin
moderation	moderation
studio	studio
plums	plum
louse	louse
cabbage	cabbage
plume	plume
latinas	latina
humulus	humulus
diabetic	diabetic
primate	primate
papayas	papaya
spock	spock
pharmacotherapy	pharmacotherapy
butylhydroxyanisole	butylhydroxyanisole
rubus	rubus
dialysis	dialysis
teosinte	teosinte
piled	pile
glyconutrients	glyconutrient
muffin	muffin
preventive	preventive
vincrisul	vincrisul
uridocid	uridocid
plasticization	plasticization
esselstyn	esselstyn
exercise-induced	exercise-induced
lemmus	lemmus
consultation	consultation
bagel	bagel
meals	meal
paula	paula
inhumanity	inhumanity
fisetin	fisetin
intactness	intactness
panama	panama
computer	computer
fluoxetine	fluoxetine
lox	lox
metastasis	metastasis
coriander	coriander
capurate	capurate
aides	aide
oysters	oyster
capsicum	capsicum
nanocrystals	nanocrystal
kenaf	kenaf
squatter	squatter
cording	cord
sildenafil	sildenafil
lower-fat	lower-fat
chimpanzees	chimpanzee
habituate	habituate
sneak-preview	sneak-preview
adderall	adderall
diabetes	diabetes
superoxides	superoxide
door	door
checker	checker
phytate	phytate
8-trihydroxypurine	8-trihydroxypurine
prescribing	prescribe
wheelchairs	wheelchair
pasteurized	pasteurize
banana	banana
sarawak	sarawak
teller	teller
nasalization	nasalization
placentomes	placentome
high-fructose	high-fructose
hydration	hydration
aquasept	aquasept
halibut	halibut
l-carnitine	l-carnitine
butadion	butadion
signaler	signaler
nonylphenol	nonylphenol
progesterone	progesterone
biodegradation	biodegradation
edamame	edamame
prosopis	prosopis
bike	bike
african-american	african-american
piles	pile
manpower	manpower
wildly	wildly
chemo	chemo
hydrogenise	hydrogenise
nbccs	nbcc
folivores	folivore
cardiologist	cardiologist
ultrasound	ultrasound
ears	ear
psychosurgery	psychosurgery
wheatgrass	wheatgrass
earl	earl
prions	prion
erythritol	erythritol
dysmenorrhea	dysmenorrhea
fiery	fiery
urosin	urosin
psychosurgeries	psychosurgery
sterotate	sterotate
largactil	largactil
bind	bind
post-antibiotic	post-antibiotic
prosopi	prosopi
pigman	pigman
flavorings	flavoring
beta-casein	beta-casein
prevention	prevention
clot	clot
pass	pass
milk	milk
bill	bill
receptiveness	receptiveness
stiffness	stiffness
nightshade	nightshade
bile	bile
clog	clog
bucket	bucket
dose	dose
digitizer	digitizer
dilations	dilation
dilate	dilate
zoloft	zoloft
oceans	ocean
coriandrum	coriandrum
addictiveness	addictiveness
daytrana	daytrana
galactosemia	galactosemia
radish	radish
cholecystokinin	cholecystokinin
oatmeal	oatmeal
thriller	thriller
kellogg	kellogg
mint	mint
vegans	vegan
pesticide-resistant	pesticide-resistant
2-bipyridine	2-bipyridine
chimpanzee	chimpanzee
thrilled	thrill
tahiti	tahitus
lipectomies	lipectomy
maspin	maspin
sensitization	sensitization
chafing	chafe
bins	bin
retailer	retailer
ileocolitis	ileocolitis
fenugreek	fenugreek
amnesia	amnesia
lucerne	lucerne
mk-803	mk-803
isodines	isodine
arrhythmia	arrhythmia
sabah	sabah
polyp	polyp
meningioma	meningioma
maltodextrin	maltodextrin
marshmallows	marshmallow
vcjd	vcjd
retinol	retinol
tailoring	tailor
habit	habit
licorices	licorice
lookout	lookout
clue	clue
bird	bird
meteorite	meteorite
signal	signal
papillomaviridae	papillomaviridae
seated	seat
trinitrin	trinitrin
penises	penis
percutaféine	percutaféine
triclosan	triclosan
myelon	myelon
frosting	frosting
juglans	juglan
atisuril	atisuril
influenza	influenza
purevia	purevia
i2190a	i2190a
excessiveness	excessiveness
miso	miso
spoilage	spoilage
cordite	cordite
plantation	plantation
podcast	podcast
nigerium	nigerium
curcuma	curcuma
kappa-caseins	kappa-casein
centrarchidae	centrarchida
ticks	tick
greenness	greenness
ecstasy	ecstasy
graders	grader
tannage	tannage
meta-analysis	meta-analysis
punicaceae	punicaceae
todarodes	todarode
framingham	framingham
heartburn	heartburn
travels	travels
nutation	nutation
dramamine	dramamine
tranquillizer	tranquillizer
nanogram	nanogram
blackberry	blackberry
deers	deer
quechua	quechua
beta-caseins	beta-casein
prostatectomy	prostatectomy
ranchers	rancher
articles	article
taraxacum	taraxacum
hiccoughs	hiccough
ryes	rye
synergy	synergy
vaccinations	vaccination
cucurbita	cucurbita
ferroprotoporphyrin	ferroprotoporphyrin
homininus	homininus
chemotherapy	chemotherapy
tahini	tahinus
povidone-iodines	povidone-iodine
spermatozoa	spermatozoa
pancreas	pancreas
cigar	cigar
supplies	supplies
skinful	skinful
cryptoxanthins	cryptoxanthin
signer	signer
inspection	inspection
gammexane	gammexane
cookie	cookie
bits	bit
sense	sense
adp-carrier	adp-carrier
chicano	chicano
butterfat	butterfat
purslane	purslane
amputation	amputation
server	server
betaisodona	betaisodona
chicana	chicana
inactiveness	inactiveness
skin	skin
tailor	tailor
skim	skim
verrucas	verruca
retinas	retinas
mad	mad
mangiferas	mangiferas
mao	mao
man	man
garbanzo	garbanzo
tryptophan	tryptophan
triglycerides	triglyceride
neurologic	neurologic
dromedary	dromedary
addict	addict
toothpaste	toothpaste
ischemias	ischemia
websites	website
dysmenorrheas	dysmenorrhea
residency	residency
maimonide	maimonide
sigmoidoscopy	sigmoidoscopy
bonus	bonus
defending	defend
splintering	splinter
teenage	teenage
supercomputers	supercomputer
hormone-disruptor	hormone-disruptor
brynner	brynner
myelopathies	myelopathy
new-video-a-day	new-video-a-day
vitaseptol	vitaseptol
vagina	vagina
hemorrhages	hemorrhage
estrogens	estrogen
hamming	ham
equipment	equipment
colorful	colorful
ovaries	ovary
cocaine	cocaine
merthiolate	merthiolate
blend	blend
pbde	pbde
prophylaxis	prophylaxis
breath	breath
electrode	electrode
pbcs	pbc
men	man
cross-contamination	cross-contamination
marlboro	marlboro
tufts	tuft
cirrhosis	cirrhosis
ici-47699	ici-47699
2-benzenediol	2-benzenediol
clogging	clog
barley	barley
gerontology	gerontology
hemlocks	hemlock
orange	orange
adulterant	adulterant
masculine	masculine
parkinson	parkinson
breast	breast
raspberries	raspberry
bioaccessibility	bioaccessibility
pseudotumor	pseudotumor
infantilism	infantilism
mahi-mahi	mahi-mahi
beater	beater
polyradiculoneuropathy	polyradiculoneuropathy
(l)-mannitol	-lrb-
recursion	recursion
receiver	receiver
abdominousness	abdominousness
beaten	beat
frozen	frozen
received	receive
millet	millet
fat-burning	fat-burning
burping	burp
mcdeath	mcdeath
boost	boost
flaxseed	flaxseed
acid-forming	acid-forming
drugging	drug
neuroprotectants	neuroprotectant
nonmigrants	nonmigrant
ip82	ip82
greece	greece
bioenergetics	bioenergetic
superbugs	superbug
ahs-2	ahs-2
arsenicals	arsenical
tetrahydroisoquinoline	tetrahydroisoquinoline
hormeses	hormese
mit	mit
bloodstream	bloodstream
nutritionfacts.org	nutritionfacts.org
stiff	stiff
hunter-gatherer	hunter-gatherer
gelafusal	gelafusal
crate	crate
swank	swank
(+)-catechin	-lrb-
lecithin	lecithin
diphenhydramine	diphenhydramine
berry	berry
chute	chute
suffering	suffer
cadavers	cadaver
exclamation	exclamation
5-androsten-3-ol-17-one	5-androsten-3-ol-17-one
wrinkles	wrinkle
whacking	whack
tobacco	tobacco
california	california
homoeopathy	homoeopathy
felv	felv
spermine	spermine
carragheen	carragheen
bears	bear
myelomatoses	myelomatose
illices	illice
nausea	nausea
monkeys	monkey
folate	folate
persimmons	persimmon
difficile	difficile
pneumonitides	pneumonitide
cooker	cooker
flying	fly
2-bipyridyl	2-bipyridyl
internet	internet
mma	mma
potatoes	potato
allorin	allorin
proteinuria	proteinuria
half-hour	half-hour
poisonous	poisonous
vegetable	vegetable
internee	internee
lasers	laser
psml	psml
alcoholisation	alcoholisation
hormesis	hormesis
eyegrounds	eyeground
eczemas	eczema
oxidization	oxidization
disclosing	disclose
capzasin	capzasin
melanomas	melanoma
liposuction	liposuction
cells	cell
arrhythmias	arrhythmia
parasites	parasite
sunshine	sunshine
parasitism	parasitism
mom	mom
sharks	shark
anana	anana
mop	mop
nmol/l	nmol/l
alfalfa	alfalfa
humor	humor
high-fat	high-fat
neurotransmitters	neurotransmitter
vegetive	vegetive
supermarkets	supermarket
hazelnut	hazelnut
mph	mph
radioactivities	radioactivity
panadol	panadol
4-dihydroxyphenethylamine	4-dihydroxyphenethylamine
books	book
häagen-dazs	häagen-daz
mammals	mammal
antioncogene	antioncogene
pritikin	pritikin
glycotoxin	glycotoxin
chervil	chervil
signature	signature
tongue	tongue
levarterenol	levarterenol
indianapolis	indianapolis
chipotle	chipotle
choline	choline
perdue	perdue
fungicides	fungicide
gangrenes	gangrene
beans	bean
cramp	cramp
mri	mri
hominid	hominid
gingers	ginger
chamorro	chamorro
hepatitis	hepatitis
carers	carer
cleistocalyx	cleistocalyx
aloxiprimum	aloxiprimum
phytosterols	phytosterol
hominin	hominin
ages	age
breastfeeding	breastfeed
defender	defender
bromination	bromination
msg	msg
rutabagas	rutabaga
illnesses	illness
fertility	fertility
butcher	butcher
avian	avian
benzol	benzol
adhesiveness	adhesiveness
olive	olive
hernias	hernia
downers	downer
spasms	spasm
wakame	wakame
polyps	polyp
4-epitetracycline	4-epitetracycline
prostaglandin	prostaglandin
lycium	lycium
témesta	témesta
excite	excite
biomarker	biomarker
osmanthus	osmanthus
mineralization	mineralization
magnorbin	magnorbin
bean-to-rice	bean-to-rice
retroviridae	retroviridae
tendons	tendon
hb419	hb419
lecithins	lecithin
manfulness	manfulness
chunk	chunk
bacteriophage	bacteriophage
ambulant	ambulant
blubber	blubber
giftgiving	giftgive
brinjals	brinjal
pathophysiology	pathophysiology
chomorro	chomorro
noradrenaline	noradrenaline
uropancreozymin	uropancreozymin
hb420	hb420
pre-diabetes	pre-diabetes
oolong	oolong
greens	green
tensor	tensor
microcystins	microcystin
dessert	dessert
isodine	isodine
urticaria	urticaria
flatus	flatus
flavors	flavor
ounces	ounce
music	music
screenings	screening
colas	cola
omnivore	omnivore
aplasia	aplasia
x-radiations	x-radiation
atherosclerosis	atherosclerosis
alpha-dipyridyl	alpha-dipyridyl
uadt	uadt
oddness	oddness
insects	insect
rancid	rancid
amphetamines	amphetamine
tarichatoxin	tarichatoxin
sensations	sensation
nagasaki	nagasaki
delusively	delusively
nauseation	nauseation
restaurants	restaurant
liptonorm	liptonorm
pepto-bismol	pepto-bismol
cysticercosis	cysticercosis
icebergs	iceberg
gallbladder	gallbladder
iodination	iodination
high-antioxidant	high-antioxidant
emerogene	emerogene
medevac	medevac
emphysema	emphysema
stressor	stressor
sleep	sleep
creatinine	creatinine
toxocara	toxocara
leukocytes	leukocyte
scurvies	scurvy
hypersensitivities	hypersensitivity
fungicide	fungicide
endocrine	endocrine
butazolidin	butazolidin
website	website
flavour	flavour
oncovine	oncovine
headphone	headphone
gumming	gum
amorpha	amorpha
purine	purine
analogization	analogization
sweet	sweet
pandemics	pandemic
oncovin	oncovin
damnation	damnation
instillment	instillment
screening	screening
n-acetyl-p-aminophenol	n-acetyl-p-aminophenol
immunosuppression	immunosuppression
pinto	pinto
agaricale	agaricale
ribes	ribe
macadamias	macadamia
arginine	arginine
thalidomide	thalidomide
prostatitis	prostatitis
anosmia	anosmia
lavender	lavender
seasickness	seasickness
cruel	cruel
antiemetic	antiemetic
3-dihydro-1-methyl-5-phenyl-2h-1	3-dihydro-1-methyl-5-phenyl-2h-1
seafoods	seafood
anti-neu5gc	anti-neu5gc
concussion	concussion
tofu	tofu
plating	plate
biometal	biometal
baggage	baggage
(+)-cyanidanol	-lrb-
cysticercoses	cysticercose
all-twinkie	all-twinkie
durvitan	durvitan
lactose	lactose
ride	ride
bisons	bison
metastase	metastase
niceness	niceness
submariners	submariner
insecta	insecta
bargaining	bargaining
flounder	flounder
attacker	attacker
rice	rice
meat-eater	meat-eater
flavouring	flavour
tapeworms	tapeworm
migrants	migrant
neolignans	neolignan
gift	gift
polynesia	polynesia
told	tell
non-smoker	non-smoker
cilantro	cilantro
slim	slim
carcinogeneses	carcinogenese
cumin	cumin
prettiness	prettiness
encephalopathy	encephalopathy
halitosis	halitosis
boosters	booster
quinine-odan	quinine-odan
spillover	spillover
lotions	lotion
practitioner	practitioner
myelomatosis	myelomatosis
mutagens	mutagen
opiate	opiate
camomile	camomile
jama	jama
artery-damaging	artery-damaging
calendulas	calendula
odontoclast	odontoclast
polysorbate	polysorbate
bicarnesine	bicarnesine
holiday	holiday
mevinolin	mevinolin
biquinate	biquinate
infarctions	infarction
vestin	vestin
nci	nci
potato	potato
osmitrol	osmitrol
cashew	cashew
viagra	viagra
uripurinol	uripurinol
phytonutrient-rich	phytonutrient-rich
enokitake	enokitake
iota-carrageenan	iota-carrageenan
grandmother	grandmother
mushrooms	mushroom
microalbuminuria	microalbuminuria
thyroids	thyroid
dysosmia	dysosmia
slip	slip
firing	firing
uruguay	uruguay
morel	morel
artichoke	artichoke
randomisation	randomisation
losses	loss
diverticulosis	diverticulosis
carcinogenesis	carcinogenesis
knobby	knobby
thrifty	thrifty
familiarized	familiarize
atheroscleroses	atherosclerose
pcbs	pcb
ginger	ginger
scales	scale
splenda	splenda
kangaroos	kangaroo
liquorices	liquorice
torn	tear
mandate	mandate
patulin	patulin
carting	cart
sorbitol	sorbitol
kool-aid	kool-aid
anti-nutrient	anti-nutrient
sirolimus	sirolimus
chlorhexidine	chlorhexidine
sdz202250	sdz202250
resveratrol	resveratrol
pinning	pin
faintness	faintness
quarts	quart
seaweed	seaweed
cannabis	cannabis
cistron	cistron
employment	employment
sprain	sprain
milker	milker
acidoses	acidose
risks	risk
diarrheal	diarrheal
allergenic	allergenic
gynecomastia	gynecomastia
diarrheas	diarrhea
mucosa	mucosa
psidiums	psidium
low-carbohydrate	low-carbohydrate
amendment	amendment
hershey	hershey
sapoderm	sapoderm
alkalinization	alkalinization
benzhydramine	benzhydramine
pease	pease
algarrobo	algarrobo
imagism	imagism
bargain	bargain
cheese	cheese
java	java
gouts	gout
pears	pear
migrant	migrant
rind	rind
dance	dance
rhyncophthirina	rhyncophthirina
tamoxifen	tamoxifen
sneaker	sneaker
steatohepatitis	steatohepatitis
peptide	peptide
relaxation	relaxation
allergy	allergy
ostreidae	ostreidae
physiopathology	physiopathology
mystery	mystery
cheesy	cheesy
macro-autophagy	macro-autophagy
milk-free	milk-free
flash	flash
osteoarthritis	osteoarthritis
regrets	regret
foligan	foligan
leukovirus	leukovirus
signalman	signalman
danes	dane
ibumetin	ibumetin
helicopter	helicopter
risk-benefit	risk-benefit
aspirin	aspirin
epicatechin	epicatechin
watermelon	watermelon
dna-damaging	dna-damaging
3-hydroxy-4-keto-flavonoids	3-hydroxy-4-keto-flavonoid
nitrolan	nitrolan
enterocele	enterocele
nosiness	nosiness
cataract	cataract
poison	poison
superfood	superfood
testopel	testopel
sigmoidoscopies	sigmoidoscopy
voles	vole
franco-prussian	franco-prussian
slur	slur
lesions	lesion
jazz	jazz
endotoxemia	endotoxemia
drool	drool
buckwheats	buckwheat
graphite	graphite
urination	urination
halitoses	halitose
feminization	feminization
imagine	imagine
glutelin	glutelin
whack	whack
bacteroidete	bacteroidete
nu-loraz	nu-loraz
digoregen	digoregen
girl	girl
imaging	imaging
wartime	wartime
iritides	iritide
blind	blind
gingivitis	gingivitis
color	color
indigestion	indigestion
lipstick	lipstick
dehydrogenase	dehydrogenase
nom	nom
most-antioxidant-packed	most-antioxidant-packed
thrombosis	thrombosis
mammal	mammal
xeno-autoantibodies	xeno-autoantibodies
hypnotics	hypnotic
headaches	headache
wisconsin	wisconsin
atheroma	atheroma
toys	toy
microlissencephaly	microlissencephaly
benhydramin	benhydramin
exudate	exudate
amfetamine	amfetamine
arthrospira	arthrospira
pharmaceuticals	pharmaceutical
ecmo	ecmo
ischemia	ischemia
npr	npr
ischemic	ischemic
fabaceae	fabaceae
colon	colon
althaeas	althaea
risk	risk
histerone	histerone
glycoalkaloids	glycoalkaloid
subsidy	subsidy
lemongrasses	lemongrass
yeasts	yeast
fodmaps	fodmap
musas	musa
alvit55	alvit55
p53	p53
cacao	cacao
grandma	grandma
inupiat	inupiat
frying	fry
prosthodontists	prosthodontist
epilepsies	epilepsy
arugula	arugula
counsel	counsel
pcos	pco
liver	liver
refractiveness	refractiveness
sumatra	sumatra
veal	veal
pollutants	pollutant
withdrawnness	withdrawnness
chickens	chicken
neurodegenerative	neurodegenerative
ladies	lady
flake	flake
detoxicate	detoxicate
colic	colic
rodovan	rodovan
tumerics	tumeric
prasterone	prasterone
appendant	appendant
pcrm	pcrm
reticulosarcomas	reticulosarcoma
defensibility	defensibility
sarcopenia	sarcopenia
strawberry	strawberry
ci981	ci981
bargains	bargain
collard	collard
songs	song
organization	organization
crystallization	crystallization
cyclic	cyclic
festivals	festival
nun	nun
anti-proteus	anti-proteus
insecticide	insecticide
citomid	citomid
kombu	kombu
schizophrenia	schizophrenia
nut	nut
hypercholesterolemia	hypercholesterolemia
whip	whip
lindane	lindane
mustard	mustard
ardeydorm	ardeydorm
centedrin	centedrin
undercooks	undercook
sustamycin	sustamycin
sweeten	sweeten
survival	survival
8-pn	8-pn
colonoscopies	colonoscopy
usda	usda
market	market
mammalgias	mammalgia
rooibos	rooibos
phillipines	phillipine
yoghurt	yoghurt
cricetus	cricetus
advertorial	advertorial
phlebothromboses	phlebothrombose
adiponectin	adiponectin
wondrous	wondrous
safeties	safety
inflammations	inflammation
breads	bread
endurance	endurance
herbs	herb
multidrug-resistant	multidrug-resistant
fungus	fungus
catarrhs	catarrh
myoquin	myoquin
enzyme	enzyme
macroautophagy	macroautophagy
amif-72	amif-72
amylases	amylase
tsentedrin	tsentedrin
tasting	tasting
vegf	vegf
evolutionary	evolutionary
boron	boron
gelatin	gelatin
arterialisation	arterialisation
meat-eaters	meat-eater
butchers	butcher
butchery	butchery
camels	camel
hamburger	hamburger
nnss	nnss
capsaicin	capsaicin
neuromodulators	neuromodulator
cinnamons	cinnamon
quinsul	quinsul
sealdin	sealdin
microbiotas	microbiota
formosa	formosa
brinjal	brinjal
peach	peach
climopax	climopax
boiling	boil
gastrojejunostomies	gastrojejunostomy
frank	frank
hawthorn	hawthorn
whop	whop
abbesses	abbess
melissa	melissa
tomato	tomato
anesthesia	anesthesia
histones	histone
worriment	worriment
cadaver	cadaver
inhumane	inhumane
pretzels	pretzel
lipotrope	lipotrope
rescuer	rescuer
adipocytes	adipocyte
myeloma-multiples	myeloma-multiple
crystals	crystal
onions	onion
5-pentanediamine	5-pentanediamine
appendage	appendage
nontoxic	nontoxic
kelp	kelp
eggbeaters	eggbeater
half-century	half-century
condyles	condyle
backache	backache
plegia	plegia
porcinus	porcinus
carya	carya
citrullus	citrullus
psychomotor	psychomotor
muskrats	muskrat
indole	indole
graphics	graphic
endive	endive
girls	girl
nitrates	nitrate
fujus	fujus
thinness	thinness
meteoroids	meteoroid
japanese	japanese
iodide	iodide
epotenon	epotenon
cognitively	cognitively
chipping	chip
easprin	easprin
antibodies	antibody
commissioner	commissioner
image	image
mercurothiolate	mercurothiolate
feminineness	feminineness
nitrol	nitrol
odorant	odorant
rubiemen	rubiemen
alcoholics	alcoholic
celebration	celebration
proctosigmoidoscopy	proctosigmoidoscopy
sea-foods	sea-food
diacylglycerol	diacylglycerol
butyrate	butyrate
inhumaneness	inhumaneness
givenness	givenness
zucchini	zucchini
levulosa	levulosa
softener	softener
gestation	gestation
levulose	levulose
inuit	inuit
oat	oat
anoxemia	anoxemia
carte	carte
pesticide	pesticide
prediabetes	prediabete
turmerics	turmeric
chlorophyll	chlorophyll
amphetamine	amphetamine
setonix	setonix
carts	cart
beethoven	beethoven
angiology	angiology
venti	venti
sulfide	sulfide
turnips	turnip
caplenal	caplenal
carob	carob
canadian	canadian
octopuse	octopuse
andropatch	andropatch
sulfites	sulfite
dressings	dressing
milliliter	milliliter
diazemuls	diazemul
vessel	vessel
clams	clam
fractures	fracture
burkitt	burkitt
burns	burn
bakery	bakery
lavages	lavage
levoamphetamine	levoamphetamine
leptin	leptin
malign	malign
hypermelanosis	hypermelanosis
drinker	drinker
ralone	ralone
diverticulum	diverticulum
osmofundin	osmofundin
reductase	reductase
alertness	alertness
malignity	malignity
digest	digest
ethnology	ethnology
currant	currant
thromboses	thrombose
sadly	sadly
camelus	camelus
virginity	virginity
betel	betel
barberry	barberry
orac	orac
machaerium	machaerium
moderator	moderator
signaller	signaller
emesis	emesis
polyarthralgias	polyarthralgia
ruling	ruling
enemas	enema
plantain	plantain
p-hydroxyacetanilide	p-hydroxyacetanilide
cricetulus	cricetulus
chronic	chronic
nightclub	nightclub
avocado	avocado
coad	coad
dimethyldiketone	dimethyldiketone
enlivening	enliven
stevia	stevia
lobotomies	lobotomy
biomarkers	biomarker
eden	eden
diagnosis	diagnosis
acesulfame	acesulfame
keoflo	keoflo
opioid-induced	opioid-induced
amazon	amazon
daniel	daniel
ixodidas	ixodida
iodisation	iodisation
bioavailability	bioavailability
hypermelanoses	hypermelanose
dyspepsia	dyspepsia
pistachios	pistachio
anhedonia	anhedonia
tetracycline	tetracycline
horsenettles	horsenettle
flavonoids	flavonoid
bertholletia	bertholletia
internist	internist
iodinate	iodinate
potassium	potassium
desensitizing	desensitize
arthroses	arthrose
flavanol	flavanol
nsc125973	nsc125973
plantago	plantago
toxin	toxin
productivity	productivity
methyl	methyl
dopaflex	dopaflex
phenolics	phenolic
blah	blah
cretinism	cretinism
illicium	illicium
coca	coca
quinson	quinson
teaspoon	teaspoon
absorbent	absorbent
tumors	tumor
sarcocysti	sarcocystus
radiation	radiation
coco	coco
oreo	oreo
aroma	aroma
greger	greger
vincasar	vincasar
pupae	pupa
exercises	exercise
exerciser	exerciser
whopping	whopping
drip	drip
okinawan	okinawan
17-beta-hydroxy-4-androsten-3-one	17-beta-hydroxy-4-androsten-3-one
glaucomas	glaucoma
diseases	disease
synergistic	synergistic
d-galactose	d-galactose
vaccinate	vaccinate
lifespans	lifespan
mutant	mutant
device	device
arthrosis	arthrosis
pharyngitis	pharyngitis
scorbutus	scorbutus
enzymes	enzyme
gummed	gummed
promiscuousness	promiscuousness
butapyrazole	butapyrazole
acid-inducing	acid-induce
mcdonald	mcdonald
ceramide	ceramide
variety	variety
neutropenic	neutropenic
iodine	iodine
macropodidae	macropodidae
liar	liar
depressor	depressor
jenapurinol	jenapurinol
numbness	numbness
mints	mint
metabolous	metabolous
catechins	catechin
strainer	strainer
laughters	laughter
trillions	trillion
ayurvedic	ayurvedic
acidosis	acidosis
peacock	peacock
atrophy	atrophy
brassica	brassica
excitant	excitant
cupcake	cupcake
pupa	pupa
carton	carton
aide	aide
urine	urine
sulfite	sulfite
neutraceuticals	neutraceutical
carcasses	carcass
reinfect	reinfect
dandelions	dandelion
smoker	smoker
pre-agricultural	pre-agricultural
mastodynias	mastodynia
triticum	triticum
smokes	smoke
lick	lick
fodmap	fodmap
longevity	longevity
aids	aid
parencephalons	parencephalon
syzygium	syzygium
treated	treat
emotions	emotion
dentists	dentist
blueberry	blueberry
epidemic	epidemic
cytoskeletons	cytoskeleton
lice	lice
bunnies	bunny
flavor	flavor
ursidae	ursidae
rhubarb	rhubarb
aromatherapy	aromatherapy
alopecia	alopecia
aicr	aicr
digacin	digacin
atresia	atresia
oncovirus	oncovirus
tinting	tint
coli	coli
destination	destination
cold	cold
alcoholise	alcoholise
life	life
cola	cola
bucketful	bucketful
alcoholism	alcoholism
honey	honey
apurin	apurin
lies	lie
dane	dane
xanthomax	xanthomax
orf	orf
mydrial	mydrial
coke	coke
pulsation	pulsation
anti-oncogenes	anti-oncogene
damn	damn
rosas	rosa
spiciness	spiciness
steroids	steroid
turnip	turnip
anesthetization	anesthetization
hormone-disruptors	hormone-disruptor
hexachlorocyclohexane	hexachlorocyclohexane
stains	stain
aptitudes	aptitude
caffeinism	caffeinism
seizer	seizer
noni	nonus
twinkies	twinky
cornell	cornell
venom	venom
endotoxins	endotoxin
eubacteria	eubacteria
novolin	novolin
teaspoons	teaspoon
entomophobia	entomophobia
myrosinase	myrosinase
leukotomies	leukotomy
yolk	yolk
vascular	vascular
coma	coma
algarrobos	algarrobo
roentgenography	roentgenography
stomachs	stomach
lymphosarcomas	lymphosarcoma
tri-sweet	tri-sweet
hormones	hormone
telomeres	telomere
oncogeneses	oncogenese
organochlorine	organochlorine
copd	copd
transcript	transcript
malignancies	malignancy
novalsan	novalsan
ova	ova
lurker	lurker
streaks	streak
cook	cook
cashiers	cashier
hoaxer	hoaxer
referral	referral
vitamins	vitamin
pelvic	pelvic
rowanberry	rowanberry
roses	rose
lyssa	lyssa
magic	magic
date	date
corn	corn
joggings	jogging
wonderfulness	wonderfulness
somagerol	somagerol
nori	nori
blog	blog
drug	drug
spitting	spit
antinutrients	antinutrient
lifeguards	lifeguard
adenovirus	adenovirus
thermogenics	thermogenic
massage	massage
ductus	ductus
licorice	licorice
plutonium	plutonium
caseins	casein
cord	cord
foeniculum	foeniculum
levonor	levonor
b-lymphocytes	b-lymphocyte
exanthema	exanthema
pharmadine	pharmadine
oncogenesis	oncogenesis
oxidise	oxidise
dash	dash
citrulline	citrulline
youtube	youtube
fructans	fructan
compliancy	compliancy
gamma-nh)	gamma-nh
cyanocobalamin	cyanocobalamin
cokes	coke
riding	ride
malabar-nuts	malabar-nut
hearts	heart
nose	nose
oats	oats
obtuse	obtuse
cognition	cognition
endotenon	endotenon
lime	lime
fishing	fishing
roaster	roaster
ethnomedicine	ethnomedicine
breakfasts	breakfast
compliance	compliance
4-diaminobutane	4-diaminobutane
fortification	fortification
myelons	myelon
salicylate	salicylate
tetramethylenediamine	tetramethylenediamine
chips	chip
telomere	telomere
pharmacist	pharmacist
low-antioxidant	low-antioxidant
pervasion	pervasion
rider	rider
limonol	limonol
rupture	rupture
curcumas	curcuma
cephalgia	cephalgia
goiabas	goiaba
glutamate	glutamate
devices	device
neuroscience	neuroscience
antimutagenic	antimutagenic
baker	baker
foodists	foodist
journalist	journalist
dizzyness	dizzyness
exposure	exposure
seizing	seize
sustonit	sustonit
bioflavonoid	bioflavonoid
asparagus	asparagus
wine	wine
utis	utis
flight	flight
reactant	reactant
novopurol	novopurol
milligram	milligram
yellow	yellow
cancer-free	cancer-free
bookplate	bookplate
parsley	parsley
myeloma	myeloma
lameness	lameness
mediterranean-type	mediterranean-type
cows	cow
pharynxs	pharynx
glycation	glycation
americans	american
pfizer	pfizer
coxa	coxa
aremis	aremis
chili	chili
audiobook	audiobook
antiperspirants	antiperspirant
mannitol	mannitol
choiceness	choiceness
pad	pad
wise	wise
referrals	referral
nitrostat	nitrostat
brainwaves	brainwave
radionuclides	radionuclide
marihuana	marihuana
ici46	ici46
501c3	501c3
non-vegan	non-vegan
pbc	pbc
vaginas	vagina
folks	folk
child	child
wonderment	wonderment
pcb	pcb
hormone	hormone
wisdom	wisdom
starvation	starvation
tax-payer	tax-payer
pear	pear
peas	pea
landfills	landfill
sneezing	sneeze
normalcy	normalcy
xylitol	xylitol
pco	pco
umbellatine	umbellatine
cymbopogon	cymbopogon
avocados	avocado
china	china
service	service
coffee	coffee
veggies	veggy
bleeding	bleed
cheerfulness	cheerfulness
lifespan	lifespan
enoki	enoki
american	american
throats	throat
dietitian	dietitian
uribenz	uribenz
pea	pea
habitually	habitually
pee	pee
miocene	miocene
xanthones	xanthone
finalization	finalization
e-mail	e-mail
11-cis-retinal	11-cis-retinal
pet	pet
period	period
africa	africa
pew	pew
infants	infant
birth	birth
geico	geico
phenidylate	phenidylate
recurrence	recurrence
toxins	toxin
caffeinate	caffeinate
tisanes	tisane
vintec	vintec
plumage	plumage
obama	obama
doughnut	doughnut
soybeans	soybean
prevalence	prevalence
ulceration	ulceration
provegetarian	provegetarian
whortleberry	whortleberry
entree	entree
pain-killers	pain-killer
pregnanedione	pregnanedione
petrolatum	petrolatum
peel	peel
agave	agave
diaphragms	diaphragm
immortalisation	immortalisation
ldl-cholesterol	ldl-cholesterol
nutmeg	nutmeg
nugget	nugget
bmaa	bmaa
environments	environment
reign	reign
enterocolitica	enterocolitica
pie	pie
pig	pig
lactic	lactic
kidney	kidney
pin	pin
instilment	instilment
mineral	mineral
baldness	baldness
heroin	heroin
anthocyanins	anthocyanin
taurine	taurine
senator	senator
glucosinolates	glucosinolate
cadmium	cadmium
fevers	fever
hypersensitivity	hypersensitivity
nutritionists	nutritionist
fruit	fruit
squatters	squatter
liveness	liveness
glucophage	glucophage
dioxide	dioxide
ratio-tryptophan	ratio-tryptophan
genetics	genetics
liquorice	liquorice
cannabi	cannabi
spools	spool
garlic	garlic
aircraft	aircraft
jaundice	jaundice
salivas	saliva
carrageenin	carrageenin
citrus	citrus
burning	burn
tolerability	tolerability
eaggec	eaggec
hydrogenations	hydrogenation
vessels	vessel
kicker	kicker
satiety	satiety
topicycline	topicycline
painkiller	painkiller
olfaction	olfaction
anti-artery-clogging	anti-artery-clogging
teenagers	teenager
fracture	fracture
muskrat	muskrat
octopodiforme	octopodiforme
decapodiforme	decapodiforme
pms	pm
cross-react	cross-react
carotenes	carotene
bible	bible
wallaroos	wallaroo
absorption	absorption
2-hydroxy-n	2-hydroxy-n
canola	canola
carsickness	carsickness
humming	hum
htlv-iii	htlv-iii
penn	penn
scallions	scallion
long-chain	long-chain
pom	pom
pop	pop
luncher	luncher
desensitisation	desensitisation
hydroxycut	hydroxycut
pomegranates	pomegranate
digestion	digestion
pork-eat	pork-eat
trillion	trillion
bio-accumulate	bio-accumulate
giver	giver
safflowers	safflower
espresso	espresso
pistachio	pistachio
fieriness	fieriness
fainting	faint
ppm	ppm
a1c	a1c
apo-e	apo-e
mealtimes	mealtime
bison	bison
feelings	feeling
polypill	polypill
vomiturition	vomiturition
intoxication	intoxication
zyloric	zyloric
octopodas	octopoda
fatty	fatty
cramping	cramp
subsidence	subsidence
bmis	bmis
digester	digester
leukosis/sarcoma	leukosis/sarcoma
molasses	molasses
burmese	burmese
favoritism	favoritism
embarin	embarin
receipt	receipt
apo-sertraline	apo-sertraline
foodstuff	foodstuff
angriness	angriness
employees	employee
psa	psa
capsule	capsule
antioxidants	antioxidant
complaining	complain
fisitin	fisitin
refining	refining
agriculture	agriculture
freak	freak
ganja	ganja
hibiscus	hibiscus
pheasant	pheasant
polycarbonate	polycarbonate
pharmacies	pharmacy
life-threatening	life-threatening
pth	pth
levocarnitine	levocarnitine
dashing	dash
femavit	femavit
juicing	juice
linums	linum
cardiology	cardiology
brufen	brufen
orgasm	orgasm
euchresta	euchresta
prostate	prostate
quotation	quotation
bravery	bravery
medicare	medicare
pets	pet
infant	infant
wrists	wrist
pus	pus
sciatica	sciatica
jodid	jodid
agaritine	agaritine
curcumin	curcumin
pest	pest
p450arom	p450arom
infamy	infamy
subscribers	subscriber
infancy	infancy
ambulance	ambulance
bruising	bruise
vertigo-vomex	vertigo-vomex
leukotomy	leukotomy
standpoint	standpoint
antibiotics	antibiotic
taboulus	taboulus
collards	collard
infection	infection
macadamia	macadamia
nutrient-rich	nutrient-rich
chlorinate	chlorinate
carotenoid	carotenoid
lyophrin	lyophrin
hoax	hoax
cavia	cavia
hirsutism	hirsutism
bacteriodete	bacteriodete
indigestibility	indigestibility
decapodiformes	decapodiforme
limonin	limonin
ipecac	ipecac
mutagenicity	mutagenicity
serviceability	serviceability
disclosure	disclosure
organs	organ
gallstones	gallstone
gilustenon	gilustenon
dermatology	dermatology
guavas	guava
fungi	fungus
organizer	organizer
travel	travel
choice	choice
poundal	poundal
cucumber	cucumber
stomach	stomach
estrogenic	estrogenic
nitrangin	nitrangin
wondering	wonder
postprandial	postprandial
blankness	blankness
citric	citric
group	group
digitation	digitation
transurethral	transurethral
tobaccos	tobacco
relaxant	relaxant
echography	echography
soldiering	soldier
dementias	dementia
fibromyoma	fibromyoma
secondhand	secondhand
taco	taco
sailors	sailor
adenoviridae	adenoviridae
gelcen	gelcen
kawas	kawa
sourness	sourness
drunkenness	drunkenness
eskimo	eskimo
rinsing	rinse
achromycin	achromycin
fennels	fennel
snacktime	snacktime
magics	magic
biacetyl	biacetyl
padding	padding
feverous	feverous
3'-diol	3
soda	soda
sock	sock
sinus	sinus
n-trimethylethanaminium	n-trimethylethanaminium
o157	o157
climarest	climarest
gooseberries	gooseberry
ticking	tick
gluten	gluten
kavas	kavas
asians	asian
hypercapnia	hypercapnia
brushed	brush
videos	video
hangover	hangover
salons	salon
rufen	rufen
transiency	transiency
hunting	hunting
oxalate	oxalate
dyschezia	dyschezia
festival	festival
abnormalities	abnormality
tersaseptic	tersaseptic
contusion	contusion
nanoparticle	nanoparticle
centramina	centramina
quinoctal	quinoctal
souring	souring
trigonellas	trigonella
nitration	nitration
transience	transience
uveitides	uveitide
trans	trans
astroglia	astroglia
colchicine	colchicine
cellidrin	cellidrin
keriorrhea	keriorrhea
smokers	smoker
glucan	glucan
ruminococcus	ruminococcus
maggots	maggot
radiator	radiator
comet	comet
farming	farm
fizzy	fizzy
hearing	hearing
meningiomas	meningioma
carentil	carentil
bargainer	bargainer
3-butanedione	3-butanedione
enokitakes	enokitakes
canthaxanthines	canthaxanthine
spasm	spasm
junk	junk
treadmill	treadmill
pineal	pineal
angiographies	angiography
arkansas	arkansa
branding	brand
chinese	chinese
radishes	radish
seals	seal
prion	prion
purgatory	purgatory
remittence	remittence
brewer	brewer
seduxen	seduxen
psyllium	psyllium
lipomul	lipomul
n-butyrate	n-butyrate
rafter	rafter
b-cells	b-cell
rosemary	rosemary
methionine	methionine
codeine/morphine	codeine/morphine
figs	fig
thighs	thigh
cinnamon	cinnamon
hordeum	hordeum
homy	homy
jodgamma	jodgamma
berries	berry
brewage	brewage
germinoblastoma	germinoblastoma
rices	rice
soyfood	soyfood
comas	coma
passer	passer
alpha	alpha
homo	homo
steamship	steamship
reception	reception
jury	jury
pigments	pigment
holy	holy
affects	affect
insomnia	insomnia
home	home
congest	congest
prettiest	prettiest
pounder	pounder
iron	iron
bovine	bovine
topectomy	topectomy
axsain	axsain
hypertension	hypertension
zeaxanthins	zeaxanthin
sparkle	sparkle
taps	tap
hepatology	hepatology
opium	opium
erbitux	erbitux
constipation	constipation
song	song
butte	butte
cream	cream
losings	losing
gradate	gradate
neoplasm	neoplasm
bertholletias	bertholletia
clients	client
5-hydroxytryptamine	5-hydroxytryptamine
birding	bird
giantism	giantism
cochineal	cochineal
nerves	nerve
homeopathic	homeopathic
hordein	hordein
tart	tart
flaxs	flax
taro	taro
ironing	iron
glucans	glucan
pseudocoma	pseudocoma
junked	junk
natto	natto
proteus	proteus
health	health
deaf-mutism	deaf-mutism
maize	maize
mediterranean	mediterranean
junker	junker
hops	hop
instillator	instillator
d-glutamate	d-glutamate
hyperactivity	hyperactivity
ironist	ironist
receptive	receptive
sprue	sprue
gangrenous	gangrenous
seats	seat
dieting	dieting
legatrim	legatrim
fine	fine
iritis	iritis
pistil	pistil
kwell	kwell
hose	hose
dehydroepiandrosterone	dehydroepiandrosterone
nomad	nomad
specialism	specialism
heart	heart
mucus	mucus
trash	trash
bilberry	bilberry
specialist	specialist
hydrocortisone	hydrocortisone
heart-healthy	heart-healthy
botulism	botulism
tactics	tactic
glow	glow
laughter	laughter
soup	soup
patent	patent
equasym	equasym
phoner	phoner
phones	phone
tangeretin	tangeretin
petri	petri
speciality	speciality
arachis	arachis
man-bites-dog	man-bites-dog
microwave	microwave
prescript	prescript
bioflavonoids	bioflavonoid
adipose	adipose
croaker	croaker
hernia	hernia
levo-amphetamine	levo-amphetamine
painkillers	painkiller
diagesil	diagesil
glybenclamide	glybenclamide
b12	b12
tbisc-ethane	tbisc-ethane
salmonella-infected	salmonella-infected
glue	glue
laparoscopic	laparoscopic
gravol	gravol
fibrositides	fibrositide
p-1496	p-1496
coughing	cough
fire	fire
sarcosporidia	sarcosporidia
methylin	methylin
transients	transient
pentagon	pentagon
proton	proton
antioxidant	antioxidant
horsebeans	horsebean
immortalization	immortalization
hownottodie	hownottodie
pinapples	pinapple
symptom	symptom
fireman	fireman
carotenoids	carotenoid
insulin	insulin
poppy	poppy
provinols	provinol
l-amphetamine	l-amphetamine
bananas	banana
vomit	vomit
pancreatitides	pancreatitide
motion-aid	motion-aid
dogmas	dogma
carcinomatoses	carcinomatose
counselor	counselor
excess	excess
plants	plant
suppuration	suppuration
bullets	bullet
homoisoflavones	homoisoflavone
dogma	dogma
althaea	althaea
bewilderment	bewilderment
adhesion	adhesion
chesapeake	chesapeake
dioxin	dioxin
fish	fish
pregnancies	pregnancy
pruritus	pruritus
cephalgias	cephalgia
promiscuously	promiscuously
auraptene	auraptene
hydrophobia	hydrophobia
budge	budge
jacutin	jacutin
infections	infection
poroporos	poroporo
chestnuts	chestnut
fibroatheroma	fibroatheroma
epitrate	epitrate
celebrate	celebrate
coumarin	coumarin
multiplier	multiplier
luteoline	luteoline
lifestyles	lifestyle
insulin-like	insulin-like
coconut	coconut
11-cis-retinol	11-cis-retinol
hunger	hunger
nuprin	nuprin
reuptake	reuptake
prebiotics	prebiotic
glucor	glucor
conflict	conflict
squat	squat
father	father
kaposi	kaposus
x-rays	x-rays
purge	purge
myocardia	myocardia
nitrate	nitrate
colorate	colorate
disruptors	disruptor
herbivories	herbivory
gingiva	gingiva
dioscorea	dioscorea
carcinomatosis	carcinomatosis
glycoalkaloid	glycoalkaloid
wonder	wonder
reflux	reflux
glitches	glitch
lightheadedness	lightheadedness
watercress	watercress
preservatives	preservative
twinky	twinky
bioequivalent	bioequivalent
taxpayer	taxpayer
abdominous	abdominous
dilation	dilation
tremor-producing	tremor-producing
carrageenan	carrageenan
cranberry	cranberry
cinfamar	cinfamar
mapluxin	mapluxin
employ	employ
mouthwash	mouthwash
brakes	brake
jeff	jeff
instill	instill
scallop	scallop
beets	beet
corianders	coriander
pruritis	pruritis
eggplant	eggplant
scathe	scathe
maimonides	maimonide
parachuter	parachuter
octogenarians	octogenarian
imagination	imagination
microtines	microtine
novaldex	novaldex
quokka	quokka
quinimax	quinimax
dancer	dancer
grilling	grill
fibromyalgias	fibromyalgia
testicles	testicle
jellification	jellification
retrovirus	retrovirus
cellulites	cellulite
fumed	fume
gd-vegf	gd-vegf
interceptor	interceptor
mk-412a	mk-412a
birds	bird
diets	diet
tranquillisation	tranquillisation
person-to-person	person-to-person
beer-drinking	beer-drinking
fenilbutazon	fenilbutazon
dietician	dietician
pyrogallol	pyrogallol
muted	mute
dormin	dormin
electroencephalograms	electroencephalogram
alpha-caseins	alpha-casein
mnpa	mnpa
biocatalysts	biocatalyst
plant-eaters	plant-eater
sweetness	sweetness
genitals	genitals
dioxins	dioxin
flame-retardant	flame-retardant
fumes	fume
gold-mining	gold-mining
pantopon	pantopon
reticulolymphosarcoma	reticulolymphosarcoma
phytochemical	phytochemical
acers	acer
sarcoma	sarcoma
televisions	television
myalgia	myalgia
vegetarians	vegetarian
biopsies	biopsy
mastectomy	mastectomy
reference	reference
antibiotic-associated	antibiotic-associated
omnivores	omnivore
cambodian	cambodian
healer	healer
tylenol	tylenol
herniation	herniation
commitment	commitment
polyphenol	polyphenol
dyslipoproteinemia	dyslipoproteinemia
accidents	accident
diarrhea	diarrhea
arthritis	arthritis
half-lifes	half-life
calorie	calorie
mackerels	mackerel
squid	squid
detoxification	detoxification
caloric	caloric
atp(beta	atp
cupping	cup
arvicoline	arvicoline
mangosteen	mangosteen
obliteran	obliteran
signaling	signaling
thrilling	thrilling
2-phenyl-benzopyrans	2-phenyl-benzopyran
mobilization	mobilization
fluorides	fluoride
cancer-fighting	cancer-fighting
cosmetics	cosmetic
arrythmia	arrythmia
cistrons	cistron
tsin	tsin
farmworker	farmworker
pneumonia	pneumonia
microtinae	microtinae
beers	beer
microcapsules	microcapsule
pecan	pecan
x-ray	x-ray
antitoxin	antitoxin
crowberry	crowberry
quindan	quindan
high-risk	high-risk
ulcerous	ulcerous
carnosine	carnosine
worksite	worksite
sweeteners	sweetener
gossypibomas	gossypiboma
milkman	milkman
kangaroo	kangaroo
fluoride	fluoride
score	score
quote	quote
fibroid	fibroid
vagus	vagus
sulfur	sulfur
diagnostic	diagnostic
brakeman	brakeman
casomorphin	casomorphin
appendix	appendix
chanting	chant
apulonga	apulonga
raw	raw
ray	ray
shaking	shake
aruba	aruba
exam	exam
reductionistic	reductionistic
progout	progout
ketchup	ketchup
throat	throat
filbert	filbert
molecules	molecule
4-dihydroxyphenylalanine	4-dihydroxyphenylalanine
digitalization	digitalization
chondrites	chondrite
dollar	dollar
mopping	mop
carica	carica
sarcosporidias	sarcosporidia
aap	aap
sedicepan	sedicepan
kappa-casein	kappa-casein
papaver	papaver
inupiats	inupiat
quercitin	quercitin
tunas	tuna
pleasance	pleasance
photo	photo
parachuting	parachute
rda	rda
abo	abo
swine	swine
gingerol	gingerol
spin	spin
cholecalciferols	cholecalciferol
frankness	frankness
spit	spit
procter	procter
flammulinas	flammulina
duck	duck
chemo/radiation	chemo/radiation
purinol	purinol
ip-82	ip-82
binder	binder
gifts	gift
ada	ada
cathodes	cathode
xenobiotics	xenobiotic
egcg	egcg
phytoestrogens	phytoestrogen
ads	ad
levans	levan
tolid	tolid
tumeric	tumeric
nutmegs	nutmeg
luteine	luteine
trust	trust
vaccines	vaccine
uprooting	uproot
manusept	manusept
soldiers	soldier
soldiery	soldiery
monosodium	monosodium
glitch	glitch
laser	laser
happiness	happiness
scope	scope
paracetamol	paracetamol
feminise	feminise
cocainization	cocainization
testolin	testolin
folvite	folvite
label	label
irritation	irritation
undercooking	undercook
doughnuts	doughnut
transiently	transiently
ulcers	ulcer
age	age
feminist	feminist
popcorn	popcorn
phosgene	phosgene
carbohydrate	carbohydrate
fisher	fisher
defect	defect
muscles	muscle
swish	swish
odds	odds
spoiler	spoiler
chanterelles	chanterelle
tapeworm	tapeworm
eggs	egg
chantry	chantry
pistils	pistil
cetuximab	cetuximab
alkylphenols	alkylphenol
chamomile	chamomile
yeast	yeast
soltamox	soltamox
tarragon	tarragon
curacao	curacao
subfertility	subfertility
defects	defect
sinusitis	sinusitis
hydroponics	hydroponics
vegf-a	vegf-a
astrocytes	astrocyte
aid	aid
ubiquinol	ubiquinol
roselle	roselle
gyrectomy	gyrectomy
portentous	portentous
factor-1	factor-1
retail	retail
glutelins	glutelin
lasik	lasik
bipyridyl	bipyridyl
tacos	taco
enterotypes	enterotype
grains	grain
protoheme	protoheme
meditation	meditation
colocasias	colocasia
pyrexias	pyrexia
gmos	gmo
signing	signing
icing	icing
painfulness	painfulness
spirulina	spirulina
laxatives	laxative
barberries	barberry
odorants	odorant
flexitarians	flexitarian
tryptacin	tryptacin
brains	brain
ala	ala
eczema	eczema
insect	insect
ale	ale
sarcomas	sarcoma
dyslipoproteinemias	dyslipoproteinemia
putrescine	putrescine
pongidae	pongidae
treadmills	treadmill
carotene	carotene
alt	alt
als	al
mcdonalds	mcdonald
breather	breather
ama	ama
delonix	delonix
sadder	sadder
todarode	todarode
uranium	uranium
cathode	cathode
slimness	slimness
cannibalisation	cannibalisation
lesion	lesion
mouthed	mouth
pyrexia	pyrexia
tolerably	tolerably
tenseness	tenseness
antibiotic-resistant	antibiotic-resistant
polychlorocamphene	polychlorocamphene
poroporo	poroporo
altruline	altruline
chlamys	chlamy
weakness	weakness
warts	wart
maggot	maggot
excitotoxins	excitotoxin
blossom	blossom
hordeins	hordein
crib	crib
rpe	rpe
digitalisation	digitalisation
distil	distil
beetroot	beetroot
analogy	analogy
starring	star
zinger	zinger
3-benzylchroman-4-ones	3-benzylchroman-4-one
cribs	crib
zerumbone	zerumbone
neoplasia	neoplasia
catfish	catfish
oxford	oxford
refractivity	refractivity
mg-5'-adenylylimidodiphosphate	mg-5
wy4036	wy4036
flatulence	flatulence
cake	cake
perciformes	perciforme
protein	protein
ape	ape
citronellas	citronella
english	english
axerophthal	axerophthal
ossifications	ossification
transudates	transudate
app	app
tummy	tummy
ncx-911	ncx-911
beta-carotene	beta-carotene
transudate	transudate
l-tryptophan	l-tryptophan
feminisation	feminisation
barbecuing	barbecue
goiaba	goiaba
sea-food	sea-food
anti-acne	anti-acne
toilet	toilet
grade	grade
pseudopelade	pseudopelade
pancreatic	pancreatic
ispaghula	ispaghula
cataracts	cataract
bodywork	bodywork
microwaves	microwave
bhang	bhang
cheeses	cheese
graphitization	graphitization
cortril	cortril
peptides	peptide
meateaters	meateater
odor	odor
sores	sore
cookies	cookie
microwaved	microwave
hypoplasia	hypoplasia
fruits	fruit
cups/day	cups/day
signor	signor
schizophrenias	schizophrenia
patience	patience
smartness	smartness
kids	kid
peppermints	peppermint
plastics	plastic
folivore	folivore
bowel	bowel
meteor	meteor
crater	crater
fruity	fruity
chiroptera	chiroptera
crates	crate
kick	kick
tumor	tumor
harmfulness	harmfulness
stuffing	stuff
ergothioneine	ergothioneine
nonmigrant	nonmigrant
run	run
cans	can
kohlrabi	kohlrabi
senescence	senescence
mother	mother
ate	eat
yams	yam
fibrous	fibrous
meditativeness	meditativeness
atp	atp
eyeful	eyeful
travelling	travel
vasculature	vasculature
barrett	barrett
farmistin	farmistin
thalomid	thalomid
harmful.34	harmful
holland	holland
steviosides	stevioside
mold	mold
kombus	kombus
volunteer	volunteer
yale	yale
neoplasms	neoplasm
cocainisation	cocainisation
surquina	surquina
crunch	crunch
adventist-2	adventist-2
mood	mood
alli	alli
book	book
dromedaries	dromedary
kicking	kick
mk-217	mk-217
perplexity	perplexity
acids	acid
epsilon-casein	epsilon-casein
thiomersal	thiomersal
nozucar	nozucar
analogous	analogous
sensing	sense
homosildenafil	homosildenafil
emitting	emit
beta-carotene-3	beta-carotene-3
adherent	adherent
fructose	fructose
bone	bone
newborn	newborn
aneurin	aneurin
zoophaginae	zoophaginae
seating	seat
mouth	mouth
arthropathy	arthropathy
kalaallits	kalaallit
bony	bony
moms	mom
grippe	grippe
prevalences	prevalence
orobronze	orobronze
rye	rye
leader	leader
apoe4	apoe4
heartbeat	heartbeat
pvp-iodine	pvp-iodine
lorazepam-neuraxpharm	lorazepam-neuraxpharm
leaden	leaden
cart	cart
subscribed	subscribe
mesothelium	mesothelium
apolorazepam	apolorazepam
auditory	auditory
larva	larva
cerebellums	cerebellum
eggbeater	eggbeater
carb	carb
winemaking	winemaking
images	image
dizziness	dizziness
subscriber	subscriber
pancreozymin	pancreozymin
et-nanbh	et-nanbh
adulterer	adulterer
wolfberry	wolfberry
phone	phone
allohexal	allohexal
allohexan	allohexan
belladonna	belladonna
glaciers	glacier
b-12	b-12
myristate	myristate
feminine	feminine
lavandula	lavandula
exercise	exercise
bleeder	bleeder
adulterous	adulterous
aptitude	aptitude
cooking	cooking
zoonotic	zoonotic
mastication	mastication
celtics	celtic
menstruations	menstruation
origanum	origanum
anytime	anytime
glycogen	glycogen
intoxicant	intoxicant
aloe	aloe
kill	kill
tablespoon	tablespoon
disorder	disorder
nasa	nasa
semi-sweet	semi-sweet
cats	cat
reisegold	reisegold
playthings	plaything
perfluorochemicals	perfluorochemical
dinnertime	dinnertime
uganda	uganda
yerba	yerba
homeopathy	homeopathy
hunters	hunter
cytophagales	cytophagale
plaque	plaque
bout	bout
microgreen	microgreen
rectal/anal	rectal/anal
ki-67	ki-67
parkinsonism	parkinsonism
sealant	sealant
chants	chant
arterialization	arterialization
parsleys	parsley
enterocytes	enterocyte
trompillo	trompillo
urethras	urethra
talent	talent
l-glutamate	l-glutamate
nervy	nervy
plaques	plaque
desmethylsildenafil	desmethylsildenafil
kink	kink
consultations	consultation
alphadines	alphadine
popkin	popkin
glutens	gluten
greenery	greenery
nerve	nerve
rooibo	rooibo
3-benzylidene-4-chromanones	3-benzylidene-4-chromanone
megacolons	megacolon
toxicant	toxicant
brainwave	brainwave
leucoanthocyanidins	leucoanthocyanidin
malaria	malaria
tanning	tan
aflatoxins	aflatoxin
database	database
eggplants	eggplant
patient	patient
malus	malus
l-arginine	l-arginine
microgreens	microgreen
canthaxanthin	canthaxanthin
authentication	authentication
sap	sap
disclosed	disclose
itchiness	itchiness
laminaria	laminaria
sat	sit
gerson-style	gerson-style
sandwich	sandwich
mk803	mk803
dimethylbiguanidine	dimethylbiguanidine
nafld	nafld
lipotoxicty	lipotoxicty
purines	purine
depression	depression
meat-free	meat-free
angina	angina
mussel	mussel
boys	boy
bag	bag
trigylceride	trigylceride
kiss	kiss
zsweet	zsweet
ban	ban
mackerel	mackerel
nazi	nazi
lignan	lignan
dynamite	dynamite
midazolam	midazolam
anemias	anemia
portend	portend
intima	intima
leprosy	leprosy
mishmash	mishmash
autophagy	autophagy
cyclamate	cyclamate
maxcaro	maxcaro
arthralgias	arthralgia
artery	artery
sweetener	sweetener
spilth	spilth
infarct	infarct
symptoms	symptom
bbq	bbq
lowest-protein	lowest-protein
echotomography	echotomography
influenzas	influenza
suicides	suicide
aaron	aaron
chemical	chemical
cestodas	cestoda
indigestions	indigestion
sulawesi	sulawesus
affect	affect
icon	icon
phages	phage
polopiryna	polopiryna
eyes	eye
osteoarthroses	osteoarthrose
icterus	icterus
tastefulness	tastefulness
wheat	wheat
deceptiveness	deceptiveness
metabolic	metabolic
3-hydroxy-l-tyrosine	3-hydroxy-l-tyrosine
seafood	seafood
tremor	tremor
fluorination	fluorination
amentia	amentia
nonus	nonus
gooses	goose
sweetleafs	sweetleaf
portent	portent
caryas	carya
nausicalm	nausicalm
diagnose	diagnose
craziness	craziness
eyed	eye
plasticizer	plasticizer
hawthorns	hawthorn
purging	purge
kiwi	kiwi
african-americans	african-american
dvds	dvd
baking	bake
endometrioma	endometrioma
chernobyl	chernobyl
butchering	butcher
ethanal	ethanal
smoothie	smoothie
encephalopathies	encephalopathy
transcripts	transcript
vomacur	vomacur
butter-flavored	butter-flavored
cephalalgia	cephalalgia
butyrate-producing	butyrate-producing
internets	internet
maninil	maninil
ondatra	ondatra
persimmon	persimmon
roasting	roast
colectomy	colectomy
medicative	medicative
eyeball	eyeball
toxoplasmas	toxoplasma
deer	deer
fenactil	fenactil
deen	deen
killers	killer
checkers	checkers
neuroprotective	neuroprotective
drippings	dripping
hesperidin	hesperidin
sid	sid
neuropsychiatry	neuropsychiatry
osteoarthrosis	osteoarthrosis
synuclein	synuclein
lemon	lemon
depressions	depression
mastictrees	mastictree
bha	bha
sip	sip
sit	sit
homocysteine	homocysteine
phenopromin	phenopromin
lysuron	lysuron
valium	valium
breathing	breathing
imaginativeness	imaginativeness
lymphoma	lymphoma
stroke	stroke
dairying	dairy
aortas	aorta
pyramid	pyramid
cashews	cashew
tetrodotoxin	tetrodotoxin
bin	bin
hominidae	hominida
bit	bit
clipboard	clipboard
antiplatelet	antiplatelet
pimpinellas	pimpinella
phytosterol	phytosterol
cranberries	cranberry
mentha	mentha
imagery	imagery
mitochondrial	mitochondrial
hashish	hashish
phip	phip
gossypiboma	gossypiboma
sle	sle
practitioners	practitioner
refinance	refinance
butacote	butacote
lipocytes	lipocyte
u.s	u.s
nasale	nasale
instillation	instillation
crystal	crystal
microgram	microgram
quokkas	quokka
phenamine	phenamine
sensitisation	sensitisation
tomaxithen	tomaxithen
peoria	peoria
commentator	commentator
amif72	amif72
pharmacopuncture	pharmacopuncture
soybean	soybean
ovis	ovis
paella	paella
low-carb	low-carb
armpits	armpit
blv	blv
exposures	exposure
anacin-3	anacin-3
parkinson’s	parkinson
beta-carboline	beta-carboline
anthropoidea	anthropoidea
bmi	bmi
cortisone	cortisone
cryptoxanthin	cryptoxanthin
toying	toy
estrogen	estrogen
toothbrush	toothbrush
coloration	coloration
bragging	brag
carotaben	carotaben
anger	anger
deli	deli
mutations	mutation
jodid-ratiopharm	jodid-ratiopharm
encephalons	encephalon
rutoside	rutoside
zorprin	zorprin
(+)-cyanidanol-3	-lrb-
sushi	sushi
soy	soy
deafness	deafness
petroleum	petroleum
encephalon	encephalon
rimapurinol	rimapurinol
roux-en-y	roux-en-y
thrown	throw
throws	throw
starfield	starfield
citronella	citronella
sipping	sip
bob	bob
nutritionfacts	nutritionfact
tense	tense
capsin	capsin
bok	bok
arterenol	arterenol
meteorites	meteorite
wallaroo	wallaroo
boy	boy
obesogens	obesogen
hypercholesterolemias	hypercholesterolemia
hispanics	hispanic
phytoestrogen	phytoestrogen
premarin	premarin
bpa	bpa
levodopa	levodopa
gangrene	gangrene
hazelnuts	hazelnut
bph	bph
dermatoses	dermatosis
signalization	signalization
alpha(s1)-casein	alpha
tearful	tearful
excitotoxin	excitotoxin
miscarriage	miscarriage
carcinogen	carcinogen
medication	medication
desensitization	desensitization
apricot	apricot
convulsions	convulsion
chondrite	chondrite
disadines	disadine
chicanos	chicano
dancing	dancing
arachidonic	arachidonic
stool	stool
colophospermum	colophospermum
hemicrania	hemicrania
pains	pain
b-cell	b-cell
heroism	heroism
7-chloro-1	7-chloro-1
bluegills	bluegill
apricots	apricot
mushroom	mushroom
animal-to-human	animal-to-human
pre-pregnancy	pre-pregnancy
alcohol	alcohol
hiccups	hiccup
std	std
tissues	tissue
pleasure	pleasure
alpha(s2)-casein	alpha
crystallizes	crystallize
dermatosis	dermatosis
dent	dent
australia	australia
kinks	kink
solanums	solanum
secondary	secondary
aches	ache
probiotic	probiotic
canthaxanthine	canthaxanthine
servicemen	serviceman
bse	bse
doctors	doctor
shooter	shooter
dosage	dosage
reactance	reactance
mammectomies	mammectomy
cspi	cspus
jogging	jogging
osteogenesis	osteogenesis
manganese	manganese
sun	sun
alcoholization	alcoholization
serving	serve
ornish	ornish
polyamine	polyamine
copper	copper
servicing	servicing
slipping	slip
gamma-imino-atp	gamma-imino-atp
honeycrisp	honeycrisp
tranquilizers	tranquilizer
bug	bug
thorazine	thorazine
mcdonald's	mcdonald
prioresses	prioress
polyphenols	polyphenol
testim	testim
petroselinum	petroselinum
nsrc	nsrc
sucralose	sucralose
480-10	480-10
ovum	ovum
testis	testis
amla	amla
stressors	stressor
requiem	requiem
laminarias	laminaria
endostatin	endostatin
seizures	seizure
cocoanuts	cocoanut
fragments	fragment
passion	passion
hypervigilance	hypervigilance
galactose	galactose
trimester	trimester
mitochondrion	mitochondrion
excitability	excitability
ocean	ocean
lyssas	lyssa
desk	desk
coriandrums	coriandrum
warthogs	warthog
doing	do
deva	deva
clotting	clot
cuttlefishs	cuttlefish
foxglove	foxglove
goitrogen	goitrogen
thyro-block	thyro-block
malformations	malformation
coldness	coldness
iddm	iddm
prkaa	prkaa
taros	taro
fagopyrum	fagopyrum
turnover	turnover
sepiidae	sepiidae
ubiquinone	ubiquinone
skin-enhancing	skin-enhancing
immunoglobulin	immunoglobulin
paratb	paratb
airway	airway
myocyte	myocyte
calories	calorie
almonds	almond
stone	stone
passing	pass
shampoo	shampoo
yogurt	yogurt
leucocythaemias	leucocythaemia
2'-bipyridine	2
ampk	ampk
cheerio	cheerio
herbalife-induced	herbalife-induced
tiresomeness	tiresomeness
bumping	bump
physicians	physician
igf-i	igf-i
children	child
diverticulitis	diverticulitis
radioactivity	radioactivity
cyanopsia	cyanopsia
epicortisol	epicortisol
absorbate	absorbate
heredity	heredity
squids	squid
zoonosis	zoonosis
hirsuteness	hirsuteness
diketobutane	diketobutane
thrombocyte	thrombocyte
non-gmo	non-gmo
tranquillity	tranquillity
reductases	reductase
tuft	tuft
emerogenes	emerogene
sensitivity	sensitivity
epitheliomas	epithelioma
nanomoles	nanomole
polyradiculoneuritides	polyradiculoneuritide
prelestrin	prelestrin
vegetable-enhanced	vegetable-enhanced
haem	haem
tranquillization	tranquillization
flax	flax
snacktimes	snacktime
recall	recall
igf-1	igf-1
carcinogens	carcinogen
sickening	sicken
acetominophen	acetominophen
guibourtia	guibourtia
meteoroid	meteoroid
enamel	enamel
erythrocuprein	erythrocuprein
mptp	mptp
gamma666	gamma666
apnea	apnea
paludism	paludism
emotion	emotion
prescription	prescription
l-tryptophan-ratiopharm	l-tryptophan-ratiopharm
testes	testis
antacids	antacid
multivitamins	multivitamin
cementoclast	cementoclast
chanter	chanter
bluegill	bluegill
contomin	contomin
hysterectomy	hysterectomy
pro-oxidants	pro-oxidant
sandwiches	sandwich
rapamune	rapamune
enlargement	enlargement
excitation	excitation
cobalamins	cobalamin
sage	sage
draconian	draconian
low-vegetable	low-vegetable
obliterans	obliteran
tan	tan
tap	tap
patients	patient
salmon	salmon
zoonoses	zoonosis
tax	tax
lovers	lover
desoxynorephedrin	desoxynorephedrin
tendon	tendon
parachutist	parachutist
contramareo	contramareo
chicanas	chicana
herbivores	herbivore
slipperiness	slipperiness
serviceman	serviceman
cestodes	cestode
tuna	tuna
coq10	coq10
sirtuins	sirtuin
gustations	gustation
hepatotoxins	hepatotoxin
tums	tum
erythroxylons	erythroxylon
taxing	tax
bellman	bellman
cat	cat
pmslindane	pmslindane
chick-fil-a	chick-fil-a
glacier	glacier
stamps	stamp
nondairy	nondairy
cestode	cestode
bulges	bulge
solanum	solanum
cestoda	cestoda
mitochondria	mitochondria
fault	fault
solatene	solatene
reticuloendotheliosis	reticuloendotheliosis
proteinurias	proteinuria
fragment	fragment
glucobay	glucobay
fining	fine