
dried fruit	diabetes related complications	0
corn	utp hexose 1 phosphate uridylyltransferase deficiency disease	0
raisin	pediatric obesity	0
barley	carcinogenese	0
wheat	breast malignant neoplasms	0
avocado	resting tremor	0
whole grains	mastodynia	0
apple juice	dyslipidemia	0
lentil	myocardial infarcts	0
sea vegetables	breast malignant neoplasm	0
gluten	dysmenorrhea	0
almond	cardiac sudden death	0
whipped cream	gastric cancers	0
peppermint	cancer of the rectum	0
coconut oil	colitis	0
seed	neurologic degenerative diseases	0
walnut	human t-cell lymphotropic virus type iii	0
prebiotic	age related macular degeneration	0
nutritional yeast	colon neoplasm	0
soy	inflammatory polyneuropathy acute	0
lavender	penile neoplasms	0
processed meats	amnesia-memory loss	0
soft drinks	high-grade lymphoma	0
split peas	diffuse undifferentiated lymphomas	0
almond milk	senile tremors	0
fig	epstein barr virus	0
dessert	odontogenic keratocysts multiple basal cell nevi	0
carob	acquired immunodeficiency syndrome virus	0
strawberry	obesity	0
vitamin	galactose 1 phosphate uridylyltransferase deficiency	0
cooking meat	juvenile parkinson disease	0
french fries	human mammary carcinoma	1
junk food	chronic fatigue disorder	0
sweet potatoes	deaf-mutism	0
sesame seeds	burkitt lymphoma virus	0
hop	bilateral headache	0
tuna	pulmonary inflammation	0
turmeric	postviral fatigue syndromes	0
food poisoning	common cold	0
brown rice	ekbom dermatozoic delusion	0
bt corn	bone fractures	0
broccoli	ankylosing spondyloarthritides	0
tea	age-related bone loss	0
bacon	ulcerative colitis type inflammatory bowel disease	0
oatmeal	testicular cancer	0
poultry	muscle spasms	0
whole foods	germinoblastic sarcoma	0
processed meat	vaginal neoplasm	0
aspartame	chronic b cell leukemia	0
cooked meat	food-borne illnesses	0
cheese	periodontal diseases	0
drinking water	pulmonary inflammations	0
beef	lobar pneumonias	1
alfalfa	crohns disease	0
skim milk	drug habituation	0
corn syrup	deafness	0
nut	chronic airflow obstruction	0
chocolate	retained surgical tools	0
apple	parkinsonian syndrome	0
dairy products	infant botulisms	0
soy milk	bovine leukemias	0
egg	utp hexose 1 phosphate uridylyltransferase deficiency	0
flaxseed	coarse tremors	0
pork	widespread chronic pains	0
processed foods	lung cancer	0
kale	breast tumors	1
beer	strain	0
tomato	secondary fibromyalgia	0
nettle tea	chronic lymphoblastic leukemias	0
breast milk	rectal tumors	0
grapefruit	prion induced disorder	0
bean	spondylitis ankylopoietica	0
seafood	coronary diseases	0
miso	familial juvenile parkinsonism	0
alcoholic beverages	anaplastic carcinoma	0
celery	parodontosis	0
fruit juice	subacute spongiform encephalopathies	0
eating nuts	hypercholesteremia	0
chicken	drug habituation	0
milk	cjd (creutzfeldt-jakob disease)	0
flax seeds	prostate neoplasm	0
curry powder	vulva cancer	0