
processed foods	peripheral autoimmune demyelinating disease	0
sesame seeds	nonalcoholic fatty livers	0
tuna	undifferentiated carcinoma	0
soft drinks	arterial fatty streak	0
nettle tea	stomach ulcers	0
soy milk	rectal tumor	0
coconut oil	mottled enamels	0
bt corn	human influenzas	0
dessert	tick bite	0
tea	crohns disease	0
sweet potatoes	aura	0
processed meats	thermal hypesthesias	0
gluten	necrotizing fasciitides	0
avocado	marie struempell disease	0
walnut	pancreatitis	0
curry powder	milk sugar intolerance	0
oatmeal	thermal hypesthesias	0
seed	post ictal confusion	0
soy	carcinogenesis	0
cooking meat	varix	0
skim milk	mania	0
fruit juice	acquired immunodeficiency syndrome virus	0
fig	vulva neoplasm	0
whipped cream	autosomal dominant juvenile parkinson disease	0
beer	intervertebral disk degeneration	0
alfalfa	tussive syncope	0
peppermint	male breast cancer	0
kale	migraine	0
vitamin	senile plaques	0
eating nuts	communicable diseases	0
nutritional yeast	sexual dysfunction	0
poultry	diabetic retinopathies	0
beef	mild neurocognitive disorders	1
prebiotic	hyperpigmentation	0
food poisoning	intraepithelial neoplasm	0
almond milk	sleeplessness	0
lentil	gastric acid reflux disease	0
strawberry	sneeze	0
lavender	insomnia disorder	0
corn	carcinogenic retroviruses	0
cheese	throbbing headache	0
aspartame	manic-depressive psychoses	0
nut	plasma-cell myelomas	0
flax seeds	arrhythmia	0
apple	bacterial vaginitides	0
breast milk	cervix cancer	0
flaxseed	spinal cord disease	0
brown rice	ductal carcinoma	0
whole foods	coma	0
almond	degenerative neurologic disease	0
miso	intraepithelial prostatic neoplasias	0
split peas	prediabetic state	0
pork	develop cancer	0
processed meat	brain disease	0
drinking water	insulin resistance	1
chicken	malignant lymphoma	0
french fries	hyperventilation syncope	0
sea vegetables	virus diseases	0
whole grains	common bile duct calculi	0
cooked meat	pregnancy induced diabetes	0
bacon	blood cancer	0
barley	cancer of the penis	0
egg	diabetic complication	0
broccoli	benign neoplasm	0
turmeric	bovine lymphosarcomas	0
junk food	nausea	0
milk	bipolar depression	0
hop	common cold	0
seafood	epithelioma	0
corn syrup	brain malignant neoplasms	0
dairy products	micturition syncopes	0
alcoholic beverages	fibrous meningioma	0
bean	cancer of the vagina	0
grapefruit	prion-induced disorders	0
apple juice	diabetic asymmetric polyneuropathies	0
carob	cerebrovascular accidents	0
tomato	diffuse well differentiated lymphocytic lymphoma	0
celery	monocular blindness	0
dried fruit	fibromyoma	0
wheat	bacterial vaginitis	0
chocolate	drug dependence	0
raisin	foodborne diseases	0