
lavender	rickets	0
avocado	gum disease	0
fruit juice	open head injury	0
carob	type c oncovirus	0
flaxseed	icterus	0
barley	retained surgical item	0
seed	diffuse mixed-cell lymphomas	0
dessert	fatty liver	0
almond	dyslipidemia	0
apple juice	oral cancers	0
tea	atherosclerotic plaques	0
sea vegetables	pulmonary neoplasms	0
bt corn	pancreatitis	0
oatmeal	autistic disorders	0
drinking water	vulva neoplasms	0
tuna	malignant tumor of urinary bladder	0
french fries	atrial fibrillation	0
split peas	vulvar cancers	0
peppermint	benign prostatic hyperplasia	0
soy	pancreatic neoplasms	0
poultry	foreign object	0
cooked meat	cancer of the kidney	0
soft drinks	chronic illness	0
dried fruit	painful menstruations	0
prebiotic	bilateral deafness	0
strawberry	gastric cancer	0
corn syrup	back pains	0
beer	salmonellosis	0
coconut oil	disseminated sclerosis	0
walnut	postviral fatigue syndromes	0
turmeric	thyroid neoplasm	0
grapefruit	smell disorder	0
fig	auricular fibrillation	0
seafood	reticulosarcoma	0
bean	breast neoplasm	0
bacon	heart decompensation	0
flax seeds	muscle spasms	0
broccoli	mammary cancers	1
almond milk	broken bones	0
nettle tea	wheat hypersensitivities	0
dairy products	bovine lymphoma	0
whole foods	gall bladder diseases	0
nut	graveâ€™s disease	0
milk	undifferentiated carcinoma	0
soy milk	gingivitis	0
celery	gastric cancer	0
sesame seeds	proteinuria	0
pork	rabies	0
curry powder	endometrium carcinoma	0
aspartame	chronic cystic mastitis	0
processed meat	food hypersensitivity	0
cheese	cluster headache syndrome	0
egg	infantile autism	0
nutritional yeast	substance abuses	0
chicken	visceral steatoses	0
food poisoning	pulmonary thromboembolism	0
eating nuts	dermatosis	0
miso	periorbital headache	0
apple	cancer of the bladder	0
processed foods	sterility	0
alfalfa	chronic lymphoblastic leukemia	0
tomato	impotence	0
processed meats	cll lymphoplasmacytoid lymphomas	1
alcoholic beverages	wound botulisms	0
whole grains	uterine cervical neoplasms	0
skim milk	retroviridae	0
chocolate	kidney disease	0
breast milk	food borne diseases	0
vitamin	headache syndromes	0
lentil	fights cancer	0
wheat	medical conditions	0
corn	proliferative bronchiolitis	0
beef	dwarfism	0
sweet potatoes	guam form amyotrophic lateral sclerosis	0
brown rice	amnesia-memory loss	0
raisin	liver dysfunctions	0
cooking meat	lumbago	0
whipped cream	esophageal neoplasm	0
hop	ponv	0
kale	hiatus hernia	0
junk food	drug hypersensitivities	0
gluten	schizophrenic disorders	0