
cooked meat	guillaine-barre syndrome	0
bacon	canker sore	0
nut	non-hodgkin lymphoma	0
beef	sudden cardiac arrests	0
tuna	disc degeneration	0
nettle tea	anoxemia	0
seafood	polyarthritide	0
chocolate	senile osteoporosis	0
celery	diffuse well-differentiated lymphocytic lymphoma	0
processed meat	degenerative disease	0
sweet potatoes	cacosmia	0
whole grains	cardiac failure	0
dairy products	sleep disorders	0
cheese	autosomal dominant. juvenile parkinson disease	0
lentil	exanthema	0
carob	amyloid plaques	0
avocado	ekbom delusional parasitosis	0
flax seeds	cancer of skin	0
skim milk	t viruses	0
whole foods	cancer of vulva	0
processed foods	renal failure	0
egg	macular dystrophy	0
chicken	senile plaques	0
strawberry	reverse cancer	0
dessert	marek's disease virus	0
tea	orf	0
fruit juice	hypospadia	0
flaxseed	weight reductions	0
food poisoning	episodic cluster headaches	0
bean	stomach neoplasm	0
wheat	reticulolymphosarcoma	0
soft drinks	muscle cramps	0
junk food	aphthous ulcer	0
dried fruit	anal fissure	0
alfalfa	peripheral arterial diseases	0
sea vegetables	acute monoblastic leukemias	0
whipped cream	heart decompensation	0
beer	galactokinase deficiency	0
breast milk	kidney calculus	0
walnut	multiple head injuries	0
prebiotic	amaurose	0
miso	small lymphocytic lymphoma	0
brown rice	dental fluoroses	0
gluten	leukovirus	0
pork	food-borne disease	0
alcoholic beverages	thyroid disorders	0
corn	gangrene	0
peppermint	prion-associated disorders	0
soy	gale deficiency	0
turmeric	respiratory tract cancer	0
oatmeal	mixed cell lymphoma	0
tomato	ms (multiple sclerosis)	0
curry powder	liver cancers	0
apple	elevated cholesterols	0
barley	western diseases	0
hop	acute stroke	0
milk	obesity	1
aspartame	breast disease	0
corn syrup	penile cancers	0
cooking meat	generalized seizure	0
soy milk	diverticulitis	0
drinking water	cancer of rectum	0
grapefruit	prostatic intraepithelial neoplasias	0
seed	small-cell lymphoma	0
almond milk	malignant epithelial neoplasms	0
sesame seeds	drug dependence	0
processed meats	death	1
eating nuts	frontal region trauma	0
lavender	gastric neoplasms	0
raisin	foodborne botulisms	0
almond	vulva cancers	0
nutritional yeast	drug dependence	0
vitamin	philadelphia-negative myeloid leukemias	0
poultry	bacteriophage	0
fig	early awakening	0
bt corn	overeat	0
apple juice	schizoaffective disorder	0
kale	arterial dysfunction	0
french fries	impaired sensation	0
broccoli	dyspepsia	0
split peas	menstrual pains	0
coconut oil	artery disease	0