
corn	bovine lymphomas	0
tea	postoperative vomiting	0
food poisoning	galactose-1-phosphate uridylyltransferase deficiencies	0
fig	foodborne illnesses	0
prebiotic	sarcopenia	0
aspartame	dermatosis	0
processed meat	eye disease	0
nutritional yeast	orf	0
almond milk	spongiform encephalopathies	0
dairy products	esophagus neoplasm	0
egg	catarrh	0
brown rice	diarrhea	0
processed meats	cerebrovascular strokes	0
pork	pulmonary cancers	0
bean	overeat	0
milk	ovarian cancers	0
nut	galactosemia iiis	0
oatmeal	parodontosis	0
breast milk	primary fibromyalgias	0
barley	acidosis	0
alcoholic beverages	asymmetric diabetic proximal motor neuropathy	0
wheat	esophagitis	0
broccoli	rupture	0
chocolate	arterial fatty streak	0
seed	age-related bone loss	0
raisin	female subfertility	0
carob	chronic insomnia	0
junk food	hepatocellular cancers	0
apple	gastric neoplasm	0
drinking water	chicken virus	0
lentil	malignant melanomas	0
walnut	acute cerebrovascular accident	0
alfalfa	premenstrual syndrome	0
soy milk	gingivitide	0
sesame seeds	feline leukemia viruses	0
bacon	semirhythmic tremor	0
dried fruit	xanthomatous meningiomas	0
miso	encephalon disease	0
grapefruit	malignant primary brain neoplasms	0
lavender	autosomal recesssive juvenile parkinsonism	0
avocado	pleomorphic lymphoma	0
split peas	cardiovascular diseases	0
whole grains	alcoholism	0
whipped cream	venous thromboses	0
sweet potatoes	penile neoplasms	0
beef	dementia with amyotrophic lateral sclerosis	0
fruit juice	cancer of lung	0
processed foods	feline lymphoma virus	0
tomato	headache disorders	0
cheese	hiatus hernia	0
flax seeds	pancreatitide	0
peppermint	action tremors	0
corn syrup	somatosensory seizures	0
hop	oncogenese	0
french fries	suppuration	0
skim milk	nonalcoholic steatohepatitis	0
vitamin	gastro-esophageal reflux	0
curry powder	intertrochanteric fractures	0
cooking meat	wart	0
dessert	experimental lung inflammations	0
gluten	postoperative nausea	0
celery	lyssa	0
almond	olfaction disorders	0
whole foods	galactosemia 3	0
nettle tea	retro-ocular headache	0
strawberry	anal ulcer	0
chicken	familial dementias	0
bt corn	open head injuries	0
cooked meat	nonalcoholic fatty liver	0
eating nuts	medical conditions	0
sea vegetables	dysmenorrhea	0
soy	osteoarthritide	0
flaxseed	blindness	0
poultry	mental disorder	0
apple juice	sudden-onset diabetes mellitus	0
beer	lav-htlv-iii	0
tuna	vulva neoplasms	0
coconut oil	verruca	0
soft drinks	male sterility	0
turmeric	acquired immune deficiency syndrome virus	0
seafood	spindle cell carcinoma	0
kale	gastro oesophageal reflux	0