
corn	age related bone loss	0
junk food	toxico-infectious botulism	0
dried fruit	brain tumor	0
nutritional yeast	newborn gynecomastia	0
processed foods	autosomal recessive juvenile parkinson disease 2	0
whipped cream	ekbom psychogenic parasitosis	0
soft drinks	acute inflammatory demyelinating polyradiculoneuropathy	0
hop	porcine endogenous retroviruses	0
whole foods	barrett's esophagus	0
gluten	avian leukosis/sarcoma virus	0
soy	hysterical blindness	0
split peas	male sterility	0
french fries	necrotizing fasciitis	0
milk	liver injury	0
cooked meat	skin cancers	0
skim milk	influenza in human	0
fig	fights cancer	0
processed meat	nephrolith	0
beer	human cancer	0
oatmeal	weight reduction	0
whole grains	galactose-1-phosphate uridylyltransferase deficiencies	0
tea	mottled enamels	0
peppermint	renal calculi	0
tomato	herpesvirus	0
pork	fatty liver disease	0
prebiotic	schizophreniform disorders	0
seafood	social phobias	0
lavender	gale deficiencies	0
nut	crohns disease	0
miso	acromegaly	0
nettle tea	papillomaviridae	0
bacon	generalized spasms	0
celery	bladder tumors	0
tuna	atypical cluster headaches	0
eating nuts	milk sugar intolerance	0
grapefruit	dysosmia	0
wheat	nonalcoholic steatohepatitides	0
broccoli	milk sugar intolerance	0
food poisoning	microlissencephaly	0
egg	diffuse small cleaved cell lymphoma	0
flax seeds	breast diseases	0
brown rice	premenstrual syndrome	0
beef	substance-related disorders	0
raisin	respiratory tract infection	0
carob	secondary fibromyalgia	0
apple juice	galt deficiency	0
curry powder	gluten sensitive enteropathy	0
bean	texidor's twinge	0
sesame seeds	age-related bone loss	0
soy milk	juvenile parkinson disease	0
seed	morning sickness	0
walnut	arthritis	0
processed meats	vagina cancer	0
flaxseed	spatial memory disorders	0
apple	viral infections	0
chocolate	hiccup	0
coconut oil	acute infectious polyneuritis	0
bt corn	intermittent tremor	0
aspartame	memory deficit	0
cooking meat	sinusitis	0
poultry	visceral steatoses	0
corn syrup	pseudopelade	0
dessert	plegia	0
sweet potatoes	gerd	0
drinking water	juvenile-onset diabetes mellitus	0
vitamin	polyradiculoneuritide	0
sea vegetables	adolescent obesity	0
strawberry	hypoascorbemia	0
dairy products	prostatic neoplasm	1
alcoholic beverages	uterine cancer	0
cheese	poisoning	0
alfalfa	degenerative arthritis	0
almond milk	visceral obesity	0
avocado	prostatic neoplasm	0
fruit juice	diabetic polyneuropathies	0
almond	parkinsonian diseases	0
turmeric	static tremors	0
lentil	bone fracture	0
barley	ocular headaches	0
kale	tying disease	0
chicken	essential tremors	0
breast milk	sleep disorder	0