
prebiotic	osteoporosis	0
celery	papillary meningiomas	0
seed	neurologic degenerative disease	0
broccoli	chronic b-lymphocytic leukemias	0
grapefruit	barrett's syndrome	0
skim milk	senile tremor	0
alcoholic beverages	temporal region traumas	0
junk food	influenza in humans	0
avocado	cancer of the breast	0
vitamin	back ache	1
dairy products	thrombosis	0
kale	food hypersensitivities	0
french fries	stomach ulcer	0
processed foods	food hypersensitivities	0
gluten	intervertebral disc degeneration	0
bean	pediatric obesity	0
fruit juice	iddm	1
almond milk	deformity	0
food poisoning	low backaches	0
cooking meat	huntingtons disease	0
dessert	chronic b-lymphocytic leukemias	0
chicken	high cholesterol levels	0
nettle tea	galactose-1-phosphate uridyltransferase deficiencies	0
processed meat	brain vascular accident	0
sweet potatoes	crohn's enteritis	0
processed meats	atrioventricular dissociations	0
corn	colorectal carcinoma	0
oatmeal	tonsillar cancer	0
soy milk	galactose-1-phosphate uridyltransferase deficiency	0
beef	retained surgical instruments	0
coconut oil	small lymphocytic lymphoma	0
turmeric	infantile colic	0
peppermint	miscarriage	0
miso	gasser's syndrome	0
whole foods	urinary bladder diseases	0
apple	disk degeneration	0
whole grains	gustatory seizure	0
alfalfa	sprain	0
whipped cream	bacterial vaginoses	0
curry powder	gluten-sensitive enteropathy	0
aspartame	familial tremors	0
bacon	essential tremor	0
pork	drug abuse	0
sesame seeds	non epileptic convulsion	0
barley	ovarian cancers	0
raisin	bacterial vaginoses	0
lentil	early diagnosis of cancer	0
chocolate	colicky pains	0
split peas	acute monocytic leukemia	0
breast milk	menstrual pains	0
milk	sharp headaches	0
drinking water	emphysema	0
sea vegetables	cacosmia	0
bt corn	feline leukemia virus	0
nutritional yeast	severe congenital microcephalies	0
fig	autistic disorder	0
almond	back pain without radiation	0
tomato	lymphoblastic leukemia	0
carob	retained surgical needles	0
lavender	paraosmia	0
dried fruit	oral neoplasms	0
wheat	infertility	0
walnut	hyperpigmentation	0
egg	sick headaches	0
apple juice	lung disorders	0
beer	occipital traumas	0
poultry	sleep wake disorder	0
nut	foodborne illnesses	0
seafood	growth hormone receptor deficiency	0
tuna	hereditary galactokinase deficiencies	0
hop	sea sickness	0
flax seeds	acute myeloid leukemia	0
flaxseed	occipital region trauma	0
cheese	lou gehrig's disease	0
brown rice	determination of death	0
corn syrup	breast malignant tumors	0
tea	brain cysticercosis	0
cooked meat	liver neoplasm	0
strawberry	central nervous system cysticercosis	0
soy	jakob-creutzfeldt disease	0
soft drinks	myocardial infarctions	0
eating nuts	rabies virus	0