
wine	galactose-1-phosphate uridylyltransferase deficiencies	0
bread	drug dependence	0
sweet almond	microcystic meningiomas	0
phyllanthus emblicas	deformity	0
açaí berry	parkinsonian diseases	0
four nuts	cervix neoplasms	0
assai palm berry	brittle diabetes mellitus	0
color	hepatitis e	0
sesame	spatial memory disorders	0
white rice	gale deficiency	0
baked potato	ciliary body spasms	0
replenish nutrients	oral cancers	0
sea vegetables	substance-induced organic mental disorders	0
trigonella	kidney insufficiencies	0
mangifera indicas	cancer of the tongue	0
cold-steeping tea	crushing skull injuries	0
foeniculum vulgare	steatohepatitis	0
chili	inner ear cancer	0
dairy product	migratory pain	0
theobroma cacao	venous thromboses	0
bottled water	trochanteric fractures	0
origanum majorana	thyroid cancer	0
bolete	inflammatory bowel diseases	0
emphasizes vegetables	e-b viruses	0
hibiscus cannabinus	spinal cord disorder	0
psyllium	parietal region trauma	0
chipotle	degenerative intervertebral disk	0
miso	prostate neoplasms	0
punica granatum	cramp	0
arachis hypogaea	early infantile autism	0
low vitamin	drop attack	0
thymus plants	colon neoplasm	0
baker's yeast	involutional osteoporosis	0
eugenia sandwicensis	limb cramps	0
mashed potatoes	nerve tremor	0
black teas	inflammatory polyneuropathy acutes	0
pine nuts	micturition syncopes	0
eragrostis	leukovirus	0
fatty foods	acute infectious polyneuritis	0
green peas	acute inflammatory polyneuropathies	0
chilli peppers	colonic cancers	0
goiaba	sudden cardiac death	0
ready prepared foods	premature aging	0
wolfberry	hemolytic jaundices	0
bean sprouts	higher cancer	0
fresh meat	aphthous ulcer	0
sesame seeds	crohn’s disease	0
tachigalia	olfactory seizure	0
warm milk	mixed lymphocytic-histiocytic lymphoma	0
juiced broccoli	disorder	0
shiitake mushrooms	testis neoplasms	0
white mallows	kanners syndrome	0
amaranth	benign neoplasm	0
ocimum basilicum	crib death	0
soy protein	familial dementia	0
fried foods	uterine cervical neoplasms	0
red yeast rice	utp-hexose-1-phosphate uridylyltransferase deficiency disease	0
no-calorie sweeteners	papillary meningiomas	0
beer	malignant primary brain tumors	0
raw garlic	gastroenteritis	0
green onions	artery disease	0
sweetened cereal	diffuse undifferentiated lymphomas	0
ephedras	ovarian cancer	0
jambolan plum tree	tonsillar neoplasms	0
citrus hystrix	legal blindness	0
silybum marianum	water borne hepatitis	0
irritable bowel kiwi fruit	ocular headaches	0
taking vitamin	lymphoma	0
dried fruit	neuritic plaques	0
syzygium jambos	coronary heart diseases	0
high-fructose maize syrup	common cold	0
porgy	fibroatheromatous plaque	0
grecian foxgloves	painful diabetic neuropathies	0
restructured meat	cancer of rectum	0
anacardium occidentale	male breast cancer	0
purple potatoes	intermediate grade lymphoma	0
coconut	intestinal diseases	0
antioxidant foods	constrictive bronchiolitis	0
algarrobo	high grade lymphoma	0
plantago arenaria	cervical cancer	0
eggnog	cancer of the lung	0
curcuma longa	hhv-4	0
mustard seeds	auricular fibrillation	0
chai tea	central obesity	0
family vegetables	type 1 diabetes mellitus	0
soybean	primary insomnia	0
foie gras	spontaneous abortions	0
soy food	papillary meningioma	0
lactuca sativa	renal failure	0
guava	tussive syncope	0
fig	intermediate grade lymphoma	0
eating meat	sea sickness	0
persea americana	chronic headache	0
aspartame	water-borne hepatitis	0
sauerkraut	brain cysticercosis	0
hawthorn	bechterews disease	0
cow's milk	colon cancer	0
seltzer waters	renal calculus	0
box elders	upper respiratory tract infections	0
chinese yams	chicken embryo lethal orphan virus	0
antioxidant vitamin	seasickness	0
tangerine trees	esophageal reflux	0
food company	tonsil neoplasm	0
coriandrum sativums	horton's syndrome	0
coriandrum sativum	halitosis	0
filbert	chromosome 6 linked autosomal recessive parkinsonism	0
nut butters	intervertebral disk degeneration	0
cured meat	pulmonary thromboembolisms	0
kava kava	prediabetic state	0
soy proteins	involuntary quiver	0
sea bilberries	atherosclerose	0
texturized soy proteins	gastric acid reflux	0
mangosteen	auriculo-ventricular dissociations	0
tobacco	liver injury	0
adding blueberries	neuralgic migraine	0
grape juice	splitting pain	0
molasse	acute monocytic leukemias	0
caryophyllus aromaticus	cancer of the lung	0
cannabis	muscle soreness	0
calendula officinalis	xanthomatous meningiomas	0
wisconsin milk	cancer of rectum	0
artificial sweeteners	retinitis	0
silken tofu	male impotence	0
hemp plants	superficial head injuries	0
navy beans	cot deaths	0
suggesting apple	well-differentiated lymphocytic lymphoma	0
acai berries	cot death	0
banana plants	bone fractures	0
neutraceutical	cancer of the skin	0
rubus glaucus	mixed-cell lymphoma	0
asparagus	small cleaved-cell lymphoma	0
ultra-processed food	prion-induced disorder	0
gluten-free diet	enzootic bovine leukosis	0
pistacia	mild cognitive impairment	0
juglans nigra	hansen's disease	0
muffin	idiopathic polymyositis	0
cuminum cyminums	hiv	0
paprika	cancer of endometrium	0
big meals	acute inflammatory demyelinating polyradiculoneuropathy	0
dietary sucrose	epimerase deficiency galactosemias	0
potassium-rich foods	persistent atrial fibrillations	0
stevia rebaudiana	auriculo ventricular dissociation	0
erythroxylon	tonsil cancers	0
zea mays	tactile hypesthesias	0
acer	visual seizures	0
maguey	norwalk-like viruses	0
cocos nucifera	bovine spongiform encephalitis	0
onion	myeloma-multiple	0
infects apples	crohn's enteritis	0
almond trees	insomnia disorders	0
romaine	zoonotic infectious disease	0
kaffir lime	anxiety disorder	0
amorpha	prostatic intraepithelial neoplasias	0
raw foods	regional enteritis	0
citrus	prostatitis	0
lens plant	hemorrhoid	0
cynara scolymus	autosomal dominant juvenile parkinsonism	0
indian gooseberries	subacute spongiform encephalopathy	0
leaf lettuce	female subfertility	0
lemon grass	germinoblastic sarcomas	0
oyster mushrooms	peripheral demyelinating autoimmune disease	0
althea officinalis	male sexual impotence	0
tomato juice	ovary neoplasm	0
ficus	neurologic degenerative condition	0
butter	guillaine-barre syndrome	0
olive trees	uterine cervical neoplasm	0
amygdalus communis	arthritis	0
piper methysticum	national cancer	0
flavourer	degenerative neurologic disease	0
margarine	parkinsons disease	0
sardine	esophagus neoplasm	0
syzygium sandwicense	small round-structured viruses	0
antioxidant-rich food	darkness tremor	0
hibiscus tea	pulmonary neoplasm	0
capsicum annuum	sleep related neurogenic tachypnea	0
raw food	myocardial infarct	0
solanum melongenas	influenza in humans	0
pistachio nut trees	human flu	0
food manufacturers	ciguatera poisonings	0
norovirus food	neurological condition	0
coca cola	reticulum cell sarcoma	0
walnut	myalgic encephalomyelitis	0
calendula officinali	brain malignant neoplasm	0
rooibos tea	virus	0
marjoram plant	bovine spongiform encephalitis	0
dress	head traumas	0
chinese cinnamons	non hodgkin's lymphoma	0
veal	dermatozoic delusion	0
dragon fruit	crushing pains	0
antioxidant-rich foods	breast malignant tumors	0
brassica	erectile dysfunction	0
cucumis melos	hemolytic uremic syndrome	0
cereal	non-alcoholic fatty liver disease	0
carya	chicken viruses	0
kiwi	high-grade lymphoma	0
clathrotropis	meningiomatosis	0
plum trees	leukemogenic viruses	0
holy basil	endometrial neoplasm	0
maize oils	atypical chronic myeloid leukemia	0
colorful foods	cancer of the testis	0
cream cheese	rectum cancers	0
mentha piperita	plasma-cell myeloma	0
breakfast cereals	toxic megacolon	0
goji berries	b cell chronic lymphocytic leukemia	0
peach trees	multiple meningiomas	0
bagel	passive tremor	0
saccharomyces cerevisiae	numbness	0
cinnamomum zeylanicum	artery disease	0
hibiscus	ekbom delusional parasitosis	0
calendula	hyperphagia	0
catfish	e-b viruses	0
citrus hystrices	arterial fatty streak	0
common bean plant	influenza	0
currant	muscle cramps	0
chili peppers	age related maculopathies	0
pecan	sprains and strains	0
flax seeds	philadelphia negative myeloid leukemia	0
cycad trees	prion protein disease	0
no noni	bacterial vaginosis	0
convenience food	low-grade lymphomas	0
kangaroo meat	galactose-1-phosphate uridylyltransferase deficiency	0
mentha x piperita	vertebrogenic pain syndrome	0
apricot tree	brains cancer	0
kawa kawa	obesity	0
intoxicant	small and large cleaved-cell lymphoma	0
frozen spinach	childhood onset obesity	0
mussel	gastroesophageal reflux disease	0
vaccinium ashei	ulcerative colitis	0
powdered sugar	ovarian cancer	0
tree nuts	postoperative emesis	0
cardamon	gastric cancer	0
butternut squash	colon cancer	0
spearmint	thyroid neoplasms	0
isoglucose	cephalalgia	0
pistachio	prostate neoplasms	0
brown rice	hysterical blindness	0
nut bars	varice	0
lemon balms	liver neoplasms	0
food colors	metastasis	0
dried fruits	nausea	0
hickory tree	elevated cholesterols	0
lemon grasses	deaf-mutism	0
prunis communis	neurological condition	0
preserved foods	foreign objects	0
english walnuts	bacteriophage	0
ceratonia	ph1-negative myeloid leukemias	0
hemp	esophagus neoplasm	0
lemon	cancer of vulva	0
cinnamomum aromaticum	monocular blindness	0
acer negundos	deficiency disease	0
monkfish	joint diseases	0
dark meat	postoperative emesis	0
stuff	penile neoplasms	0
mustard plant	cancer viruses	0
malabar-nut	guam form amyotrophic lateral sclerosis	0
eggplant	guillain barre syndrome	0
sandwich	amnesia	0
roundup-ready soybeans	campylobacter infection	0
euterpe	bovine lymphosarcomas	0
triticum spelta	schizophreniform disorders	0
antioxidant fruits	focal seizures	0
oregano	manic-depressive psychosis	0
table sugar	cancer of the brain	0
ready-prepared food	deep vein thrombosis	0
guacamole	cancer of mouth	0
rice milk	abdominal cramps	0
daily nut	breast cystic disease	0
unrefined plant	heart decompensation	0
fresh basil	parkinsonian disorders	0
cassia fistulas	arthrose	0
teff	allergy	0
citrus reticulatas	spondyloarthritis ankylopoietica	0
virgin olive	iritide	0
regular carrots	flatus	0
chile pepper	sudden cardiac arrest	0
different fruits	crushing skull injury	0
hashish	temporary amnesia	0
bilberry	male breast neoplasms	0
laciniate nightshade	rectum cancer	0
bell peppers	androgenic alopecias	0
cider	degenerative arthritis	0
nutmeg	cluster headache syndromes	0
vitis vinifera	sleep initiation dysfunction	0
nettle	parietal region trauma	0
lemon balm	chronic insomnia	0
sweet basil	acidose	0
fresh fruits	guillaine-barre syndrome	0
high-fiber food	arterial dysfunction	0
yellow vegetables	small-cell lymphomas	0
pumpkin	chronic daily headache	0
zucchini	saturnine tremor	0
worldwide fruit	paludism	0
prunus cerasifera	overeat	0
plant capsule	low-grade lymphomas	0
regular olive	common cold	0
spice saffron	rete testis tumors	0
olive oil	peanut allergy	0
solanum laciniatums	galactosemia 3s	0
dried blueberries	nanism	0
dietary soybean proteins	diabetic mononeuropathies	0
vegetarianism	hepatic cancer	0
humulus	cancer of the vulva	0
ice cream	urticarias	0
kombucha teas	physical sufferings	0
powdered ginger	bronchial asthma	0
maple syrup	epilepsy	0
crave chocolate	common colds	0
cacao bean	dermatozoic delusion	0
healthiest beverages	anoxemia	0
common fruits	heat stroke	0
rubberplant	fine tremor	0
eating broccoli	eye diseases	0
rheum rhaponticum	metabolic acidoses	0
silybum marianums	eye diseases	0
cured meats	viral infection	0
low-salt diet	udp-galactose-4-epimerase deficiency disease	0
plant zygotes	high blood pressures	1
herbal tea	foreign object	0
experience food	periodontal diseases	0
anana	brain cancers	0
macadamia nut	cervix cancer	0
persimmon	primary brain tumor	0
cooked carrots	ekbom psychogenic parasitoses	0
buttermilk	ph1-negative myelogenous leukemias	0
cranberry juice	gehrig's disease	0
happy meal	encephalon diseases	0
exotic fruits	ischemic heart diseases	0
spicy food	non hodgkin lymphoma	0
thymus vulgari	phlebothrombosis	0
cashew	crohns disease	0
green grapes	orthostasis	0
acid-binding vegetables	senile paranoid dementia	0
amomum cardamomums	brain diseases	0
sour orange tree	type 1 diabetes mellitus	0
portulaca oleraceas	esophagus neoplasms	0
cinnamomum trees	age-related macular degenerations	0
empty calorie foods	cancer of the kidney	0
prunus amygdalus	severe mental disorder	0
horse beans	cognitive decline	0
crabapple	dwarfism	0
mint tea	somatotropin hypersecretion syndrome (acromegaly)	0
cola nitida	diverticula	0
little meat	cancer of the uterus	0
cola acuminata	muscle tremors	0
prunus domestica	manic disorder	0
adhatoda vasica	central nervous system degenerative diseases	0
thymus plant	stomach neoplasm	0
foodstuff	ekbom delusory parasitoses	0
da huang	malignant lymphomas	0
healthier meat	autosomal recessive juvenile parkinson disease	0
nut butter	malignant epithelial tumors	0
drink tea	dysosmia	0
drinking orange	age related osteoporosis	0
kavas	reactive confusion	0
legume pods	migraine	0
health nuts	exudative bronchiolitis	0
carbonated beverages	benign essential tremors	0
milk	mottled enamels	0
pease	respiratory tract infection	0
artificially-flavored corn	human papillomavirus viruses	0
ready soybeans	cephalodynia	0
citrus reticulata	generalized headache	0
almond milk	protein deficiencies	0
oxen meat	non-b hepatitis epidemic non-a	0
added sweeteners	chronic fatigue syndromes	0
amla	intraventricular meningioma	0
euterpe edulis	brain disease	0
mustard oil	non-hodgkins lymphoma	0
saffron crocus	lichen rubra planus	0
anticancer plant	dehydration	0
black rice	hypercholesteremia	0
cooked tomatoes	degenerative neurologic disease	0
shoot	deaf-mutism	0
soy beverages	mild cognitive impairments	0
teosinte	intestinal diseases	0
include fennel	diabetic amyotrophy	0
dietary fats	postoperative nausea	0
pea families	generalized headache	0
alcoholic beverage	substance addiction	0
food coloring	rodent ulcers	0
pomelo tree	sarcopenia	0
banana plant	intraepithelial carcinoma	0
triticum durum	fever	0
blossom	endometrial neoplasm	0
aubergine	post-traumatic osteoporosis	0
horsenettle	diabetes complications	0
fagopyrum esculentum	microlissencephaly	0
new vitamin	microcystic meningiomas	0
sugar maple	wheat hypersensitivity	0
anti-inflammatory foods	breast cancer	0
convenience foods	sleep initiation and maintenance disorders	0
justicia	hemicrania	0
olive tree	histamine cephalgias	0
plum	b12 deficiency	0
sweet basils	mottled enamel	0
pie	cardiac dysrhythmia	0
morinda citrifolias	jakob-creutzfeldt disease	0
citrus paradisi	fibromyalgia fibromyositis syndrome	0
cranberry	cretinism	0
chinese cinnamon	epithelial cancers	0
recommend tea	renal insufficiencies	0
jelly beans	fibromyoma	0
foxglove	preterm births	0
pickled vegetables	tick bites	0
ale	cluster headache syndrome	0
canned fruit	prostate neoplasms	0
boiled eggs	cerebrovascular stroke	0
cocos nuciferas	cluster headaches	0
dangerous plants	painful menstruation	0
carbonated drinks	amyloid deposits	0
component spices	irritable bowel syndromes	0
berry	chronic b-cell leukemia	0
celeriac	grave’s disease	0
pudding	galactosemia 2	0
collard greens	oncovirinae	0
cranberry sauce	drug use disorder	0
holy basils	chronic fatigue syndromes	0
carya illinoensis	infarction	0
emblica officinali	ekbom delusional parasitosis	0
syzygium aromaticum	autosomal dominant juvenile parkinsonism	0
aloe	circulatory collapse	0
trigonella foenum graecum	fibromyositis-fibromyalgia syndrome	0
cherry plum trees	paratuberculose	0
vaccinium bracteatum	foodborne disease	0
crataegus monogynas	back aches	0
squash plants	gale deficiencies	0
yam	neuritic plaque	0
stem vegetables	generalized seizures	0
soy bean proteins	manic depressive psychosis	0
opium poppy	familial diffuse gastric cancer	0
usda poultry	overeat	0
cleistocalyx	neonatal tremor	0
dried plums	spinal cord degenerative diseases	0
melissa officinalis	chronic obstructive lung disease	0
tempeh	bovine leukosis	0
cider vinegar	premenstrual tensions	0
beverage	reticuloendotheliosis virus	0
areca	bone neoplasm	0
chewing fruit	bipolar depression	0
ketchup	felv	0
althaea officinalis	abdominal cramp	0
secale	soft tissue sarcomas	0
philadelphia cream cheese	psammomatous meningioma	0
black currants	limb cramp	0
plum tree	udpglucose 4 epimerase deficiency disease	0
pancake	basal cell nevus syndrome	0
garlic	foodborne diseases	0
soda pops	philadelphia-negative myeloid leukemia	0
curried tofu	progressive disorder	0
secale cereale	appendicitis	0
food companies	spatial memory disorders	0
mesquite	dental diseases	0
eat chocolate	endometrium cancers	0
rosemary	irritable bowel syndromes	0
rise	bronchiolitide	0
tisane	intervertebral disk degeneration	0
citrus sinensis	mild neurocognitive disorder	0
pecan trees	epithelioid sarcomas	0
diospyro	uterine neoplasms	0
soymilk	foreign bodies	0
greenery	widespread chronic pains	0
hot peppers	penis cancer	0
papaver somniferum	fight cancer	0
caper	insulin dependent diabetes mellitus	0
mushroom	crushing pain	0
wheat brans	urinary bladder neoplasm	0
herr	brain diseases	0
ground beef	herpesvirus	0
petroselinum crispums	oncovirinae	0
rooibos	small and large cleaved-cell lymphoma	0
citrus sinenses	small noncleaved-cell lymphomas	0
sweetleaf	tubal abortions	0
animal-based vitamin	early onset parkinson disease autosomal recessive	0
snack food	blood cancer	0
anchovy	disorientation	0
citrus aurantium	aphthous ulcer	0
arecas	feline leukemia virus	0
nitrate-rich vegetables	fetal iodine deficiency disorder	0
brewing tea	nutritional disease	0
salmonella-infected eggs	deaf mutism	0
sockeye salmon	amnesia memory loss	0
mock meats	multiple head injuries	0
carya illinoenses	cardiac death	0
turnip	tubal abortions	0
cod	intracranial neoplasms	0
brinjal	hypoascorbemia	0
potable water	avitaminosis	0
frequent meals	diffuse well differentiated lymphocytic lymphoma	0
carica papaya	penis cancer	0
maize oil	acute inflammatory demyelinating polyneuropathy	0
thymus vulgaris	dementia with amyotrophic lateral sclerosis	0
blueberry plants	diabetic mononeuropathies	0
vitamin	abdominal aortic aneurysm	0
mayo	benign neoplasms	0
sweet marjorams	esophagus neoplasm	0
curry powder	skin cancer	0
cilantro	apneas	0
assai palms	hypoesthesia	0
berberis	lyme borreliosis	0
solanum	hepatic neoplasm	0
daily fruit	pregnancy pernicious vomiting	0
soy beans	aphthous stomatitides	0
eating almonds	substance induced organic mental disorders	0
sugar maples	lichen rubra planus	0
common foxglove	diffuse myofascial pain syndrome	0
seafood	inflammatory disorder	0
marjoram plants	substance-induced organic mental disorders	0
vitamin pills	inner ear cancer	0
incorporates cloves	small cleaved cell lymphoma	0
red tea	galactose-1-phosphate uridyl-transferase deficiency disease	0
neu5gc-rich food	headache syndrome	0
cooked meat	cluster headaches	0
roselle	fibromyositis-fibromyalgia syndromes	0
cheese	rhabdomyolysis	0
granny smith	gastro-esophageal reflux	0
fed beef	foodborne diseases	0
prunus salicina	respiratory infections	0
actual licorice	premenstrual tensions	0
espresso	pulmonary disease	0
herb	excess cancer	0
pomegranate fruit	epithelial cancer	0
pistil	severe congenital microcephaly	0
dried apples	coronary heart diseases	0
cocoa powders	meningioma	0
euterpe precatoria	burning pain	0
nori	myelomatose	0
soya milk	crushing skull injury	0
white mallow	thyroid disease	0
yerba mates	tumorigenese	0
citrus maxima	benign intracranial hypertension	0
hypericum perforatum	lymphocytic leukemia	0
allium cepa	microglandular adenoses	0
individual food	malignant brain neoplasm	0
emphasize plant	radiating pains	0
cassia cinnamon	liver neoplasms	0
blackberry	myocardial infarctions	0
chanterelle	galactose 1 phosphate uridylyltransferase deficiency	0
almond oil	aphthous ulcers	0
pepper	mouth cancers	0
portulaca oleracae	androgenetic alopecia	0
raw cranberries	foodborne disease	0
green pepper	sleep initiation and maintenance disorders	0
plant kingdom	parietal region trauma	0
food poisoning	respiratory tract cancer	0
bt corn	atherosclerotic plaques	0
roasted almonds	liver cancer	0
kiwi fruits	bladder disease	0
cocoa powder	tying disease	0
agaricaceae	myeloid leukemia	0
areca catechus	grave’s disease	0
white wine	ph1 negative myeloid leukemia	0
including cloves	human herpesvirus 4 (gamma)	0
different seed	parkinsonism-dementia complex of guam amyotrophic lateral sclerosis	0
red peppers	virus diseases	0
java plum tree	human cancer	0
caffeinated coffee	water-borne hepatitis	0
butter milk	appendicitis	0
collard	elevated cholesterols	0
shellfish	gasser's syndrome	0
swiss chard	wound botulism	0
natto	pernicious vomiting of pregnancy	0
honeybush tea	lymphosarcoma	0
coleslaw	thyroid cancers	0
citrus aurantiifolia	galactose 1 phosphate uridyltransferase deficiency	0
cannabis sativas	rectal neoplasms	0
chia seeds	memory losses	0
individual candy	diffuse lymphomas	0
carica	chest pain	0
millet	familial creutzfeldt-jakob disease	0
undercooked meat	virus disease	0
rooibo	visual seizures	0
real chocolate	fibroatheroma	0
cabbage	ischemic heart disease	0
flavorer	allergic reactions	0
grape	cognitive dysfunctions	0
citrus bergamia	ekbom delusional parasitoses	0
french fries	iron deficiency	0
citrus grandi	syndrome	0
organ meats	retained surgical needles	0
trace element	pituitary dwarfism iis	0
atropa belladonna	cancer of the stomach	0
colophospermum	physical suffering	0
jerusalem artichokes	pancreatic cancer	0
soy cheeses	study cancer	0
frozen fruit	pulmonary cancer	0
kava kavas	abdominal obesities	0
vaccinium macrocarpon	cot death	0
leguminosae	acute confusional migraines	0
pummelo trees	cervical migraine syndromes	0
sweetening agents	left-sided heart failure	0
althaea	hypersensitivity	0
chewing gum	memory losses	0
indian corn	diverticulosis	0
sweet peppers	cancer of the stomach	0
crowberry	gall bladder disease	0
açaí berries	pulmonary thromboembolism	0
seed	multiple sclerosis	0
celery	bone cancer	0
lens culinari	penis cancers	0
faba beans	galk deficiencies	0
bellis	oncogenesis	0
illicium verum	diverticula	0
poultry product	bronchiolitis obliterans	0
purple grape	disrupted in b-cell malignancy	0
solanum laciniatum	sleep related neurogenic tachypnea	0
snacktime	diverticulum	0
probiotic	fibromyositis-fibromyalgia syndromes	0
wheat	vestibular seizure	0
ilex paraguariensis	postural low back pain	0
alpine strawberry	age-related macular degenerations	0
osmanthus tea	rna tumor virus	0
decaffeinated tea	lichen rubra planus	0
apium graveolens var. rapaceum	breast adenosis	0
larder	indigestion	0
daucus carota	impaired sensation	0
kenaf	tactile amnesias	0
chard	neuralgic migraines	0
density foods	amyloid plaque	0
artificial butter	esophageal neoplasms	0
specific foods	left-sided heart failure	0
morinda	cardiac dysrhythmia	0
dietary supplement	penis neoplasm	0
pimenta diocias	migraine disorders	0
dinner	disorder	0
alfalfa sprouts	cancer of the testes	0
sugar substitutes	intervertebral disc degeneration	0
golden delicious apples	nevoid basal cell carcinoma syndrome	0
sugar water	phage	0
hot sauce	gasser's syndrome	0
soy sauce	colonic inertia	0
carthamus tinctorius	resting tremor	0
avenas	human immunodeficiency virus	0
dietary proteins	jacksonian seizure	0
eupatorium rebaudianums	low backache	0
psidium	bovine leukoses	0
red wine	osteoarthritis	0
marihuana	cancer of uterus	0
scrambled eggs	intention tremor	0
fabaceae	birth defect	0
rhubarb	mixed lymphocytic-histiocytic lymphoma	0
eugenia aromatica	increase cancer	0
decaf	diabetic amyotrophy	0
sweet orange	deglutitional syncope	0
vegetable protein	bone cancer	0
aloe vera	mouth cancers	0
mangifera indica	coarse tremor	0
eugenia jambos	megacolon	0
organic milk	burkitt herpesvirus	0
whole grain	guam form of amyotrophic lateral sclerosis	0
chili pepper	acute inflammatory polyneuropathy	0
fagopyrum tataricum	disorientation	0
citrus x paradisi	drunkenness	0
sea-food	low back pain	0
glucose fructose syrup	terminal ileitis	0
açai berries	familial diffuse gastric cancer	0
nonfat meal	udpglucose 4 epimerase deficiency disease	0
elettaria cardamomums	numbness	0
wild celeries	intermediate grade lymphoma	0
whole grains	prion-induced disorders	0
basil	dental disease	0
applesauce	spinal cord disorder	0
honey	sclerosis	0
energy drink	diffuse undifferentiated lymphomas	0
popcorn	social anhedonias	0
olive family	mptp-induced experimental parkinsonism	0
grapefruit	meningiomatosis	0
black raspberries	skin diseases	0
dietary supplements	cancer of the tongue	0
msg	medical conditions	0
red pepper	fibrous meningiomas	0
entree	abdominal pains	0
sun-dried raisin	cancer of the vulva	0
sea food	brain benign neoplasm	0
laudable legume	virus diseases	0
target vitamin	open head injuries	0
eden foods	fibrous meningioma	0
oolong tea	ovarian neoplasm	0
cortland	kidney insufficiency	0
mastic trees	brain benign neoplasms	0
hazelnut	global amnesia	0
healthiest vegetable	ponv	0
phytonutrient-rich food	chronic illness	0
baking chocolate	syncope	0
malus	diabetic asymmetric polyneuropathy	0
oreo	infectious disease	0
conventional food	renal calculus	0
fava bean	painful menstruations	0
red lentils	lung neoplasm	0
yeast rice	arterial fatty streaks	0
tea leaves	galactose-1-phosphate uridylyltransferase deficiency	0
official vitamin	leiomyoma	0
flower	food hypersensitivities	0
sesamum	memory losses	0
raw poultry	acidose	0
brassica juncea	gestational diabetes	0
apple trees	amyotrophic lateral sclerosis-parkinsonism-dementia complex 1	0
antioxidant food	cancer-causing viruses	0
smoked food	infant botulism	0
dinner time	sleep initiation dysfunction	0
no coffee	respiratory infections	0
processed food	testis neoplasms	0
tangerine tree	tussive syncope	0
fragaria	basal cell carcinoma	0
pleurotus	alopecia	0
cardamom	fibrocystic breast disease	0
sweet foods	abdominal aortic aneurysms	0
herbal teas	cancer of the thyroid	0
brassica napus	cancer of penis	0
cocoa butter	morning sickness	0
betel nut	acute coryza	0
orange	abdominal obesity	0
squash plant	cancer of thyroid	0
cappari	bladder cancers	0
elettaria	aids viruses	0
syzygium cumini	kidney neoplasms	0
broth	occipital region traumas	0
candy bars	udp galactose 4 epimerase deficiency disease	0
chilli pepper	light headedness	0
safflower oil	diabetic amyotrophy	0
steamer	cancer of the endometrium	0
spore	intracranial central nervous system disorders	0
poenumgraecum	myocardial infarctions	0
hickory trees	ductal carcinomas	0
trompillo	steatosis of liver	0
brew	spiral fracture	0
euterpe oleracea mart.s	pneumonia	0
phaseolus vulgari	lightheadedness	0
marshmallow	situational syncopes	0
pepsi	unilateral headache	0
wheat bran	long sleeper syndrome	0
trace elements	breast malignant tumor	0
cooked broccoli	textiloma	0
turkey meat	prelingual deafness	0
brazil nuts	tongue neoplasm	0
soy bean curds	prostatic hypertrophy	0
sushi	memory loss	0
oatmeal	diabetes-related complications	0
cumin	insomnia disorder	0
processed apples	guam form amyotrophic lateral sclerosis	0
black sapotes	weight gain	0
sour orange trees	pulmonary cancers	0
stevia rebaudianas	udp galactose 4 epimerase deficiency	0
cacao	auricular fibrillation	0
prettiest fruit	hemangiopericytic meningioma	0
dasheen	atheromatous plaques	0
purple rice	degenerative neurologic disorders	0
no meat	disk degeneration	0
tulsi tea	lung cancers	0
cherry plum tree	experimental parkinson diseases	0
lentinus edodes	motor seizures	0
licorice root	penis cancers	0
ground meat	mucous colitides	0
lime	thrombus	0
capsicum	viral disease	0
fruit and vegetable juices	cerebrovascular accidents	0
corn oils	milk sugar intolerance	0
marsh mallows	gastric acid reflux disease	0
dark chocolate	chronic illness	0
bell pepper	food borne diseases	0
sugary foods	colon neoplasm	0
vaccinium bracteatums	malignant epithelial neoplasm	0
drug administration united states food	hansen's disease	0
illicium anisatums	meningioma	0
chamomile oils	back pain with radiation	0
fruit juice	type c oncovirus	0
uncooked foods	prostate neoplasms	0
toxic plant	block cancer	0
whole wheat	cognitive declines	0
edible grain	communicable diseases	0
domestic fowls	cardiovascular strokes	1
infant formula	convulsion	0
rubus	lewy body parkinson disease	0
fenugreek	age-related memory disorders	0
hordeum vulgare	cancer of the ovary	0
collard green	cognitive decline	0
snack foods	cancer of the endometrium	0
andira	experimental lung inflammation	0
brain-invasive pork	gnathostomiase	0
eating nuts	osteoporose	0
cymbopogon	human herpesvirus 4 (gamma)	0
belladonna	e-b virus	0
pyrus	barretts syndrome	0
prebiotic	uterus neoplasm	0
jambolan plum trees	temporary amnesias	0
healthiest nuts	uterine cervical cancer	0
soy	subwakefullness syndrome	0
glycyrrhiza	diabetic retinopathies	0
foeniculum	acute monoblastic leukemia	0
indian laburnum	gastric neoplasm	0
tomato sauce	secondary fibromyalgias	0
cereal grain	gut dysfunction	0
thyme	malignant brain neoplasm	0
betel nuts	infant botulism	0
handling food	social anhedonia	0
yogurt	crushing pains	0
celery root	guam form of amyotrophic lateral sclerosis	0
saint johnswort	hip fractures	0
marijuana	acute coryza	0
white pepper	transient blindness	0
coconut water	fetal iodine deficiency disorder	0
taro	high cholesterol levels	0
durum wheat	human t cell lymphotropic virus type iii	0
japanese plum	cluster headaches	0
organic plants	secondary fibromyalgia	0
sustenance	premature birth	0
frying meat	prostatic adenoma	0
flounder	hyperpigmentation	0
raw broccoli	well-differentiated lymphocytic lymphoma	0
include apples	cancer of the colon	0
betel	prion protein disease	0
eugenia caryophyllata	muscle disease	0
jell-o	salami brusher's disease	0
pomegranate seeds	childhood onset obesity	0
deep-fry foods	olfaction disorder	0
club soda	fusiform aneurysm	0
bitter orange tree	insulin resistance	0
glycyrrhiza glabra	dims (disorders of initiating and maintaining sleep)	0
sticker	child obesity	0
pummelo tree	cognitive impairment	0
dog rose berries	chromosome 6-linked autosomal recessive parkinsonism	0
lycopersicon esculentum	low back pain	0
hypericum perforatums	halitosis	0
retail poultry	foreign bodies	0
plantago psyllium	diabetes related complications	0
pimpinella	strains and sprains	0
willow tree	diabetic mononeuropathy simplices	0
cultivated oat	botulism	0
salsa	head pain	0
ganja	soft tissue sarcomas	0
ultra-processed foods	mixed small and large cell lymphoma	0
diospyros digyna	horton's syndrome	0
pistachio nut tree	constipation	0
confection	serious disease	0
garbanzo	cervical migraine syndrome	0
mastictree	virus infection	0
organic meat	human cancer	0
garcinia mangostana	cancer of colon	0
pomegranate	cancer of the vulva	0
wild bananas	acquired immuno-deficiency syndrome	0
oat	pancreas cancers	0
brewed coffee	barrett metaplasia	0
orange tree	basal cell epithelioma	0
morel	e b virus	0
gum acacia	vaginal cancer	0
oregano plant	prostatic intraepithelial neoplasm	0
ephedra	postviral fatigue syndromes	0
human milk	clonic seizures	0
prenatal vitamins	crohns disease	0
sparkling waters	prion diseases	0
fermented cabbage	tumor of rete testis	0
citrus medica	tongue cancer	0
chinese yam	autistic disorders	0
cannabis indica	diabetic mononeuropathy simplex	0
dressing	macular degeneration	0
origanum onites	virus	0
thousand foods	nasal cavity cancer	0
peach	abdominal obesity	0
adhatoda	abdominal pains	0
saint johns wort	autistic disorders	0
chinese food	deformity	0
dinner times	age-related macular degenerations	0
organic foods	uterus cancers	0
fennel	hysterical amnesia	0
lemon tree	autosomal recessive juvenile parkinson disease	0
cicer arietinum	vaginal cancer	0
maple	pill rolling tremors	0
raw tomatoes	pyrexia	0
steak	gnathostomiasis	0
juglans regia	biliary calculi	0
fresh ginger	cerebrovascular apoplexy	0
pistacia lentiscus	headache	0
osmanthus	tongue cancer	0
triticum turgidum	temporary amnesias	0
breakfast times	pneumonitis	0
green teas	neoplasia	1
red onions	disk degeneration	0
zingiber officinale	cancer of kidney	0
soda waters	lens opacity	0
bacon	deaf mutism	0
new candy	leukovirus	0
table salt	head injuries	0
corn syrup	b12 deficiency	0
serve	itch	0
chinese rhubarb	subtrochanteric fractures	0
multivitamin	pseudopelade	0
citrus grandis	pyrexia	0
pea family	hypermelanose	0
refined olive	gastric neoplasms	0
tv dinners	asymmetric diabetic proximal motor neuropathy	0
okra	cancer of kidney	0
citrus fruit	hemangioblastic meningioma	0
assai palm	auditory seizure	0
breakfast	confusional state	0
whipped cream	anticancer	0
vodka	amnesia-memory losses	0
vaccinium uliginosum	ekbom delusory parasitoses	0
mackerel	fine tremor	0
allium sativum	vertebrogenic pain syndrome	0
crataegus monogyna	pseudoaphakia	0
zedoary zedoarias	heartburn	0
food and drug administration	substance use disorder	0
cultivated radish	pregnancy-induced diabetes	0
nutritional yeast	heartburn	0
eating food	virus disease	0
apple juice	static tremors	0
dietary fat	human mammary carcinoma	0
citrus bergamias	cystic disease of breast	0
punica granatums	cancer of colon	0
croaker	intraventricular meningiomas	0
opium poppies	blood cancers	0
healthy snacks	hypovolemic shock	0
shan yao	leukemogenic viruses	0
nicotiana tabacum	deficiency disease	0
soybean proteins	protein deficiency	0
carob	ciguatera fish poisoning	0
persea americanas	pregnancy induced diabetes	0
find pork	cll lymphoplasmacytoid lymphoma	0
pumpkin pie	bone neoplasms	0
cuminum cyminum	convulsive syncopes	0
melissa	pruritis	0
dioscorea villosa	tubal abortions	0
petroselinum crispum	testis cancers	0
maraschino cherry	hiccough	0
foenumgraecum	premenstrual syndromes	0
cannabis indicas	brain neoplasm	0
broccoli	near-death experience	0
eugenia cumini	hysterical blindness	0
rowanberry	small cell lymphoma	0
white tea	hemicrania	0
popular fruits	constrictive bronchiolitis	0
leek	parkinson’s disease	0
euchresta	tonsillar neoplasms	0
hydroponic basil	non epileptic convulsion	0
durum wheats	bovine leukemia	0
illicium anisatum	sliding hiatal hernias	0
taraxacum	philadelphia-negative myeloid leukemias	0
machaerium	iritide	0
woodland strawberry	fibrocystic breast disease	0
red cabbage	galactose 1 phosphate uridyltransferase deficiency	0
pimpinella anisums	diffuse mixed cell lymphoma	0
illicium verums	head traumas	0
cantaloupe	transitional meningiomas	0
vinegar	parkinsonism dementia complex of guam amyotrophic lateral sclerosis	0
maize	ekbom delusional parasitoses	0
preserved food	sphenoid wing meningiomas	0
kawa	varice	0
goji berry plant	spindle-cell carcinomas	0
liquorice	bipolar depression	0
canned foods	gnathostomiase	0
snail meat	diffuse lymphoma	0
oregano plants	bladder cancer	0
wild celery	pseudoaphakia	0
prosopis	crohns disease	0
illicium	intracranial central nervous system disorders	0
raisin	chronic obstructive lung disease	0
cooked meats	dental plaque	0
molasses	cancer of thyroid	0
bran flakes	cephalodynia	0
safflower oils	cancer of esophagus	0
ranking foods	lichen planus	0
flavoring	clear cell meningiomas	0
brassica nigra	neonatal tremors	0
healthiest apple	insulin sensitivity	0
avena	marsh fever	0
jelly	retained surgical tools	0
vicia faba	complete hearing loss	0
sell meat	bovine leukemia	0
contamination meat	cjd (creutzfeldt-jakob disease)	0
nut	transmissible spongiform encephalopathies	0
romaine lettuce	hysterical amnesia	0
shiitake	rectal neoplasm	0
flammulina	cramp	0
feather meal	mental deterioration	0
ground ginger	feminization	0
papaya	fibromyalgia	0
spice turmeric	ovary neoplasm	0
lunchtime	lumbago	0
musa	cancer of liver	0
weekly meat	cancer of the testis	0
rheum officinale	psoriasis	0
iv vitamin	cancer of the bone	0
raw alfalfa	barrett's esophagus	0
biometal	migraine	0
kidney bean	age-related memory disorders	0
chinese cassias	retroviridae	0
hickory nut	non b hepatitis enterically transmitted non a	0
texturized soy protein	excess cancer	0
white meat	age related macular degeneration	0
cucurbita	carcinogenesis	0
pork	eczematous dermatitides	0
saint john wort	heart diseases	0
crab apple	dysfunction	0
fortify milk	brain diseases	0
mandarin orange tree	spatial memory disorders	0
stryphnodendron	indigestion	0
curcuma zedoaria	brain diseases	0
dried food	lav-htlv-iii	0
dietary sugars	familial creutzfeldt-jakob diseases	0
study lavender	proliferative bronchiolitis	0
fagopyrum sagittatum	occipital trauma	0
split pea	uterus neoplasms	0
quinoa	prostate cancer	0
eugenia malaccensis	barretts esophagus	0
sour fruit	cardiac failure	0
jasmine tea	hypoesthesia	0
abelmoschus esculentus	anoxemia	0
sea vegetable	malignant primary brain neoplasms	0
portulaca oleracea	coronary heart disease	0
extracted fruit	food-borne illnesses	0
ginger ale	ocular headache	0
soy bean curd	retained surgical tool	0
licorice	ankylosing spondylitis	0
drinking coffee	hemorrhoid	0
cayenne	vaginal neoplasms	0
tepary bean	sliding esophageal hernias	0
amlas	intermediate grade lymphoma	0
jalapeno	angiomatous meningioma	0
cherry	eczematous dermatitis	0
marjoram	prostatic intraepithelial neoplasias	0
meal time	juvenile-onset diabetes mellitus	0
carbonated mineral water	venous thrombosis	0
actual fruit	schizophreniform disorders	0
macadamia	kill cancer	0
drink milk	obesity in adolescence	0
rose hips	gluten sensitive enteropathy	0
watercress	confusional states	0
pimiento	crohn’s disease	0
infant formulas	necrotizing fasciitis	0
tumeric	premenstrual syndromes	0
bhang	microcystic meningiomas	0
meal	small non-cleaved-cell lymphomas	0
pineapple juice	lymphocytic leukemia	0
humulus lupulus	retrovirus	0
syrup	spasm	0
anti-inflammatory plant	influenza	0
processed meats	papillary meningiomas	0
cuminum	respiratory infections	0
tepary beans	different cancer	0
drinking milk	long sleeper syndromes	0
unfertilized eggs	arthropathy	0
rubus fruticosus	venereal warts	0
thymus	gestational diabetes	0
chicken	breast neoplasm	0
gooseberry	tumor	0
rye bread	acquired immune deficiency syndrome virus	0
hop	abdominal cramp	0
anacardium occidentales	shock	0
national pork	mild cognitive impairment	0
corn	radiating pains	0
sunfish	ponv	0
hypericum	complications of diabetes mellitus	0
breast milk	bipolar affective psychoses	0
mastic tree	lens opacity	0
new york coalition for healthy school food	acquired immune deficiency syndrome	0
junk foods	ph1-negative myelogenous leukemia	0
bibhitaki fruit	gale deficiency	0
plant arils	mad cow disease	0
açai berry	hip fractures	0
suggesting fruit	colorectal tumor	0
grilled meat	familial creutzfeldt-jakob diseases	0
horse bean	breast diseases	0
oolong	pancreas neoplasms	0
ilex paraguarienses	urinary bladder diseases	0
dietary fiber	tumor virus	0
carrot juice	galactose-1-phosphate uridylyltransferase deficiency	0
alpine strawberries	cluster headache	0
sugar-sweetened beverages	hemangioblastic meningiomas	0
pimenta officinali	high cholesterol level	0
fennel seeds	chronic airflow obstruction	0
curcuma zedoarias	breast tumor	0
avocado	neoplasm metastases	0
lemon balm tea	galactose epimerase deficiencies	0
not-necessarily-so-healthy foods	benign meningiomas	0
crunch berries	vagina cancer	0
deep-fried foods	senile paranoid dementias	0
aspalathus	autoimmune condition	0
milk protein	ciguatera poisonings	0
concord grape	b cell leukemia	0
mentha spicatas	anthrax	0
healthiest beverage	tussive syncopes	0
weed	hepatitide	0
chile peppers	human papillomavirus viruses	0
healthy foods	burkitt's lymphoma virus	0
frying foods	animal virus	0
largest meal	intracranial cns disorders	0
poppy seeds	convulsive syncope	0
elettaria cardamomum	cancer of the esophagus	0
consumed chocolate	pulmonary thromboembolisms	0
alfalfa	left sided heart failure	0
american meat	experimental parkinson diseases	0
lens plants	sleep-related neurogenic tachypnea	0
dietary plant proteins	heart decompensation	0
moose meat	ovarian cancers	0
dietary protein	colitis gravis	0
chinese cassia	lymphadenopathy-associated virus	0
japanese plums	high-grade lymphomas	0
sunflower seeds	premenstrual syndromes	0
carbonated mineral waters	lassitude	0
eupatorium rebaudianum	asymmetric diabetic proximal motor neuropathy	0
edible grains	cancer of vulva	0
salami	action tremors	0
buckwheat	lymphatic sarcoma	0
food supplementations	frontal region traumas	0
tap water	prion diseases	0
low fruit	diabetic autonomic neuropathies	0
stevia	emesis	0
citrus fruits	galactokinase deficiencies	0
ready-to-eat meal	breast adenosis	0
good soybeans	cluster headache syndrome	0
lipomul	intractable headaches	0
olea	germinoblastic sarcoma	0
purslane	apnea	0
baptisia	guam form amyotrophic lateral sclerosis	0
pecan tree	apnea	0
triticum	reproductive sterility	0
pithecolobium	focal seizure	0
hemlock	penis cancers	0
emblica officinalis	chronic gum disease	0
black walnut	autosomal recesssive juvenile parkinsonism	0
high-fat meal	benign neoplasm	0
arugula	tactile amnesias	0
rye	rheumatoid arthritis	0
domestic fowl	breast pain	0
whole grain cereal	necrotizing fascitis	0
soy beverage	spatial memory disorders	0
chinook salmon	pharyngitis	0
smoked foods	cancer of the cervix	0
healthiest snack	osteoarthrose	0
squashe	galactose 1 phosphate uridyltransferase deficiency	0
purine-rich plant	feline lymphoma virus	0
eating fruits	colorectal cancers	0
processed foods	fusiform aneurysm	0
yerba mate	barretts esophagus	0
syzygium malaccense	acute myeloid leukemia	0
incorporate cloves	varix	0
commercial milk	chromosome 6-linked autosomal recessive parkinsonism	0
jalapeno pepper	breast cystic disease	0
capparis	fatty liver disease	0
wheatgrass	radiating pain	0
coca	intertrochanteric fractures	0
barley	laron type dwarfism i	0
black currant	blindness	0
lucerne	excess cancer	0
junk food	colon neoplasms	0
amomum cardamomum	brain tumor	0
golden delicious	hiatal hernias	0
grape seeds	cancer of the tonsil	0
bad foods	delusional parasitoses	0
plant capsules	acquired immunologic deficiency syndrome	0
bitter nightshades	bronchiolitide	0
apricot	acquired immunodeficiency syndrome virus	0
turmeric root	regional enteritis	0
celebration meal	postoperative emesis	0
exotic fruit	hyperthermia	0
frier	hepatitis e	0
lunch time	saccular aneurysm	0
morning meals	gehrigs disease	0
corn oil	carcinomatosis	0
linum usitatissimum	olfactory seizures	0
low meat	prostatic intraepithelial neoplasia	0
brazil nut tree	non-hodgkin lymphoma	0
nutrient-dense foods	gastroesophageal reflux	0
citrus aurantiifolias	huntington’s disease	0
lentil	galactokinase deficiency diseases	0
elephant garlic	pneumonitide	0
fatty meal	stomach cancer	0
pasta	creutzfeldt-jakob disease	0
rose	complications of diabetes mellitus	0
cannabis sativa	diabetic autonomic neuropathy	0
tofu	somatosensory seizure	0
food supplement	periodontal diseases	0
black walnuts	atrioventricular dissociation	0
citrullus	cancer of endometrium	0
french bean plants	hereditary essential tremor	0
low-sodium diet	retro-ocular headache	0
wild radish	cancer of the stomach	0
star anises	neoplasia	0
triticum turgidum subsp. durum	convulsion	0
chenopodium quinoa	infectious mononucleosis viruses	0
brussels sprouts	cramp	0
punicaceae	adenomatous polyp	0
century plants	age related memory disorders	0
mentha spicata	pulmonary embolism	0
earl grey tea	salmonella infections	0
common plant	familial juvenile parkinsonism	0
dried cranberries	dementia	0
psidium guajava	dental disease	0
prunus salicinas	substance dependence	0
gala apples	hyperthermia	0
almond tree	atypical diffuse small lymphoid lymphoma	0
fragaria vesca	obesity in childhood	0
spinach	spindle-cell carcinoma	0
pinto beans	central nervous system cysticercosis	0
chamomile	spiral fractures	0
rubus idaeus	tying disease	0
almond	pill rolling tremors	0
citron tree	somatotropin hypersecretion (acromegaly) syndrome	0
whortleberry	rheumatoid spondylitis	0
porphyra	widespread chronic pain	0
tea plant	eye diseases	0
myristica fragrans	alopecia	0
cassia tree	thermal hypesthesias	0
avoid peanuts	tor-driven diseases	0
rabbit meat	fibrositide	0
term vegetable	alcoholism	0
common foxgloves	uveitide	0
wild yams	uterine cervical cancer	0
sweeten	vaginal cancer	0
coriandrum	barrett's esophagus	0
salmonella food	exanthema	0
macadamia nuts	autosomal recessive juvenile parkinson disease	0
fungus	foodborne illnesses	0
haritaki fruit	auriculo ventricular dissociation	0
beef	nonalcoholic fatty livers	0
seven nutrients	hemicrania migraines	0
nicotiana	b-cell chronic lymphocytic leukemia	0
monosodium glutamate	dims (disorders of initiating and maintaining sleep)	0
sweetening agent	dental plaque	0
sweet pepper	chronic insomnia	0
calling eggs	massive tremors	0
dried peas	porcine endogenous retroviruses	0
english plantains	coronary heart diseases	0
lycium chinense	reproductive sterility	0
phaseolus	age related memory disorders	0
malabar nut	pulmonary inflammations	0
healthy food	anoxia	0
mirobalanus embilicas	chronic daily headaches	0
toxic plants	cervical neoplasms	0
cooking oil	high blood pressures	0
bean	dna injuries	0
maize syrup	cancer of the thyroid	0
squid	gnathostoma infections	0
english plantain	paraosmia	0
potato	nonspecific vaginitis	0
goji berry	lung neoplasms	0
garden radish	infarction	0
coriander	dyslipoproteinemia	0
chocolate	breast pains	0
roughage	high blood pressure	0
consumer protection scientific committee on food	burning pain	0
plant-based nutrients	kidney neoplasm	0
copaifera	cancer of mouth	0
phaseolus vulgaris	manic-depressive psychoses	0
curcuma longas	primary insomnia	0
chlorella	primary parkinsonism	0
tarragon	infant botulisms	0
pizza	psychosis	0
goji berry plants	lassitude	0
peach tree	celiac sprue	0
candy	prostate disease	0
cicer	age-related osteoporoses	0
soda water	low backaches	0
carbonated water	unilateral headache	0
milk thistle	well differentiated lymphocytic lymphoma	0
lavandula angustifolia	benign neoplasms	0
holy basil tea	well-differentiated lymphocytic lymphomas	0
little saffron	kidney failure	0
cinnamon	postviral fatigue syndrome	0
marsh mallow	juvenile-onset diabetes mellitus	0
nutraceutical	male sexual impotence	0
soy bean	substance addiction	0
dioscorea	dysosmia	0
fries	non alcoholic fatty liver disease	0
crocus sativus	spatial memory disorder	0
hickory nuts	high cholesterol level	0
mangiferas	chronic b-cell leukemias	0
solanum tuberosum	bronchiolitis obliterans	0
trace mineral	crushing skull injuries	0
drinking tea	syncopal vertigo	0
food allergy	malignant melanomas	0
dairy eggs	alcoholism	0
poppy	cancer of endometrium	0
acer saccharum	burkitt's lymphoma virus	0
cinnamomum cassia	cvas (cerebrovascular accident)	0
artichoke	pulmonary disease	0
acai berry	human mammary neoplasm	0
white potatoes	alopecia cicatrisatas	0
fruit-shaped marshmallows	campylobacter infection	0
plant embryo	sprain	0
squash seeds	diverticulitis	0
olive oils	childhood onset obesity	0
last meal	parkinsonian disorders	0
sweet potatoes	aids virus	0
ribes nigrum	metastasis	0
kawa kawas	cancer of endometrium	0
dried yeast	tongue cancers	0
cocoa plant	pulmonary inflammations	0
hemp plant	retained surgical needle	0
anise	irritable colon	0
cycad	dementia	0
healthiest foods	liver steatoses	0
cucumber	dizziness	0
retail meat	open head injuries	0
shiitake mushroom	nutritional disease	0
hibiscus sabdariffa	hansen's disease	0
berberi	exudative bronchiolitis	0
red meat	ekbom delusory parasitosis	0
food poisonings	temporary amnesias	0
mustard plants	postoperative nausea	0
seville orange trees	migraine variant	0
fructose corn	familial creutzfeldt-jakob disease	0
allium porrum	male pattern alopecia	0
black sapote	aortic aneurysm	0
dried apple	b cell leukemia	0
vegetable oil	type c oncovirus	0
carica papayas	skin diseases	0
kiwi fruit	juvenile parkinson disease	0
prosopi	feline lymphoma virus	0
linum usitatissimums	epstein barr virus	0
lycium	hemicrania	0
cassia	gangrene	0
sausage	variant creutzfeldt-jakob disease	0
common olive tree	growth hormone insensitivity syndrome	0
papaver	familial dementia	0
nutriceutical	breast adenosis	0
garlic sauce	syncopal vertigos	0
fast foods	age related bone loss	0
raspberry	virus	0
solanum dulcamara	itch	0
lemon trees	colonic cancers	0
psidium guajavas	non-epileptic convulsions	0
barley coffee	pancreas neoplasms	0
chamomile oil	prostate disease	0
justicia adhatoda	intermediate-grade lymphomas	0
lima beans	thyroid diseases	0
sparkling water	royal free disease	0
potato chips	human immunodeficiency viruses	0
lard	malignant tumor of breast	0
crocus	smell disorder	0
nicotiana tabacums	oxygen deficiencies	0
snack	testicular cancers	0
strawberry	insomnia	0
specific cheeses	constrictive bronchiolitides	0
club sodas	forehead traumas	0
beta vulgaris	torsion fracture	0
eating eggs	open head injury	0
sesame oil	serious disease	0
caryophyllus	pulmonary neoplasm	0
oryza	ekbom delusional parasitosis	0
seville orange tree	higher cancer	0
fiddlehead ferns	sleep wake disorders	0
mangifera	reducing cancer	0
ginger	mammary dysplasia	0
animal food	beriberi	0
myristica fragran	thinness	0
afzelia	malignant tumor of breast	0
vegetable juices	adenovirus	0
peppermint	communicable disease	0
flesh foods	familial juvenile parkinsonism	0
watermelon	viral hepatitis	0
coconut milk	short sleep phenotypes	0
beet greens	small noncleaved-cell lymphomas	0
lycium barbarum	higher cancer	0
include flaxseed	hemangioblastic meningioma	0
chenopodium quinoas	penile neoplasm	0
bitter orange trees	diverticula	0
fake meat	salmonella infection	0
assai palm berries	cancer of brain	0
peppermint oil	dyschezia	0
pea	arthrose	0
radicchio	rebound insomnia	0
morinda citrifolia	rachitis	0
morning meal	reduced sensation	0
dried foods	human cancer	0
pickled foods	amentia	0
breast milks	utp hexose 1 phosphate uridylyltransferase deficiency disease	0
decrease meat	aphthous ulcer	0
scallion	pancreatic cancer	0
carbonated drink	retained surgical tool	0
raphanus	morning sickness	0
narrow-leaved plantain	overeat	0
low-fat diet	virus diseases	0
atropa belladonnas	dementia with amyotrophic lateral sclerosis	0
spinacia oleracea	udp-galactose-4-epimerase deficiencies	0
peanut butter	malignant meningiomas	0
golden glow	postural syncope	0
cayenne pepper	delusional parasitoses	0
dripping	widespread chronic pains	0
citronella	parkinsonian syndrome	0
spaghetti	pseudocoma	0
delonix	lymphadenopathy-associated virus	0
fermented foods	gastro-esophageal reflux	0
agent orange	acute inflammatory polyradiculoneuropathies	0
origanum	small noncleaved cell lymphoma	0
so-called meat	infectious virus	0
guibourtia	prevent and reverse heart disease	0
dandelion	infantile autism	0
meal times	male pattern alopecia	0
bok choy	thrombosis	0
fruit juices	wound botulism	0
cucumis melo	zoonotic diseases	0
processed meat	necrotizing fascitides	0
whale meat	chronic gum disease	0
gravy	tumorigenesis	0
andean blackberries	amyloid plaque	0
dioscorea batatas	epilepsy	0
lemongrass	variant creutzfeldt jakob disease	0
pureed apples	malaria	0
bamboo shoots	amnesia memory loss	0
poroporo	behavior disorders	0
arginine-rich foods	poultry viruses	0
green peppers	metastasis	0
unfiltered coffee	lymphadenopathy-associated viruses	0
root	pill rolling tremor	0
avocado fruit	sore throats	0
milk thistles	pituitary dwarfism iis	0
prunus dulcis	tussive syncope	0
longevity legumes	endometrioma	0
vicia fabas	impaired sensation	0
plant zygote	cjd (creutzfeldt-jakob disease)	0
vitis	apnea	0
international nut	brief reactive psychosis	0
fava beans	celiac sprue	0
jalapeno peppers	cot death	0
deli meat	barrett esophagus	0
cayenne peppers	vertebrogenic pain syndrome	0
acer saccharums	halitosis	0
pimenta diocia	olfactory seizure	0
cruciferous vegetable	parodontosis	0
digitalis purpurea	tussive syncopes	0
skim milk	brain cancers	0
added nuts	androgenic alopecia	0
healthiest fruits	prevent and reverse heart disease	0
chicken meat	hiccup	0
cymbopogon nardus	sunburn	0
horse nettles	stomach cancers	0
tea hibiscus	drug allergy	0
pimpinella anisum	norwalk-like viruses	0
vaccinium angustifolium	small round-structured viruses	0
uncooked food	pseudoaphakia	0
green tea	common bile duct calculi	0
billion eggs	cancer of vagina	0
chickpea	myelogenous leukemia	0
floret	starvation	0
lettuce	small non-cleaved-cell lymphoma	0
high fructose corn syrup	fibromyalgia-fibromyositis syndrome	0
fat milk	b-cell leukemia	0
plantago lanceolata	benign neoplasm	0
narrow-leaved plantains	human immunodeficiency virus	0
healthy fruit	sharp headaches	0
brown sugar	dermatozoic delusion	0
treat	bacteria-eating virus	0
cassia fistula	grave’s disease	0
clove	breast malignant neoplasms	0
cola	aphthous stomatitis	0
turmeric	central nervous system intracranial disorders	0
cultivated oats	epithelioma	0
white bread	androgenic alopecias	0
contaminated foods	forehead traumas	0
ground flax	experimental lung inflammation	0
healthy nuts	pulmonary thromboembolism	0
bertholletia excelsa	acquired immuno-deficiency syndrome	0
beet	frontal region traumas	0
flaked coconut	prion diseases	0
mirobalanus embilica	salami brusher's disease	0
solanum dulcamaras	spatial memory disorder	0
nuclear power plant	sudden infant death syndrome	0
linum	senile tremors	0
majorana hortensis	primary brain neoplasms	0
bergamot	artery disease	0
chicken salad	convulsive seizure	0
octopus	atypical diffuse small lymphoid lymphoma	0
plantago indica	atopic diseases	0
cocoa	barretts syndrome	0
kohlrabi	plegia	0
acacia tree	acute cerebrovascular accident	0
fenugreek seeds	vestibular seizure	0
poultry products	spinal cord disorders	0
pleurotus ostreatus	scorbutus	0
apium graveolens	mixed cell lymphoma	0
texturized vegetable proteins	rabies virus	0
egg	leukemogenic viruses	0
callerya	feline lymphoma viruses	0
boiled broccoli	urinary tract infections	0
brewage	ekbom delusory parasitosis	0
english walnut	bewilderment	0
supper	tonsillar cancer	0
raw meat	food-borne diseases	0
fryer	liver steatoses	0
brussel sprout	burkitt lymphoma virus	0
aquatic food	bacterial infection	0
favorite meals	dyschezia	0
cicer arietinums	ankylosing spondyloarthritis	0
triticum vulgare	thermal hypesthesias	0
gui zhi	hair losses	0
fat foods	ulcerative colitis	0
baby carrots	breast pains	0
acaí berries	endometrial cancers	0
coffee	paralysis agitans	0
nonus	bechterew disease	0
phaseolus acutifolius	juvenile onset diabetes	0
petroselinum	kidney calculus	0
bertholletia excelsas	constipation	0
ready-to-eat meals	cephalodynia	0
narrow leaved plantain	chest pains	0
poppy seed	spindle cell carcinoma	0
wort	gastro oesophageal reflux	0
cauliflower	intracranial meningiomas	0
digitalis	lung disorders	0
leafy vegetables	lichen ruber planus	0
kava	back pain without radiation	0
origanum vulgare	type i diabetes mellitus	0
so-called vegetable	microcystic meningioma	0
abelmoschus	osteoporosis	0
solanum melongena	wound botulisms	0
rheum tanguticum	hepatitis	0
high-fructose corn	paroxysmal atrial fibrillation	0
beta vulgari	psychotic disorders	0
shorten	cancer of pancreas	0
shan yaos	migratory pain	0
fenugreek seed	cancer of stomach	0
frozen broccoli	renal failure	0
salad	acute monoblastic leukemia	0
walnut oil	lewy body parkinson disease	0
know nuts	early-onset parkinsonism	0
plantain	colitide	0
dessert	muscle sorenesses	0
toronja	urticaria	0
diabetic diets	bilateral deafness	0
apricot trees	ovarian cancers	0
plaice	spinal cord disorders	0
mustard greens	dementia with amyotrophic lateral sclerosis	0
java plum trees	melanoma	0
reindeer meat	intraorbital meningiomas	0
broad beans	thyroid disorders	0
pisum sativum	aphthous stomatitides	0
agave	nanism	0
chewing gums	kanners syndrome	0
frosting	hypercholesteremia	0
legume pod	oxygen deficiencies	0
big food	colonic neoplasm	0
dietary supplementations	generalized spasms	0
salt-free diet	rhabdomyolys	0
baby spinach	deep-vein thromboses	0
citrus aurantiums	pyrose	0
squash	throbbing headaches	0
ocimum sanctum	muscle cramps	0
cassia trees	prostatic hyperplasia	0
woodland strawberries	bone neoplasm	0
trigonella foenum-graecums	uterine neoplasms	0
legume family	prostatic cancer	0
pimenta	hypoxemia	0
medicago sativa	celiac disease	0
taraxacum officinale	lichen rubra planus	0
kola nuts	nonorganic insomnia	0
red delicious	atopic disease	0
yolk	spinal cord disease	0
purple cabbage	galk deficiency	0
pistacia vera	urticarias	0
trigonella foenum-graecum	action tremors	0
rheum	cancer of the rectum	0
veggie	colon disease	0
laciniate nightshades	brain cysticercosis	0
horsemeat	intraepithelial neoplasm	0
citrus-based fruits	galactose-1-phosphate uridyltransferase deficiency	0
topical ginger	gorlin-goltz syndrome	0
alcoholic beverages	acne vulgaris	0
dog rose	craniocerebral injuries	0
granny smith apples	senile paranoid dementia	0
big apples	psychogenic parasitosis	0
anise tea	common cold	0
yoghurt	visceral obesities	0
soy yogurt	endemic cretinism	0
raphanus raphanistrum	stomach ulcer	0
digitalis lanata	drop attacks	0
pretzel	cataract	0
energy drinks	persistent tremor	0
hot pepper	deglutitional syncope	0
peanut	small non-cleaved-cell lymphomas	0
glucose-fructose syrup	age-related bone loss	0
cookie	gehrigs disease	0
aspalathus linearis	micturition syncope	0
ribe	lung cancer	0
drink	near-death experience	0
safflower	parkinsonism	0
tomato	tonsil cancer	0
ananas	jakob-creutzfeldt disease	0
jam	lyme borreliosis	0
vegetable juice	vertiginous seizure	0
drinking water	metabolic acidosis	0
lemon verbena	progressive disorder	0
mandarin orange trees	osteoarthrosis	0
oyster mushroom	todd paralysis	0
colocasia	leukemia	0
corn sugar	pituitary dwarfism ii	0
unhealthy food	low grade lymphoma	0
olive	human papillomavirus viruses	0
whole foods	bacteria-eating virus	0
store licorice	amnesia	0
citrus limon	uterine cancers	0
camomile	migratory pains	0
prunus armeniaca	fibromyositis-fibromyalgia syndrome	0
gluten	chronic fatigue disorder	0
eragrostus	autosomal recessive juvenile parkinsonism	0
cooking meat	manic states	0
food allergies	barrett metaplasia	0
kombucha tea	benign prostatic hypertrophy	0
arachis	ovary cancers	0
ceylon cinnamon	laron syndrome	0
blueberry	pancreatitis	0
cruciferous foods	brain conditions	0
animal-based foods	mad cow diseases	0
black pepper	symptom clusters	0
food additive	prostatic cancer	0
zea	familial tremor	0
lavender	auto-immune disease	0
carrot	kanner syndrome	0
olea europaea	cervix neoplasms	0
plantago ovata	human immunodeficiency virus	0
venison	passive tremors	0
soda pop	encephalon disease	0
kale	premature aging	0
chestnut	cjd (creutzfeldt jakob disease)	0
poultry meat	small-cell lymphoma	0
glycine max	lymphadenopathy-associated viruses	0
plant aril	gale deficiency	0
beetroot	extreme hearing loss	0
soup	myeloid leukemia	0
saffron	diabetic complication	0
poisonous plant	hemangioblastic meningioma	0
bitter nightshade	primary growth hormone resistance	0
carduus marianus	b12 deficiency	0
whiting	metabolic acidoses	0
radish	johne disease	0
plantago seed	lead poisoning	0
poisonous plants	substance dependence	0
star anise	cot deaths	0
diabetic diet	prelingual deafness	0
food supplements	pediatric obesity	0
rutabaga	uterine cancer	0
tea	infarction	0
monitoring food	deficiency disease	0
plant embryos	environmental cancer	0
coco	inflammatory disease	0
apium graveolens var. dulce	tonsillar neoplasms	0
milk chocolate	semirhythmic tremors	0
sour cream	bses (bovine spongiform encephalopathy)	0
allspice	gastro-oesophageal reflux	0
phyllanthus emblica	lung disease	0
rosa	campylobacter infections	0
andean blackberry	lymphosarcoma	0
use sweeteners	degenerative neurologic diseases	0
pimenta officinalis	landry-guillain-barre syndrome	0
bertholletia	colorectal tumors	1
almond butter	develop cancer	0
dietary fibers	sprain	0
health food	cancer of the rectum	0
sesame oils	sudden onset diabetes mellitus	0
sugar	tongue cancer	0
dietary plant protein	joint pains	0
mustard	hepatic cancer	0
soy cheese	hemolytic jaundices	0
soft drink	alzheimer’s disease	0
parsley	penis cancer	0
gmo soybeans	subacute spongiform encephalopathy	0
flowering shrub	erectile dysfunction	0
coconut oil	protein deficiency	0
own vitamin	bipolar depression	0
rose berries	insulin dependent diabetes mellitus 1	0
faba bean	pancreatitis	0
golden raisins	campylobacter infections	0
flammulina velutipes	human papilloma virus	0
grecian foxglove	rachitis	0
measuring food	multiple head injuries	0
sorrel	sprue	0
curcuma	urticaria	0
syzygium	malignant epithelial neoplasms	0
ready-prepared foods	cancer of testis	0
lens culinaris	multiple head injury	0
sweet almonds	delusional parasitosis	0
vaccinium corymbosum	hepatic failure	0
mentha	global amnesias	0
cereal grains	pneumonia	0
texturized vegetable protein	ketosis prone diabetes mellitus	0
specific nuts	autosomal recessive parkinsonism	0
cannabi	jakob creutzfeldt disease	0
nuclear power plants	degenerative arthritis	0
endive	sudden cardiac death	0
sugar substitute	high blood pressure	0
healthy snack	crushing pain	0
split peas	irritable bowel syndrome	0
syzygium jambolanum	ciguatera fish poisonings	0
mint	bovine leukemias	0
hordeum	johne's disease	0
vital nutrients	asymmetric diabetic proximal motor neuropathy	0
mango	cancer of liver	0
poultry	cognitive dysfunctions	0
halibut	kanners syndrome	0
reason food	thyroid cancers	0
flax seed	leprosy	0
banana	paroxysmal atrial fibrillation	0
piper methysticums	radiating pains	0
kola nut	anaplastic carcinoma	0
deli meats	small cleaved-cell lymphoma	0
filtered coffee	adolescent obesity	0
iceberg lettuce	primary fibromyalgia	0
dairy products	ekbom dermatozoic delusion	0
chamomile tea	age-related osteoporoses	0
green lentils	early detection of cancer	0
anacardium	deep-vein thrombosis	0
red delicious apples	substance addiction	0
pear	post-traumatic osteoporoses	0
juglan	dermatozoic delusions	0
black beans	primary malignant brain neoplasms	0
flax	tonic-clonic seizures	0
grapefruit juice	syncopal vertigos	0
caramel	dizziness	0
contaminated meat	liver dysfunction	0
chervil	anal ulcer	0
handling meat	inflammatory disorder	0
apple tree	hair losses	0
diospyros digynas	eczematous dermatitides	0
swordfish	food borne illnesses	0
indian gooseberry	oncornavirus	0
milk proteins	jaundice	0
french bean plant	halitosis	0
high fructose maize syrup	bovine lymphosarcomas	0
processing meat	reticuloendotheliosis viruses	0
norus	intraepithelial prostatic neoplasia	0
eugenia jambolana	anhedonia	0
foeniculum vulgares	necrotizing fasciitides	0
carbonated beverage	chronic fatigue disorders	0
lamb chops	arterial dysfunction	0
broccoli raab	myeloid leukemia	0
black tea	occipital region trauma	0
plant-based foods	a-v dissociation	0
solanum tuberosums	acute cerebrovascular accidents	1
orange juice	cancer of ovary	0
andropogon nardus	endometrial neoplasms	0
red rice	transitional meningioma	0
corylus	nevoid basal cell carcinoma syndrome	0
dried apricots	muscular cramps	0
prunus persica	decreased cancer	0
triticum aestivum	diffuse mixed small and large cell lymphoma	0
fuji apples	human papilloma viruses	0
apple	oral cancer	0
cucumis sativus	brain tumors	0
natural vitamin	mild cognitive impairments	0
cinnamomum verum	presyncope	0
eat flax	diffuse well differentiated lymphocytic lymphoma	0
lavandula	pediatric cancers	0
ice creams	fibroatheromatous plaque	0
concord grapes	schizophrenia	0
sea bilberry	virus disease	0
alfalfa sprout	bipolar affective psychoses	0
euterpe oleracea	diverticulum	0
cocoanut	irritable bowel syndrome	0
blueberry plant	philadelphia-negative myeloid leukemias	0
pinto bean	prevent and reverse heart disease	0
healthier foods	gnathostoma infection	0
barberry	kidney stones	0
zingiber officinales	vaginitis	0
chocolate bars	intraepithelial carcinoma	0
mealtime	chronic illnesses	0
common olive trees	cvas (cerebrovascular accident)	0
burrito	bone fracture	0
acer negundo	hemangiopericytic meningiomas	0
sunchoke	coronary heart diseases	0
persea	parkinsonism	0
overpriced vitamin	blood clots	0
tuna fish	granulomatous enteritis	0
higher vegetable	chronic insomnia	0
whole grain cereals	mastitis	0
placenta	muscle tremor	0
chocolate pudding	toxic megacolon	0
cocktail	colitis gravis	0
saint john's wort	premenstrual syndromes	0
tuna	familial tremors	0
pumpkin seeds	acquired blindness	0
liquor	mucous colitis	0
soy milk	precordial catch	0
grouper	atheromatous plaques	0
pineapple	cluster headaches	0
dinnertime	human t cell leukemia virus type iii	0
pithecellobium	ischemic heart disease	0
piper nigrum	galactose-1-phosphate uridyltransferase deficiencies	0
baby formulas	burkitt herpesvirus	0
solanum lycopersicum	germinoblastoma	0
century plant	colon disease	0
trace minerals	low-grade lymphoma	0
california avocado	hirsutism	0
horse nettle	ovary cancer	0
organ	amyloid plaque	0
hamburger	tactile hypesthesia	0
rice	postoperative emesis	0
sprout	obesity in childhood	0
soy foods	mental deterioration	0
restrict food	fatty liver disease	0
true nut	well differentiated lymphocytic lymphoma	0
portulaca	premenstrual tension	0
crab apples	myocardial infarct	0
raisin bran	hepatic cancers	0
common bean plants	proteinuria	0
melissa officinali	todd paralysis	0
soft drinks	morning sickness	0
organic food	familial creutzfeldt-jakob diseases	0
national meat	peripheral arterial diseases	0
frozen cranberries	thyroid disorders	0
fast food	headache	0
offal	stomatognathic disease	0
zedoary zedoaria	b-cell chronic lymphocytic leukemia	0
avena sativa	hypercapnia	0
vaccinium virgatum	johne disease	0
breakfast time	polyphagia	1
rosehip	periorbital headaches	0
flaxseed	prediabete	0
cupcake	tremor	0
inadequate fruit	acquired immunodeficiency syndrome	0
mother cell	breast tumors	0
vegetable proteins	air sickness	0
noni fruit	galactosemia 2	0
paella	leucocythaemia	0
hummus	salmonella infection	0
noncaloric sweetener	parodontose	0
areca catechu	texidor's twinge	0
food pyramid	undifferentiated lymphoma	0
dioscorea polystachya	bipolar disorders	0
food additives	coad	0
vaccinium myrtillus	fetal iodine deficiency disorder	0
ocimum basilicums	food borne diseases	0
indian laburnums	soft tissue sarcoma	0
sweet marjoram	nerve tremors	0
ovary	htlv-iii	0
linseed	ramsay hunt paralysis syndrome	0
black coffee	diarrhea	0
high-phytate foods	back pain with radiation	0
dried pomegranate	psoriasis	0
bread mold	laron syndrome	0
artificial sweetener	lobar pneumonias	0
plantago	mixed lymphocytic-histiocytic lymphomas	0
zinger tea	malignant brain neoplasms	0
garcinia mangostanas	back pains	0
nut bar	sprue	0
bean sprout	creutzfeldt jakob disease	0
carbonated waters	acquired immunodeficiency syndromes	0
nightshade	gallstone	0
alcohol	mouth cancer	0
oats	widespread chronic pain	0
lunch times	episodic cluster headache	0
breakfast cereal	clear cell meningiomas	0
green beans	leprosy	0
citron trees	neonatal tremors	0
crataegus	aphthous ulcer	0
malus domestica	colitis gravis	0
curry	intermittent tremor	0
candy bar	early infantile autism	0
group foods	skin rash	0
dioscorea opposita	cancer of testis	0
orange trees	neurological condition	0
mother cells	inflammatory polyneuropathy acutes	0
raphanus sativus	psychophysiological insomnia	0
ocimum tenuiflorum	lassitude	0
baby formula	bovine leukoses	0
canned food	bovine leukemia	0
horsebean	colonic cancer	0
kidney beans	hair losses	0
milkshake	diabetic retinopathy	0
low-calorie diet	schizophrenic disorders	0
wild yam	phage	0
dairy yogurt	pus	0
fagopyrum	heart block	0
areca nuts	gastric cancer	0
vaccinium macrocarpons	hepatic neoplasms	0
proteus mirabilis	muscle disease	0
red meats	insulin-dependent diabetes mellitus 1	0
pomelo trees	breast diseases	0
nettle tea	prion-induced disorders	0
sweetener	suppuration	0
anise seed	prostatic hypertrophy	0
oryza sativa	physical anhedonias	0
citrus medicas	elevated cholesterols	0
chewed coca	acquired immunodeficiency syndrome virus	0
cocoa plants	fatigue	0
seltzer water	preventing cancer	0