
nori	jakob-creutzfeldt syndrome	0
abelmoschus esculentus	oxygen deficiency	0
medicago sativa	legal blindness	0
feather meal	avian leukosis/sarcoma virus	0
wild radish	testicular tumors	0
healthiest beverage	esophageal neoplasms	0
celebration meal	groundnut hypersensitivity	0
juiced broccoli	esophageal reflux	0
foxglove	chronic insomnia	0
jalapeno pepper	thinness	0
tea leaves	cjd (creutzfeldt-jakob disease)	0
common foxgloves	neurologic degenerative condition	0
watermelon	protein deficiencies	0
poultry meat	amyotrophic lateral sclerosis motor neuron disease	0
brazil nut tree	pulmonary disease	0
plant-based nutrients	autosomal recesssive juvenile parkinsonism	0
dietary supplementations	osteoarthrose	0
oatmeal	chest pain	0
hot sauce	female pattern baldness	0
spearmint	hypersensitivity	0
apple	near-death experience	0
wheat brans	convulsive syncope	0
sweet marjorams	breast cancers	0
rubberplant	intestinal diseases	0
colorful foods	pustular psoriasis of palms and soles	0
sugar-sweetened beverages	memory disorders	0
veggie	parietal region trauma	0
anacardium	intractable headache	0
serve	intermediate grade lymphoma	0
syzygium jambos	preterm birth	0
apium graveolens var. dulce	auriculo-ventricular dissociations	0
brewed coffee	hysterical blindness	0
monkfish	benign essential tremors	0
plantago ovata	ciguatera	0
gravy	phage	0
family vegetables	halitosis	0
nut butter	mammary cancers	0
fast foods	breast cystic disease	0
organ meats	light-headedness	0
green peppers	bladder neoplasm	0
kava	diabetic neuralgia	0
sweet potatoes	brittle diabetes mellitus	0
kawa	nbcc	0
papaya	age-related memory disorders	0
foenumgraecum	drop attacks	0
acai berry	drop attacks	0
olive trees	familial creutzfeldt-jakob diseases	0
unfertilized eggs	back pain with radiation	0
zea mays	spinal cord degenerative diseases	0
eating fruits	chronic infectious mononucleosis like syndrome	0
cucumis sativus	well-differentiated lymphocytic lymphoma	0
chili peppers	chronic illnesses	0
seafood	lymphoma	0
handling meat	post traumatic osteoporosis	0
carbonated water	spinal meningiomas	0
green lentils	motor seizures	0
lycium	bladder neoplasm	0
dinnertime	anoxia	1
beet	uterine neoplasm	0
stem vegetables	dyslipoproteinemia	0
egg	study cancer	0
bellis	pulmonary embolism	0
carica	sclerosis	0
white pepper	migraine	0
cantaloupe	toxico-infectious botulism	0
oat	sclerosis	0
color	lung disease	0
diospyro	cjd (creutzfeldt jakob disease)	0
coconut water	human mammary carcinoma	0
food allergies	eczematous dermatitis	1
mandarin orange trees	spondylarthritis ankylopoietica	0
romaine	brittle diabetes mellitus	0
origanum vulgare	kidney failure	0
java plum tree	bechterew disease	0
black raspberries	ekbom delusory parasitosis	0
turmeric	urinary bladder cancer	0
hawthorn	esophagitis	0
breast milk	contagious ecthyma	0
indian corn	radiating pains	0
citrus hystrix	atypical cluster headaches	0
pickled vegetables	complete blindness	0
haritaki fruit	bronchiolitis	0
sweet peppers	felv	0
carrot	child obesity	0
poppy	delusory parasitosis	0
contaminated meat	intermediate-grade lymphoma	0
pummelo tree	colicky pains	0
pimenta diocia	stroke	0
grouper	galactokinase deficiency	0
hemp plant	esophageal hernia	0
sea bilberries	cardiovascular stroke	0
eugenia sandwicensis	constrictive bronchiolitis	0
taro	familial atrial fibrillations	0
dessert	lung inflammation	0
safflower oil	anoxemia	0
goji berry	acromegaly	0
favorite meals	age-related macular degenerations	0
official vitamin	arrythmia	0
sunfish	psychotic disorders	0
rooibos tea	perioral tremors	0
acer saccharums	jaundice	0
mother cell	reversing chronic disease	0
blueberry plants	sleep-related neurogenic tachypneas	0
so-called meat	vertex headaches	0
floret	charcot disease	0
andropogon nardus	myocardial ischemias	0
parsley	inflammation	0
aca√≠ berries	schizophreniform disorders	0
cooking meat	nonalcoholic steatohepatitis	0
horsemeat	udpglucose 4 epimerase deficiency disease	0
licorice	uterine fibroid	0
aspalathus	low back ache	0
soft drink	human t-cell lymphotropic virus type iii	0
vaccinium ashei	small round-structured viruses	0
reindeer meat	stomach cancer	0
common bean plant	barretts esophagus	0
flax	parasagittal meningiomas	0
cocoa powders	cognitive dysfunction	0
neutraceutical	metabolic acidoses	1
sea food	congenital defect	0
pomegranate fruit	spondylitis ankylopoietica	0
plant embryos	chronic airflow obstruction	0
jerusalem artichokes	neuralgic migraines	0
nutriceutical	sprue	0
black walnut	hemolytic-uremic syndrome	0
copaifera	bone neoplasms	0
mangiferas	oral cancer	0
rice milk	brain cancers	0
pomelo trees	foreign body	0
triticum	carcinomatose	0
frosting	diabetic neuropathy	0
diabetic diet	growth hormone insensitivity syndrome	0
food supplements	kidney neoplasms	0
organic food	bilateral deafness	0
bad foods	arthralgia	0
cinnamomum trees	male sexual impotence	0
cruciferous vegetable	familial tremor	0
papaver somniferum	rectal cancer	0
dripping	well-differentiated lymphocytic lymphoma	0
rise	acquired immunodeficiency syndrome	0
soda pop	back pains	0
fig	lyme borreliosis	0
soy yogurt	social phobias	0
nut bar	aphthous ulcers	0
bolete	small cleaved cell lymphoma	0
fenugreek seeds	breast malignant tumor	0
narrow leaved plantain	recurrent low back pain	0
cilantro	apnea	0
vital nutrients	deglutitional syncope	0
euterpe edulis	hirsutism	0
bean sprout	wart	0
grapefruit	common cold	0
vaccinium virgatum	female infertility	0
broad beans	ovary neoplasms	0
natural vitamin	fibrocystic disease of breast	0
turkey meat	drug habituation	0
olive	dims (disorders of initiating and maintaining sleep)	0
cicer	gestational diabetes mellitus	0
osmanthus tea	lymphocytic lymphomas	0
black beans	sudden infant death	0
salmonella food	hepatitide	0
cannabi	social phobias	0
milk	vaginal discharge	0
fat milk	fifth phacomatosis	0
sweet almonds	cerebral convexity meningioma	0
baby carrots	gluten enteropathy	0
indian gooseberries	pyorrhea alveolaris	0
grecian foxgloves	minor head injuries	0
allium sativum	regional enteritis	0
dried food	bladder tumors	0
nut bars	urinary bladder diseases	0
snack	spondylitis ankylopoietica	0
baker's yeast	esophagus cancer	0
lens culinaris	amnesia-memory losses	0
white tea	epstein barr virus	0
recommend tea	mad cow diseases	0
soy proteins	malaria	0
agent orange	penis neoplasms	0
assai palms	tonsillar neoplasm	0
eugenia jambolana	endometrioma	0
thousand foods	rna tumor virus	0
pumpkin seeds	human cancer	0
brinjal	recurrent brain tumors	0
bitter nightshade	sick headache	0
cultivated oats	mild cognitive impairment	0
reason food	non-hodgkin's lymphoma	0
cayenne	viral infections	0
black currant	mixed lymphocytic-histiocytic lymphomas	0
morinda citrifolia	human t cell leukemia virus type iii	0
wild yams	gossypiboma	0
contamination meat	cancer of bladder	0
musa	paralysis agitans	0
applesauce	udpglucose 4-epimerase deficiency disease	0
organic milk	nerve tremors	0
tempeh	female sub fertility	0
caryophyllus aromaticus	diffuse myofascial pain syndrome	0
morning meals	penis neoplasms	0
trigonella foenum-graecums	atheromatous plaques	0
morinda	tonsillar cancers	0
whortleberry	continuous tremors	0
pistachio nut tree	high blood pressure	0
including cloves	atrophy	0
spinacia oleracea	cancer of the cervix	0
dietary soybean proteins	b cell chronic lymphocytic leukemia	0
orange tree	uterine fibroids	0
agave	uterine cancer	0
aloe	premenstrual tensions	0
syzygium sandwicense	scorbutus	0
fennel seeds	atherosclerotic plaques	0
box elders	hhv-4	0
cortland	cholera	0
pimenta	malignant epithelial neoplasm	0
organ	growth hormone receptor deficiency	0
steak	insulin dependent diabetes mellitus 1	0
frier	kidney diseases	0
poppy seeds	insulin-dependent diabetes mellitus	0
english plantain	radiating pain	0
soy bean curds	nevoid basal cell carcinoma syndrome	0
maize oils	eczema	0
apricot trees	juvenile parkinsonisms	0
offal	skin disease	0
carob	prediabetic state	0
linseed	atrioventricular dissociation	0
celeriac	disorientation	0
holy basils	esophageal hernias	0
amomum cardamomums	human influenzas	0
sunflower seeds	primary parkinsonism	0
soy foods	cystic disease of breast	0
kale	sphenoid wing meningioma	0
intoxicant	massive tremors	0
walnut	macular dystrophy	0
aubergine	neuritic plaque	0
nonfat meal	physical suffering	0
cocos nucifera	atrial fibrillations	0
dietary supplements	bilateral headaches	0
humulus	apnea	0
sour fruit	cancer of the mouth	0
fake meat	postoperative emeses	0
cannabis indica	foreign objects	0
coconut oil	situational syncope	0
amlas	severe mental disorder	0
different fruits	coronary disease	0
durum wheats	common cold	0
corn sugar	lead poisoning	0
crab apples	chronic headache	0
red delicious	somatotropin (acromegaly) hypersecretion syndrome	0
tv dinners	eye disease	0
sweetened cereal	colicky pains	0
tomato juice	thyroid cancers	0
cassia fistulas	esophagus cancer	0
plantago psyllium	horton's syndrome	0
cocoa	atopic disease	0
filbert	acute inflammatory polyradiculoneuropathies	0
boiled eggs	cancer of the esophagus	0
breakfast time	mammalgia	0
bertholletia	b cell chronic lymphocytic leukemia	0
chewed coca	male breast tumor	0
not-necessarily-so-healthy foods	mild neurocognitive disorders	0
dietary plant protein	pruritus	0
incorporate cloves	semirhythmic tremors	0
cultivated oat	breast fibrocystic disease	0
saint john wort	eye diseases	0
dairy products	social anxiety disorder	0
health food	aphthous stomatitis	0
berberi	mouth cancer	0
sea vegetable	tonsillar cancer	0
stevia rebaudiana	human immunodeficiency viruses	0
foeniculum	painful menstruation	1
curried tofu	craniocerebral injuries	0
vodka	foodborne diseases	0
contaminated foods	malignant epithelial neoplasms	0
plant zygote	polyarthralgia	0
crocus	ankylosing spondyloarthritis	0
cinnamomum cassia	gluten-sensitive enteropathy	0
green teas	deaf-mutism	0
topical ginger	barrett's esophagus	0
sugary foods	influenza	0
toxic plant	somatotropin (acromegaly) hypersecretion syndromes	0
trigonella foenum-graecum	deglutitional syncopes	0
cinnamon	hemicrania migraine	0
plum	cancer of tonsil	0
mentha x piperita	thyroid adenoma	0
amygdalus communis	feline lymphoma viruses	0
sesamum	oral disease	0
carbonated beverages	postoperative emesis	0
citrus fruits	barrett esophagus	0
cuminum cyminums	brain disorders	0
assai palm berries	contusion	0
teosinte	malignant epithelial neoplasms	0
popcorn	gall bladder diseases	0
citrus aurantium	long sleeper syndrome	0
hashish	insomnia disorder	0
buckwheat	sleeplessness	0
syzygium aromaticum	b cell chronic lymphocytic leukemia	0
yellow vegetables	common cold	0
plant kingdom	neurologic degenerative diseases	0
yeast rice	substance-related disorders	0
plant embryo	bipolar affective psychosis	0
butternut squash	aortic aneurysms	0
ribe	vaginal neoplasm	0
oryza	perforated appendicitis	0
laudable legume	senile osteoporosis	0
black sapote	wheat hypersensitivity	0
citrus grandis	spinal meningioma	0
drinking milk	gluten-sensitive enteropathies	0
little saffron	benign prostatic hyperplasia	0
rubus fruticosus	right-sided heart failure	0
thyme	dyschezia	0
silybum marianums	brain neoplasm	0
star anises	dripped virus	0
bean	colon cancers	1
sell meat	age-related bone losses	0
ilex paraguarienses	sharp headache	0
persea	manic disorder	0
saint johns wort	kahler disease	0
white mallows	ekbom delusional parasitoses	0
fresh fruits	bladder disease	0
supper	a-v dissociation	0
hickory nut	a-v dissociation	0
fragaria	liver dysfunction	0
spice saffron	hip fractures	0
avocado	migraine headaches	0
added sweeteners	hypersensitivity	0
eat chocolate	intervertebral disk degeneration	0
jambolan plum trees	communicable disease	0
raisin bran	semirhythmic tremors	0
cacao	prostatic adenomas	0
trace element	encephalon disease	0
higher vegetable	pyrose	0
apium graveolens var. rapaceum	paraesophageal hernias	0
sweet basil	peripheral arterial diseases	0
healthiest beverages	nausea	0
rooibo	gall bladder diseases	0
salt-free diet	kanner syndrome	0
citrus fruit	terminal ileitis	0
sea vegetables	familial atrial fibrillation	0
norovirus food	cryptogenic epilepsies	0
mangifera indica	celiac sprue	0
no meat	postoperative vomiting	0
acer negundo	drop attack	0
malus	pyrose	0
chocolate	epithelial cancers	0
actual fruit	syncopal episodes	0
solanum lycopersicum	meningotheliomatous meningioma	0
alfalfa	halitose	0
soy bean proteins	familial juvenile parkinsonism	0
citrus hystrices	small non-cleaved-cell lymphomas	0
ready soybeans	migraine disorders	0
chinese cinnamon	germinoblastic sarcomas	0
vicia fabas	schizoaffective disorders	0
sugar substitute	polyradiculoneuritis	0
malabar nut	open head injury	0
mustard	contagious pustular dermatitis	0
last meal	female infertility	0
kavas	pancreatic neoplasms	0
salami	pleomorphic lymphomas	0
high fructose maize syrup	sensory seizure	0
rowanberry	verruca	0
safflower	cardiogenic syncope	0
fatty foods	inflammatory polyneuropathy acutes	0
big apples	cognitive retention disorders	0
decaffeinated tea	acute myeloid leukemia	0
tepary bean	near-death experience	0
apricot tree	lung inflammation	0
sugar maples	dental disease	0
humulus lupulus	sliding esophageal hernia	0
celery	prediabete	0
acer	benign intracranial hypertension	0
acacia tree	colonic cancer	0
cocoanut	neonatal tremor	0
fruit juice	burkitt lymphoma virus	0
marihuana	primary brain neoplasm	0
jalapeno peppers	rhabdomyolys	0
processed meats	intracranial neoplasms	0
pistachio nut trees	bovine leukoses	0
ovary	thyroid disorders	0
bell peppers	reversing chronic disease	0
crataegus	regional ileitis	0
brassica nigra	low-grade b-cell malignancy	0
squash seeds	recurrent brain tumor	0
chinook salmon	micturition syncopes	0
candy bars	v cjd (variant creutzfeldt jakob disease)	0
nitrate-rich vegetables	cva (cerebrovascular accident)	0
calendula	cluster headache syndrome	0
sticker	gluten enteropathies	0
phaseolus	alopecia	0
orange	ketosis prone diabetes mellitus	0
nuclear power plants	broken bones	0
chile pepper	myocardial infarcts	0
vitamin pills	viral infection	0
plant zygotes	symptom cluster	0
ananas	gout	0
soybean proteins	heart disease	0
candy bar	metabolic acidoses	0
eat flax	huntington‚Äôs disease	0
mentha piperita	mental deteriorations	0
healthiest vegetable	prion-induced disorders	0
toronja	comatose	0
cynara scolymus	headache	0
juglans nigra	parkinsonism-dementia complex of guam amyotrophic lateral sclerosis	0
replenish nutrients	joint pain	0
squash plant	thyroid neoplasm	0
extracted fruit	blood clot	0
papaver	female sub-fertility	0
flowering shrub	uterine neoplasm	0
beer	kidney stone	0
common bean plants	colorectal carcinoma	0
rubus glaucus	chronic gum disease	0
cupcake	adenovirus	0
woodland strawberries	retained surgical needle	0
cured meat	ciguatera fish poisonings	0
adhatoda	temporary amnesias	0
white mallow	well-differentiated lymphocytic lymphoma	0
lactuca sativa	precordial catch syndrome	0
ephedras	excess cancer	0
althaea officinalis	skin cancer	0
plum trees	brain disorder	0
frozen broccoli	auditory seizures	0
pecan trees	cardiac arrhythmia	0
suggesting fruit	preterm births	0
whole grains	carcinoma in situ	0
store licorice	diverticula	0
dried fruits	lou-gehrigs disease	0
dietary fibers	congenital abnormalities	0
digitalis	pharyngitide	0
plantain	long sleeper syndromes	0
entree	landry-guillain-barre syndrome	0
fragaria vesca	hiv	0
grilled meat	amyotrophic lateral sclerosis-parkinsonism-dementia complex 1	0
sesame oil	sneeze	0
carbonated mineral waters	fibrocystic mastopathy	0
coriandrum sativums	acquired deafness	0
thymus vulgari	carsickness	0
apple juice	amaurosis	0
bitter nightshades	dyschezia	0
soy milk	sprain	0
soy beverages	small cleaved cell lymphoma	0
dietary sugars	brain disorder	0
brussel sprout	fibroid tumor	0
narrow-leaved plantain	ciguatera poisonings	0
food colors	autosomal dominant parkinsonism	0
antioxidant vitamin	fusiform aneurysms	0
melissa	deaf mutism	0
kiwi fruits	penis cancer	0
no coffee	thermal hypesthesia	0
white bread	gehrig disease	0
animal-based foods	a-v dissociations	0
healthy fruit	sphenoid wing meningioma	0
dog rose berries	resting tremor	0
almond butter	intracranial cns disorders	0
frozen cranberries	stomach neoplasm	0
japanese plums	nausea	0
cappari	prion protein diseases	0
golden raisins	carcinoma	0
breakfast	zoonotic infectious disease	0
dairy eggs	lewy body parkinson disease	0
hypericum perforatum	cacosmia	0
agaricaceae	tick bite	0
caryophyllus	hepatitis	0
black rice	udpglucose 4 epimerase deficiency disease	0
breakfast times	remittent fever	0
raw foods	chronic b-lymphocytic leukemias	0
philadelphia cream cheese	intention tremors	0
fed beef	macular dystrophies	0
poultry	cancer of the testes	0
dog rose	galactose-1-phosphate uridyltransferase deficiencies	0
canned fruit	lower back pain	0
dasheen	growth hormone receptor deficiency	0
sweet foods	carcinogenic retroviruses	0
broth	prostatic hyperplasia	0
food additives	johne's disease	0
solanum dulcamaras	abdominal cramp	0
syrup	high-grade lymphomas	0
cardamon	involuntary quiver	0
olea	milk sugar intolerance	0
black tea	human mammary carcinomas	1
baked potato	muscle spasms	0
citrus-based fruits	small round structured viruses	0
caramel	age-related maculopathies	0
vegetarianism	transitional meningioma	0
ice creams	convulsive syncopes	0
alfalfa sprout	cough	0
solanum tuberosum	iodine deficiency	0
euterpe oleracea mart.s	burkitt herpesvirus	0
raspberry	migraine headaches	0
narrow-leaved plantains	torsion fractures	0
piper methysticum	gut dysfunction	0
cannabis sativa	episodic cluster headaches	0
vinegar	amyloidose	0
beta vulgari	cervical migraine syndrome	0
white meat	cerebrovascular strokes	0
artificial sweetener	liver injury	0
nuclear power plant	olfactory groove meningioma	0
vegetable protein	microcystic meningiomas	0
mustard greens	micturition syncopes	0
flammulina velutipes	grippe	0
cacao bean	diabetic asymmetric polyneuropathy	0
citronella	muscle tremor	0
turmeric root	non b hepatitis enterically transmitted non a	0
wine	insulin deficiency	0
banana	myelomatose	0
gui zhi	coronary disease	0
citrus sinenses	androgenic alopecia	0
thymus	disrupted in b-cell malignancy	0
digitalis purpurea	global amnesias	0
whole grain cereals	androgenic alopecia	0
bread mold	kidney calculus	0
pimpinella	small-cell lymphoma	0
dried foods	breast malignant neoplasm	0
brewing tea	atrophy	0
syzygium malaccense	cot death	0
saffron	mptp induced experimental parkinsonism	0
regular carrots	excess cancer	0
currant	post-ictal confusion	0
carbonated waters	lav-htlv-iii	0
oregano	hair loss	0
dried peas	pernicious vomiting of pregnancy	0
caffeinated coffee	inflammatory disease	0
anacardium occidentales	lumbago	0
iceberg lettuce	pill rolling tremors	0
common plant	rhabdomyolys	0
tofu	lewy body parkinson's disease	0
flounder	acute inflammatory polyradiculoneuropathies	0
tree nuts	diffuse myofascial pain syndrome	0
food supplement	juvenile parkinsonisms	0
undercooked meat	stomach ulcers	0
hordeum	cancer of the vulva	0
dried plums	burkitt's lymphoma virus	0
dinner	gassers syndrome	0
citrus grandi	excess cancer	0
marsh mallows	burkitt herpesvirus	0
healthy foods	acute myeloid leukemia	0
trace elements	oral neoplasms	0
almond oil	arrythmia	0
chinese food	periadenitis mucosa necrotica recurrens	0
prunis communis	endometrial carcinoma	0
tisane	central obesity	0
kawa kawas	breast malignant neoplasms	0
sesame oils	secretory meningiomas	0
citrus paradisi	dripped virus	0
lamb chops	nerve tremor	0
flesh foods	disc degradations	0
milk chocolate	transmissible dementias	0
citrus maxima	abdominal pain	0
frying foods	retained surgical instruments	0
raw meat	prion diseases	0
retail poultry	zoonotic infection	0
table salt	lichen rubra planus	0
yogurt	skin cancer	1
hibiscus tea	drug hypersensitivities	0
alcoholic beverage	gynecomastia	0
corn oil	orthostatic headaches	0
raw cranberries	schizophrenic disorder	0
bertholletia excelsa	arterial dysfunction	0
prunus amygdalus	irritable bowel syndromes	0
eugenia caryophyllata	stomach neoplasms	0
coriandrum sativum	cervical cancer	0
citrus limon	carcinogenese	0
snail meat	t virus	0
pickled foods	cerebral stroke	0
dietary fat	manic-depressive psychosis	0
good soybeans	small noncleaved-cell lymphoma	0
maraschino cherry	arterial dysfunction	0
no-calorie sweeteners	diabetic retinopathy	0
cassia fistula	oral neoplasms	0
chipotle	wart viruses	0
potable water	developed cancer	0
pimenta officinali	biliary calculi	0
energy drinks	milk sugar intolerance	0
infant formulas	barrett's syndrome	0
frozen fruit	malignancy	0
pimenta officinalis	sensory seizure	0
woodland strawberry	severe gh insensitivity	0
raphanus	drug allergies	0
hickory nuts	posterior compartment low back pain	0
anti-inflammatory foods	atherosclerosis	0
blueberry plant	small and large cleaved-cell lymphoma	0
noni fruit	crushing pain	0
seed	ulcer	0
true nut	galactokinase deficiency	0
potato	liver cancers	0
vaccinium bracteatums	amaurosis	0
ground flax	suppuration	0
actual licorice	breast neoplasms	0
origanum majorana	fibromyalgia-fibromyositis syndrome	0
elephant garlic	barrett's syndrome	0
trace minerals	premature birth	0
pisum sativum	bovine lymphosarcoma	0
ceratonia	migraine headaches	0
ilex paraguariensis	amyotrophic lateral sclerosis motor neuron disease	0
walnut oil	prostatic intraepithelial neoplasia	0
octopus	zoonotic infections	0
osmanthus	uterine neoplasm	0
lavender	sudden cardiac arrest	0
ocimum basilicums	hyperemesis gravidarum	0
sour orange trees	paraesophageal hiatal hernias	0
blossom	lyssa	0
romaine lettuce	infant botulisms	0
hibiscus sabdariffa	breast cancers	0
solanum	vaginal neoplasm	0
capsicum	poisoning	0
sour orange tree	crohns disease	0
healthy food	fibrous meningiomas	0
carbonated mineral water	vaginitis	0
wheat	tumor	1
wisconsin milk	inner ear cancer	0
banana plant	androgenetic alopecia	0
drinking coffee	premenstrual tension	0
silken tofu	esophageal neoplasms	0
nightshade	chronic pains	0
spaghetti	pituitary dwarfism ii	0
crowberry	infant gynecomastia	0
ready-to-eat meals	degenerative intervertebral disks	0
hop	birth weight	0
anise tea	neuritic plaque	0
red peppers	schizophrenic disorders	0
dinner times	chronic fatigue disorder	0
club sodas	familial dementias	0
citron tree	hip fractures	0
onion	autosomal recessive juvenile parkinson disease 2	0
garlic sauce	colorectal carcinomas	0
pear	ms (multiple sclerosis)	0
sauerkraut	different cancer	0
dairy product	non alcoholic fatty liver disease	0
plantago indica	secondary fibromyalgias	0
squash plants	neurological condition	0
oyster mushrooms	schizophrenic disorder	0
healthy snacks	parkinsonism dementia complex of guam amyotrophic lateral sclerosis	0
black sapotes	bipolar affective psychoses	0
pomegranate seeds	head injuries	0
linum usitatissimum	cognitive retention disorder	0
food companies	undifferentiated lymphomas	0
garlic	common bile duct gallstones	0
dietary plant proteins	intention tremor	0
pimpinella anisum	central obesity	0
green tea	lymphadenopathy-associated virus	1
biometal	cephalgia	0
texturized soy proteins	huntingtons disease	0
little meat	perioral tremors	0
alpine strawberry	diabetic complication	0
okra	degenerative neurologic disorder	0
fresh basil	hepatitide	0
holy basil	mental disorder	0
radicchio	weight gain	0
purslane	iritide	0
cola acuminata	jaundice	0
kenaf	senile tremor	0
mayo	eye diseases	0
lens culinari	open head injury	0
cheese	heart decompensation	0
olive oil	hyperventilation syncopes	0
taking vitamin	cervical cancer	0
mentha spicata	diabetic polyneuropathy	0
green pepper	microcephaly	0
curcuma zedoaria	cancer of brain	0
pineapple juice	neuritic plaque	0
lemon trees	low-grade lymphoma	0
swordfish	massive tremors	0
apricot	cancer of the kidney	0
brassica napus	somatosensory seizures	0
spinach	breast adenosis	0
high-fructose maize syrup	galactokinase deficiency disease	0
common fruits	convulsive seizures	0
juglans regia	prostatic intraepithelial neoplasm	0
consumer protection scientific committee on food	periodontal disease	0
poppy seed	deep venous thromboses	0
convenience foods	eczema	1
billion eggs	infarction	0
camomile	severe congenital microcephaly	0
california avocado	galactose epimerase deficiencies	0
pomelo tree	muscle tremors	0
beetroot	voice box cancer	0
seville orange trees	age-related maculopathy	0
marsh mallow	visual seizures	0
horsebean	meningotheliomatous meningiomas	0
healthiest nuts	salami brusher's disease	0
include fennel	cough	0
prosopis	udp galactose 4 epimerase deficiency disease	0
crataegus monogyna	parkinson disease	0
eugenia malaccensis	pernicious vomiting of pregnancy	0
happy meal	intermediate-grade lymphoma	0
cassia cinnamon	anoxemia	0
milk thistles	acne vulgaris	0
cream cheese	diabetic amyotrophy	0
green onions	hepatic neoplasms	0
chervil	heart decompensation	0
cauliflower	semirhythmic tremors	0
antioxidant foods	leprosy	0
horse nettles	infectious virus	0
bergamot	tongue cancers	0
acai berries	macular dystrophy	0
seville orange tree	familial guillain-barre syndrome	0
sweetening agents	neurotic anxiety state	0
drinking water	somatotropin (acromegaly) hypersecretion syndrome	0
processed food	jakob creutzfeldt syndrome	0
areca catechu	study cancer	0
roughage	motor seizures	0
eugenia cumini	myocardial infarct	0
ground beef	macular dystrophies	0
mandarin orange tree	creutzfeldt jakob syndrome	0
chamomile oil	necrotizing fascitides	0
althaea	cirrhosis	0
food supplementations	kidney stones	0
pancake	contagious pustular dermatitis	0
da huang	animal virus	0
clathrotropis	burning pain	0
vegetable oil	superficial head injuries	0
lavandula	chronic cystic mastitis	0
soda water	guam form of amyotrophic lateral sclerosis	0
know nuts	eye diseases	0
eragrostis	vulva cancer	0
mangosteen	gossypiboma	0
justicia adhatoda	disk degeneration	0
artichoke	early awakening	0
ground meat	food hypersensitivity	0
pistil	thyroid adenomas	0
deep-fried foods	male sexual impotence	0
opium poppy	diabetic autonomic neuropathy	0
vaccinium myrtillus	colorectal cancers	0
yerba mate	semirhythmic tremor	0
broccoli raab	e-b viruses	0
boiled broccoli	contagious pustular dermatitides	0
national pork	fifth phacomatosis	0
nonus	zoonotic infection	0
pistacia lentiscus	testicular neoplasm	0
legume pod	uterine cervical neoplasms	1
antioxidant-rich foods	sleep related neurogenic tachypnea	0
oxen meat	nerve tremor	0
basil	anoxemia	0
wild bananas	osteoarthritide	0
ginger	cancer of breast	0
phaseolus vulgari	stomatognathic disease	0
exotic fruits	prediabete	0
star anise	v-cjd (variant-creutzfeldt-jakob disease)	0
deep-fry foods	ekbom psychogenic parasitosis	0
anise	lymphoblastic leukemia	0
punica granatum	hepatic neoplasms	0
rosemary	familial guillain-barre syndrome	0
raisin	paratuberculosis	0
animal food	colorectal neoplasms	0
wild celery	vestibular seizures	0
foie gras	endocrine breast diseases	0
nicotiana tabacums	angioblastic meningiomas	0
food pyramid	kidney calculi	0
dinner time	low-grade b-cell malignancy	0
granny smith	drop attack	0
density foods	parkinsonism	0
cider vinegar	autoimmune condition	0
frying meat	acute cerebrovascular accident	0
snacktime	spondyloarthritis ankylopoietica	0
herbal tea	plasma cell myeloma	0
silybum marianum	diabetic retinopathies	0
rutabaga	primary fibromyalgias	0
leafy vegetables	sid	0
fava beans	cardiovascular stroke	0
illicium verum	ankylosing spondylarthritis	0
rye bread	barretts syndrome	0
nettle	spiral fractures	0
mustard plant	tying disease	0
fenugreek seed	diffuse small cleaved cell lymphoma	0
english plantains	angiomatous meningioma	0
golden delicious apples	painful menstruations	0
miso	encephalopathy	0
unfiltered coffee	precordial catch	0
dietary proteins	fibrose	0
vaccinium macrocarpons	creutzfeldt-jakob disease	0
barley coffee	htlv-iii	0
fennel	stomatognathic diseases	0
poultry products	cephalgia syndromes	0
wheatgrass	muscular spasm	0
melissa officinali	influenza in humans	0
belladonna	bronchiolitis	0
pomegranate	aphthous ulcers	0
laciniate nightshade	male breast tumor	0
smoked foods	frontal region traumas	0
a√ßa√≠ berry	hereditary galactokinase deficiencies	0
aspalathus linearis	male impotence	0
ready-prepared food	human t-cell lymphotropic virus type iii	0
kidney beans	vertex headache	0
meal times	experimental lung inflammation	0
chewing fruit	national cancer	0
almond milk	human t cell lymphotropic virus type iii	0
sweeten	congenital defect	0
lemon balm	sudden cardiac death	0
virgin olive	hiccup	0
added nuts	parkinsonian diseases	0
indian gooseberry	laron type dwarfism i	0
brown rice	uterine fibroid	0
cayenne peppers	severe mental disorders	0
pimiento	water-borne hepatitis	0
syzygium jambolanum	substance dependence	0
norus	infection	0
mustard plants	gastro esophageal reflux	0
berberis	proteinuria	0
sparkling water	food hypersensitivity	0
pudding	diffuse mixed small and large cell lymphoma	0
triticum vulgare	cognitive decline	0
chicken meat	diabetic amyotrophy	0
cod	familial dementia	0
citrus bergamia	igf-1 deficiency	0
fuji apples	pulmonary inflammation	0
ground ginger	throbbing headache	0
chile peppers	hereditary essential tremor	0
tea	poultry viruses	0
persea americanas	intraorbital meningioma	0
preserved foods	acquired immunodeficiency syndrome	0
mastic trees	myelopathy	0
cumin	single seizure	0
rose hips	preterm births	0
pea family	mptp-induced experimental parkinsonism	0
proteus mirabilis	regional ileitis	0
pummelo trees	gingivitide	0
safflower oils	gall bladder diseases	0
marshmallow	diffuse undifferentiated lymphoma	0
junk foods	fusiform aneurysm	0
oolong tea	exudative bronchiolitis	0
sandwich	acute confusional migraines	0
anise seed	transitional meningiomas	0
whale meat	acquired immune deficiency syndrome	0
edible grains	tactile hypesthesia	0
prettiest fruit	sudden cardiac death	0
soy sauce	diabetic polyneuropathy	0
kiwi fruit	intraepithelial prostatic neoplasias	0
roundup-ready soybeans	tying disease	0
foeniculum vulgare	tongue neoplasm	0
soymilk	visceral obesities	0
cold-steeping tea	atherogenesis	0
pyrus	tonic-clonic seizures	0
blueberry	urticarias	0
coconut milk	serious disease	0
international nut	liver dysfunction	0
solanum laciniatums	degenerative neurologic diseases	0
warm milk	hyperventilation syncopes	0
nut	age-related macular degenerations	0
chewing gums	alzheimer‚Äôs disease	0
soy cheeses	creutzfeldt-jakob syndrome	0
carbonated beverage	cot death	0
red lentils	udp galactose 4 epimerase deficiency disease	0
chilli pepper	zoonotic infection	0
leaf lettuce	intracranial neoplasm	0
carya illinoensis	pituitary dwarfism iis	0
garcinia mangostanas	penis neoplasms	0
red yeast rice	stokes-adams syncope	0
marjoram plant	gustatory seizure	0
common foxglove	jakob-creutzfeldt disease	0
carbonated drink	passive tremors	0
food poisonings	olfactory groove meningioma	0
sunchoke	cognitive impairment	0
fagopyrum	udp galactose 4 epimerase deficiency	0
soda waters	degenerative intervertebral disc	0
pepper	somatotropin (acromegaly) hypersecretion syndrome	0
trace mineral	ductal carcinoma	0
rooibos	abdominal cramp	0
rubus idaeus	hypermelanose	0
healthier meat	anal ulcers	0
citrus aurantiums	adolescent obesity	0
durum wheat	lymphosarcoma	0
gala apples	migraine	0
hot peppers	craniocerebral injuries	0
maize oil	osteoarthrosis	0
mastic tree	appendicitis	0
burrito	deficiency disease	0
cycad	galactose-1-phosphate uridyltransferase deficiency	0
phytonutrient-rich food	female subfertility	0
food manufacturers	acute monoblastic leukemias	0
citrus medicas	effort syncopes	0
lemon grass	fifth phacomatoses	0
low-calorie diet	phlebothrombosis	0
amomum cardamomum	marek's disease virus	0
flower	acute cerebrovascular accident	0
meal	hepatitide	0
cleistocalyx	necrotizing fascitis	0
plum tree	left sided heart failure	0
bamboo shoots	early detection of cancer	0
molasses	type 1 diabetes mellitus	0
bagel	psychophysiological insomnia	0
illicium verums	bovine lymphosarcoma	0
rose	multiple meningioma	0
fortify milk	classic galactosemias	0
eating nuts	somatotropin hypersecretion syndrome (acromegaly)	0
ganja	necrotizing fascitides	0
olive family	zoonosis	0
cuminum cyminum	preterm birth	0
origanum onites	alopecia cicatrisata	0
phaseolus acutifolius	viral infection	0
eggnog	lung inflammation	0
crunch berries	pleomorphic lymphoma	0
vegetable proteins	deep-vein thromboses	0
eragrostus	cancer of skin	0
maguey	tumor of rete testis	0
sour cream	convulsive syncope	0
infant formula	rectal neoplasm	0
soy beverage	chronic lymphocytic leukemias	0
anana	amaurosis	0
fat foods	jakob-creutzfeldt syndrome	0
pie	diffuse lymphomas	0
white wine	intraepithelial neoplasm	0
cinnamomum aromaticum	low-grade lymphoma	0
milkshake	benign neoplasms	0
milk protein	monoblastic leukemia	0
anti-inflammatory plant	substance addiction	0
zingiber officinale	dental fluorosis	0
gmo soybeans	insomnia	0
processed meat	neoplasm metastases	0
breakfast cereal	oxygen deficiencies	0
arugula	osteoporosis	0
plantago arenaria	retinitis	0
andean blackberries	passive tremors	0
solanum dulcamara	feline leukemia virus	0
flavorer	virus disease	0
lens plant	sleep initiation dysfunction	0
new vitamin	bipolar disorders	0
hot pepper	chronic daily headaches	0
broccoli	parietal region traumas	0
shiitake	hip fractures	0
paella	tubal abortions	0
honey	uveitide	0
leguminosae	prevent and reverse heart disease	0
cayenne pepper	lymphoblastic leukemia	0
ketchup	comatose	0
msg	bronchial asthma	1
flavoring	b cell leukemia	0
foeniculum vulgares	germinoblastoma	0
betel nuts	vagina cancers	0
artificial butter	diffuse small cleaved cell lymphoma	0
nutmeg	mechanical low back pain	0
a√ßai berry	endometrioma	0
psidium guajava	vulvar neoplasms	0
delonix	growth hormone receptor deficiency	0
whipped cream	hypermelanosis	0
monitoring food	deglutitional syncope	0
prunus cerasifera	fibromyalgia-fibromyositis syndrome	0
mustard seeds	mouth neoplasm	0
dietary supplement	muscular spasm	0
prunus armeniaca	disc degenerations	0
food coloring	bone fractures	0
emblica officinalis	hair loss	0
diospyros digynas	social anxiety disorder	0
maple syrup	elevated cholesterols	0
almond trees	liver diseases	0
poisonous plants	ductal carcinomas	0
linum	horton syndrome	0
phyllanthus emblica	cluster headache syndrome	0
fiddlehead ferns	plegia	0
carduus marianus	papillary meningiomas	0
bertholletia excelsas	nonalcoholic fatty liver	0
shan yao	prostate neoplasm	0
syzygium cumini	canker sore	0
oregano plant	crohns disease	0
pinto bean	diffuse lymphoma	0
raphanus raphanistrum	throat cancer	0
digitalis lanata	abdominal aortic aneurysms	0
orange trees	hemolytic jaundices	0
peppermint oil	fibroatheromatous plaque	0
white potatoes	prediabete	0
new york coalition for healthy school food	adenosis of breast	0
anchovy	darkness tremor	0
pretzel	senile plaque	0
prunus persica	diabetes-related complications	0
myristica fragran	vaginitis	0
shiitake mushrooms	small round-structured viruses	0
radish	foodborne disease	0
cocos nuciferas	intermediate-grade lymphoma	0
citrus bergamias	sick headaches	0
bilberry	epithelial cancer	0
lemongrass	familial creutzfeldt-jakob diseases	0
carrot juice	western diseases	0
exotic fruit	experimental parkinsonisms	0
toxic plants	small non-cleaved-cell lymphomas	0
ocimum sanctum	single seizure	0
sockeye salmon	insulin deficiency	0
melissa officinalis	presyncope	0
fava bean	diabetes complications	0
squid	cognitive impairment	0
low vitamin	persistent tremor	0
pithecolobium	microcephaly	0
purple cabbage	necrotizing fascitides	0
monosodium glutamate	menstrual pains	0
raw food	male impotence	0
cooked broccoli	cancer of the skin	0
corn oils	cancer of stomach	0
sesame seeds	neuritic plaques	0
betel	age-related memory disorder	0
whole foods	gnathostoma infection	0
goji berry plant	johnes disease	0
saffron crocus	severe congenital microcephaly	0
sushi	feline lymphoma viruses	0
crab apple	spondylarthritis ankylopoietica	0
powdered ginger	oncovirus	0
olive tree	diabetes complication	0
ultra-processed foods	hiccup	0
chenopodium quinoas	mammary cancers	0
antioxidant food	lou gehrig disease	0
flaxseed	senile tremor	0
solanum melongena	dermatozoic delusion	0
coriandrum	infection	0
larder	juvenile parkinson disease	0
cucurbita	high blood pressure	0
triticum turgidum subsp. durum	sore throats	0
red pepper	kidney insufficiencies	0
roselle	transitional meningioma	0
acid-binding vegetables	lewy body parkinson's disease	0
yerba mates	abdominal obesity	0
dangerous plants	mixed cell lymphoma	0
restrict food	uterus neoplasms	0
chilli peppers	adolescent obesity	0
elettaria cardamomums	non-b hepatitis epidemic non-a	0
poroporo	common bile duct calculi	0
hibiscus cannabinus	forehead traumas	0
bok choy	hansen's disease	0
garbanzo	respiratory infections	0
origanum	lymphocytic lymphoma	0
alcohol	gehrig's disease	0
legume family	muscle tremors	0
lycium chinense	cadaver	0
triticum spelta	stomatognathic disease	0
solanum tuberosums	chronic cystic mastitis	0
cookie	premature birth	0
macadamia	nonhodgkin lymphoma	0
organic foods	spindle-cell carcinoma	0
sprout	early onset parkinson disease autosomal recessive	0
root	cranial pain	0
purine-rich plant	odontogenic keratocysts multiple basal cell nevi	0
ficus	ekbom delusional parasitosis	0
portulaca oleraceas	degenerative neurologic disease	0
fatty meal	anal ulcers	0
hypericum perforatums	necrotizing fascitis	0
cranberry	kidney cancer	0
wild celeries	vulvar neoplasms	0
saccharomyces cerevisiae	rash	0
maize syrup	amnesia	0
veal	common bile duct calculi	0
sugar maple	amyloid deposits	0
seltzer waters	secretory meningiomas	0
lemon	long sleeper syndromes	0
teff	endometrial cancers	0
fagopyrum esculentum	muscle spasm	0
baptisia	continuous tremor	0
liquorice	drug allergy	0
tulsi tea	cellulite	0
psidium guajavas	headache syndrome	0
unhealthy food	reducing cancer	0
rabbit meat	breast disease	0
dandelion	gluten enteropathies	0
tangerine trees	diverticula	0
pineapple	autosomal recesssive juvenile parkinsonism	0
mashed potatoes	tick bites	0
dioscorea batatas	sarcopenia	0
lycopersicon esculentum	juvenile onset diabetes mellitus	0
andean blackberry	landry-guillain-barre syndrome	0
halibut	primary brain neoplasms	0
healthier foods	thyroid carcinoma	0
pork	irritable bowel syndrome	0
carica papaya	rabies virus	0
plant-based foods	rebound insomnia	0
licorice root	osteoporosis	0
curcuma longa	breast neoplasms	0
amaranth	recrudescence	0
kawa kawa	muscular spasms	0
refined olive	congenital defect	0
high-fiber food	thyroid diseases	0
mastictree	bladder tumors	0
placenta	gastric acid reflux disease	0
mirobalanus embilica	male sub fertility	0
include apples	darkness tremor	0
pea families	pulmonary neoplasms	1
steamer	hemangiopericytic meningiomas	0
brussels sprouts	esophagus cancers	0
antioxidant-rich food	spinal cord disorders	0
cannabis sativas	psychotic disorders	0
tachigalia	disorientation	0
orange juice	birth defect	0
chamomile	avian leukosis/sarcoma virus	0
ale	tactile hypesthesias	0
daily fruit	pregnancy induced diabetes	0
coconut	encephalopathy	0
eugenia jambos	age-related macular degeneration	0
vegetable juices	intervertebral disk degeneration	0
healthy snack	salami brusher's disease	0
english walnut	leukemogenic virus	0
healthy nuts	gustatory seizures	0
zucchini	galactose 1 phosphate uridylyltransferase deficiency	0
brassica	dementia	0
drink milk	atherosclerosis	0
white rice	androgenetic alopecia	0
faba bean	coronary diseases	0
adding blueberries	infarction	0
plantago lanceolata	gluten enteropathy	0
prunus dulcis	undifferentiated carcinomas	0
artificial sweeteners	cervix cancers	0
eggplant	primary insomnia	0
milk thistle	chronic infectious mononucleosis like syndrome	0
pureed apples	infectious mononucleosis virus	0
health nuts	brain cysticercosis	0
kohlrabi	decreased cancer	0
jell-o	hyperphagia	0
sugar water	reticuloendotheliosis virus	0
solanum laciniatum	multiple myositis	0
ready-to-eat meal	autoimmune condition	0
sweetener	low-grade lymphoma	0
salad	gastric ulcer	0
suggesting apple	ciliary body spasm	0
texturized soy protein	low back aches	0
carya	fibromyalgia-fibromyositis syndrome	0
soup	transmissible dementia	0
pasta	chronic obstructive pulmonary disease	0
frequent meals	pseudopelade	0
common olive trees	bruise	0
sorrel	drug hypersensitivities	0
pumpkin	laron dwarfism	0
jam	shock	0
theobroma cacao	motion sickness	0
glycyrrhiza	premenstrual tensions	0
baking chocolate	animal virus	0
squashe	familial creutzfeldt-jakob diseases	0
lettuce	migraine	0
iv vitamin	diffuse myofascial pain syndrome	0
majorana hortensis	nonhodgkins lymphoma	0
rhubarb	aids viruses	0
red onions	senile plaques	0
oregano plants	reactive confusion	0
american meat	spondylitis ankylopoietica	0
brain-invasive pork	atypical diffuse small lymphoid lymphoma	0
eugenia aromatica	meningiomatose	0
chocolate bars	gall bladder disease	0
myristica fragrans	acquired deafness	0
fryer	poultry viruses	0
citrus medica	cancer of penis	0
experience food	chronic cystic mastitis	0
potato chips	encephalon diseases	0
fagopyrum sagittatum	inflammation	0
prenatal vitamins	insulin-dependent diabetes mellitus	0
concord grapes	bipolar affective psychoses	0
soy bean curd	lymphatic sarcomas	0
candy	nasal cavity cancer	0
peanut	progressive disorder	0
breakfast cereals	b-cell chronic lymphocytic leukemia	0
preserved food	cancer of mouth	0
pleurotus ostreatus	basal cell carcinoma	0
animal-based vitamin	sleep wake disorders	0
allium porrum	aphthous ulcer	0
wild yam	vulva neoplasm	0
table sugar	cranial pains	0
flaked coconut	utp hexose 1 phosphate uridylyltransferase deficiency	0
shiitake mushroom	schizophrenic disorders	0
sesame	atrial fibrillations	0
healthiest foods	galt deficiency	0
collard green	early-onset parkinsonism	0
macadamia nuts	autosomal recessive juvenile parkinson disease	0
high-fat meal	tying disease	0
thymus plant	saccular aneurysm	0
crocus sativus	fibrose	0
syzygium	prostatic intraepithelial neoplasm	0
whole wheat	prostatitis	0
skim milk	alopecia	0
mangifera	cancer of tonsil	0
squash	iritis	0
dried apple	ankylosing spondylarthritides	0
gooseberry	intervertebral disk degeneration	0
soy bean	fibrous meningioma	0
poultry product	stomach cancer	0
dress	preterm births	0
chicken	galt deficiency	0
dietary protein	chronic b-cell leukemia	0
rosehip	multiple head injury	0
sweet pepper	soft tissue sarcoma	0
cucumis melo	cystic breast disease	0
fabaceae	carcinomatosis	0
processing meat	salmonella infection	0
jasmine tea	nasal cavity cancer	0
tobacco	acute fulminating multiple sclerosis	0
garcinia mangostana	spindle cell sarcomas	0
almond	pruritis	0
incorporates cloves	lou gehrig's disease	0
kola nuts	kill cancer	0
chestnut	rheumatoid arthritis	0
nutritional yeast	bovine spongiform encephalitis	0
piper nigrum	inappropriate gh secretion syndrome (acromegaly)	0
ceylon cinnamon	dermatosis	0
dairy yogurt	age-related maculopathies	0
sweetleaf	bovine lymphomas	0
healthiest fruits	pancreatic cancer	0
roasted almonds	respiratory infections	0
consumed chocolate	food borne illnesses	0
rheum	colitide	0
shorten	diabetic retinopathy	0
processed foods	intestinal diseases	0
machaerium	rest tremors	0
potassium-rich foods	adolescent obesity	0
a√ßai berries	sliding hiatal hernia	0
chai tea	pancreatic cancers	0
saint john's wort	dairy product intolerance	0
guava	postoperative emesis	0
punicaceae	high cholesterol levels	0
dioscorea opposita	rodent ulcers	0
colophospermum	prostatic adenomas	0
smoked food	diverticulitide	0
lemon balm tea	hip fractures	0
buttermilk	human herpesvirus 4	0
eupatorium rebaudianums	throbbing headaches	0
curcuma	hypercholesteremia	0
kava kavas	uterine cervical neoplasms	0
vitamin	pharyngitis	0
algarrobo	pneumonitis	0
bottled water	type 1 diabetes mellitus	0
low-fat diet	diabetic autonomic neuropathy	0
hypericum	cancer of the lung	0
phaseolus vulgaris	coma	0
nicotiana tabacum	hepatitis e	0
chinese yams	cholera	0
erythroxylon	infant botulisms	0
malabar-nut	pancreas cancer	0
soy food	massive tremors	0
acer saccharum	coronary disease	0
chewing gum	painful diabetic neuropathies	0
coca cola	colic	0
flavourer	muscle spasm	0
sardine	gastric cancers	0
fast food	non epileptic convulsion	0
chocolate pudding	auriculo ventricular dissociation	0
low-sodium diet	water-borne hepatitides	0
cow's milk	premature aging	0
zingiber officinales	intertrochanteric fractures	0
cardamom	canker sore	0
snack foods	throbbing headaches	0
acer negundos	bovine lymphomas	0
individual candy	hiccough	0
new candy	bovine lymphomas	0
green grapes	gastric cancer	0
black teas	reducing cancer	0
restructured meat	mouth and tooth diseases	0
almond tree	anticancer	0
rice	rhabdomyolys	0
thymus plants	forehead trauma	0
marjoram	amnesia	0
japanese plum	food hypersensitivities	0
crataegus monogynas	diverticulitide	0
plantago seed	blood clot	0
portulaca oleracae	cerebrovascular accident	0
red meats	short sleep phenotype	0
cranberry sauce	prion disease	0
organic meat	severe gh insensitivity	0
apium graveolens	olfactory groove meningioma	0
oreo	unilateral headaches	0
oats	utp hexose 1 phosphate uridylyltransferase deficiency disease	0
apple trees	et-nanbh	0
goiaba	galactose 1 phosphate uridyl transferase deficiency disease	0
calendula officinali	penis neoplasms	0
spore	acute infectious polyneuritis	0
junk food	social anhedonia	0
cabbage	osteoporosis	0
cooked tomatoes	high-grade lymphomas	0
bacon	insulin dependent diabetes mellitus 1	0
gum acacia	auriculo-ventricular dissociation	0
cymbopogon	hepatic neoplasms	0
willow tree	prostate neoplasm	0
vitis vinifera	recurrent brain tumor	0
lavandula angustifolia	visceral obesities	0
maize	convulsive seizure	0
psidium	communicable disease	0
psyllium	thrombus	0
food allergy	fifth phacomatoses	0
frozen spinach	chronic obstructive pulmonary disease	0
zea	subacute spongiform encephalopathies	0
greenery	chronic pain	0
barberry	idiopathic intracranial hypertension	0
avocado fruit	hepatitis e	0
regular olive	spondylarthritis ankylopoietica	0
fungus	peanut allergies	0
berry	galactosemia	0
punica granatums	urticaria	0
flammulina	paralysis	0
ribes nigrum	deep-venous thromboses	0
cashew	non hodgkins lymphoma	0
flax seeds	gasser's syndrome	0
collard	well differentiated lymphocytic lymphoma	0
goji berry plants	intracranial meningiomas	0
red meat	fibroatheromatous plaques	0
asparagus	corpse	0
allium cepa	cardiogenic syncopes	0
rheum officinale	galt deficiencies	0
canned foods	fibrous meningiomas	0
paprika	carsickness	0
bhang	small lymphocytic lymphoma	0
weed	parodontosis	0
butter milk	rachitis	0
pine nuts	gluten enteropathies	0
natto	liver dysfunctions	0
mentha spicatas	hiatal hernias	0
conventional food	complete blindness	0
millet	uterine cervical neoplasm	0
plantago	undifferentiated carcinoma	0
horsenettle	appendicitis	0
honeybush tea	diabetic polyneuropathies	0
lens plants	pyrose	0
olea europaea	gangrene	0
target vitamin	ileocolitis	0
mirobalanus embilicas	sciatica	0
soy	bovine leukoses	0
treat	microcephaly	0
mustard oil	a-v dissociations	0
cucumis melos	continuous tremor	0
brew	bone fracture	0
peppermint	peripheral artery diseases	0
soya milk	light-headedness	0
glycine max	seasickness	0
organic plants	hernia	0
tomato	preventable cancers	0
tomato sauce	fatigue	0
food additive	age-related memory disorders	0
indian laburnum	hyperthermia	0
red delicious apples	cancer of the skin	0
persimmon	fusiform aneurysm	0
arachis	uveitide	0
confection	bovine lymphosarcomas	0
sweet orange	atopic disease	0
cannabis indicas	epithelioma	0
andira	semantic memory disorders	0
molasse	ankylosing spondylitis	0
citrus aurantiifolia	colorectal tumor	0
mesquite	cancer of the tongue	0
tarragon	urticaria	0
black walnuts	salami brusher's disease	0
vegetable juice	severe congenital microcephaly	0
dietary fiber	single seizure	0
split peas	hypesthesia	0
dietary fats	hypospadia	0
bibhitaki fruit	galactokinase deficiencies	0
zedoary zedoarias	clonic seizure	0
cinnamomum verum	stomatognathic diseases	0
kombucha tea	proteinuria	0
catfish	spindle-cell carcinoma	0
crave chocolate	myalgia	0
fries	small-cell lymphomas	0
soft drinks	colon neoplasm	0
ice cream	insomnia disorders	0
chenopodium quinoa	plasmodium infections	0
fresh ginger	creutzfeldt-jakob disease	0
peach tree	female infertility	0
usda poultry	burkitt's lymphoma virus	0
cannabis	rectal tumors	0
mentha	udp-galactose-4-epimerase deficiency diseases	0
sweet basils	amyotrophic lateral sclerosis motor neuron disease	0
real chocolate	cerebrovascular strokes	0
granny smith apples	decreased cancer	0
brassica juncea	ciguatera fish poisoning	0
lemon balms	pulmonary cancers	0
lemon tree	mouth and tooth diseases	0
pease	fibrous meningioma	0
red wine	neurodegenerative diseases	0
meal time	bronchiolitis obliterans	0
chlorella	renal failures	0
measuring food	alopecia cicatrisata	0
secale	deaf-mutism	0
atropa belladonna	upper respiratory infections	0
cranberry juice	rectum cancers	0
corn	undifferentiated lymphomas	0
cocoa powder	pancreas cancers	1
raw tomatoes	pancreas cancers	0
nutraceutical	pseudocoma	0
term vegetable	splitting pain	0
artificially-flavored corn	visceral steatoses	0
longevity legumes	feline lymphoma viruses	0
chicken salad	congenital defects	0
cassia tree	rectal neoplasms	0
rubus	asymmetric diabetic proximal motor neuropathy	0
soda pops	radiating pains	0
juglan	new variant creutzfeldt jakob disease	0
cherry plum trees	primary malignant brain tumors	0
pizza	myeloid leukemia	0
barley	fibrous meningiomas	0
whole grain cereal	chronic fatigue syndromes	0
filtered coffee	periorbital headaches	0
althea officinalis	juvenile parkinsonism	0
legume pods	cognitive impairment	1
strawberry	lyme borreliosis	0
cocoa plant	tumor of rete testis	0
weekly meat	alcoholism	0
drug administration united states food	bipolar disorder	0
triticum aestivum	epileptic seizures	0
concord grape	human immunodeficiency virus	0
guacamole	fusiform aneurysm	0
prunus salicina	neurotic anxiety state	0
overpriced vitamin	continuous tremor	0
glycyrrhiza glabra	plegia	0
dried cranberries	sciatica	0
nicotiana	human cancer	0
hickory tree	intracranial neoplasms	0
faba beans	tactile amnesia	0
nutrient-dense foods	intracranial neoplasms	0
trigonella	encephalon disease	0
drinking orange	kidney insufficiency	0
avena sativa	tactile hypesthesia	0
vicia faba	testis neoplasms	0
afzelia	gastric cancers	0
jambolan plum tree	food hypersensitivity	0
carbonated drinks	auriculo-ventricular dissociation	0
processed apples	psychophysiological insomnia	0
eden foods	body weight	0
pumpkin pie	contagious pustular dermatitides	0
lycium barbarum	gehrig disease	0
cereal grain	orf	0
specific cheeses	age related macular degeneration	0
lemon verbena	sharp headache	0
citrus x paradisi	proteinuria	0
diabetic diets	intraepithelial neoplasms	0
noncaloric sweetener	skin disease	0
peach	retained surgical items	0
specific foods	pharyngitide	0
taraxacum officinale	low back aches	0
nut butters	inflammatory polyneuropathy acutes	0
probiotic	lung inflammations	0
lunch times	ciguatera fish poisonings	0
celery root	generalized headaches	0
commercial milk	small-cell lymphoma	0
cocoa plants	stomach ulcers	0
lima beans	colic	0
capsicum annuum	cancer of the breast	0
allspice	manic disorders	0
neu5gc-rich food	texidor twinge	0
a√ßa√≠ berries	icterus	0
euchresta	somatotropin (acromegaly) hypersecretion syndromes	0
peanut butter	cardiovascular strokes	0
kidney bean	fibrositis	0
infects apples	bronchiolitis obliterans	0
hemp plants	fibromyositis-fibromyalgia syndrome	0
kaffir lime	diabetic autonomic neuropathies	0
snack food	cranial pains	0
specific nuts	iron deficiency	0
peach trees	reticulum cell sarcoma	0
bread	passive tremor	0
curcuma zedoarias	behavior disorders	0
cherry	degenerative neurologic diseases	0
hamburger	eczematous dermatitides	0
dressing	intracranial meningioma	0
hydroponic basil	sunburn	0
vaccinium corymbosum	temporal region trauma	0
salsa	gorlin-goltz syndrome	0
cereal	cancer of liver	0
pimpinella anisums	hereditary essential tremor	0
dried apples	premenstrual tensions	0
milk proteins	cancer of penis	0
alpine strawberries	prion-induced disorder	0
corylus	testicular tumors	0
tea plant	higher cancer	0
red rice	lung disorders	0
coca	neurotic anxiety states	0
ephedra	low-grade b-cell malignancy	0
gluten	respiratory tract infection	0
plant aril	birth defects	0
four nuts	early diagnosis of cancer	0
margarine	cot death	0
amorpha	amyloid deposits	0
spicy food	chronic b cell leukemia	0
human milk	anemia	0
taraxacum	flatus	0
soy cheese	back pains	0
citrus sinensis	male sterility	0
grape seeds	prion induced disorder	0
isoglucose	cancer of skin	0
tap water	retrovirus	0
decrease meat	water stress	0
opium poppies	arterial dysfunction	0
purple rice	muscular rheumatism	0
rye	ischemic heart diseases	0
morel	oxygen deficiencies	0
cooking oil	right-sided heart failure	0
purple potatoes	progressive disorder	0
linum usitatissimums	fibrous meningioma	0
dark meat	chronic fatigue disorder	0
trigonella foenum graecum	acute monoblastic leukemia	0
spice turmeric	prediabetic state	0
ginger ale	ph1-negative myelogenous leukemia	0
kola nut	parkinsonism-dementia complex of guam amyotrophic lateral sclerosis	0
chinese cinnamons	acquired immunologic deficiency syndrome	0
ready prepared foods	nonhodgkin's lymphoma	0
euterpe oleracea	intervertebral disk degeneration	0
triticum durum	head pain	0
avena	anaplastic carcinomas	0
tepary beans	diffuse undifferentiated lymphoma	0
sea-food	joint disease	0
coco	developed cancer	0
mushroom	stomach cancers	0
grape	primary malignant brain neoplasms	0
curcuma longas	prostatitis	0
euterpe	acquired immuno-deficiency syndromes	0
jelly	anthrax	0
chamomile oils	cadaver	0
cider	confusional states	0
raw garlic	cjd (creutzfeldt jakob disease)	0
tea hibiscus	neurological condition	0
century plants	gastroenteritis	0
illicium	johnes disease	0
leek	fifth phacomatoses	0
cycad trees	bacterial vaginoses	0
java plum trees	limb tremor	0
multivitamin	dementia	0
marijuana	cancer of ovary	0
pepsi	acute monocytic leukemias	0
malus domestica	right-sided heart failure	0
cassia	diffuse lymphomas	0
fenugreek	barrett metaplasia	0
curry	behavior disorders	0
piper methysticums	myeloma-multiple	0
drink	atrioventricular dissociations	0
tumeric	gustatory seizure	0
domestic fowls	esophagus cancers	0
mock meats	non b hepatitis epidemic non a	0
lentil	rheumatoid arthritis	0
shellfish	androgenic alopecias	0
guibourtia	fibroadenoma	0
avenas	ovary cancer	0
pleurotus	severe congenital microcephalies	0
canned food	foodborne botulism	0
bell pepper	macular degeneration	0
deli meat	chronic illness	0
club soda	a-v dissociation	0
poisonous plant	head trauma	0
daucus carota	heart attacks	0
yam	deep-venous thromboses	0
dried blueberries	social phobias	0
chard	a-v dissociation	0
horse nettle	necrotizing fascitides	0
lentinus edodes	bone fracture	0
holy basil tea	blood clot	0
chickpea	neoplasm metastasis	0
daily nut	early-onset parkinsonism	0
fresh meat	psychosis	0
cymbopogon nardus	paraesophageal hernia	0
cola	colicky pain	0
pistachio	colorectal carcinomas	0
emblica officinali	lactose intolerance	0
individual food	type c oncoviruses	0
morning meal	bilateral sciaticas	0
alfalfa sprouts	dental fluoroses	0
big food	xanthomatous meningiomas	0
mint tea	benign neoplasm	0
green beans	age-related maculopathies	0
empty calorie foods	common cancer	0
herb	complete hearing loss	0
stryphnodendron	spiral fractures	0
largest meal	auricular fibrillations	0
so-called vegetable	non-b hepatitis epidemic non-a	0
salmonella-infected eggs	nevoid basal cell carcinoma syndrome	0
assai palm	deglutitional syncope	0
pistacia vera	beriberi	0
coleslaw	testicular tumors	0
plant capsules	persistent tremor	0
century plant	carcinogenic retroviruses	0
areca catechus	botulism	0
mangifera indicas	guillain barre syndrome	0
petroselinum crispum	galactosemia 3	0
hummus	fibromyalgia-fibromyositis syndromes	0
baby formulas	hemolytic jaundice	0
fruit-shaped marshmallows	paraosmia	0
stevia	congenital abnormality	0
pea	fibrocystic disease of breast	0
kiwi	bladder cancers	0
sausage	protein deficiency	0
phyllanthus emblicas	small noncleaved cell lymphoma	0
chia seeds	kidney cancer	0
dioscorea	emphysema	0
pithecellobium	cancer-causing viruses	0
cruciferous foods	mixed lymphomas	0
drinking tea	male subfertility	0
domestic fowl	parkinson‚Äôs disease	0
prebiotic	urticaria	0
jelly beans	brain malignant neoplasm	0
atropa belladonnas	hypovolemic shock	0
dried fruit	schilling type myeloid leukemia	0
vaccinium uliginosum	abdominal cramp	0
cucumber	low back pain	0
lipomul	male sub-fertility	0
butter	chronic obstructive pulmonary disease	0
shan yaos	autoimmune disease	0
nettle tea	esophageal reflux	0
healthiest snack	joint pains	0
soy beans	arrhythmia	0
stuff	canker sores	0
citrus	cluster headache syndrome	0
black pepper	texidor twinge	0
handling food	upper respiratory infection	0
find pork	aura	0
drink tea	anal fissure	0
arecas	liver failure	0
beef	vulva cancers	0
olive oils	idiopathic proctocolitis	0
porgy	human t cell leukemia virus type iii	0
poenumgraecum	prion induced disorder	0
food and drug administration	primary brain tumors	0
saint johnswort	menstrual disorders	0
chinese cassia	saturnine tremors	0
pecan tree	virus infection	0
dark chocolate	lymphocytic lymphomas	0
chinese rhubarb	migratory pain	0
coriander	bipolar disorders	0
cultivated radish	acute inflammatory polyneuropathy	0
hordeum vulgare	regional ileitides	0
lucerne	burkitt's lymphoma virus	0
callerya	dental fluoroses	0
whole grain	minor head injury	0
muffin	esophageal cancers	0
dried yeast	lichen rubra planus	0
liquor	primary malignant brain tumors	0
petroselinum	ph1 negative myelogenous leukemia	0
eating eggs	secondary fibromyalgia	0
emphasize plant	coronary disease	0
portulaca	miscarriage	0
fermented cabbage	macular dystrophy	0
no noni	experimental parkinson disease	0
wolfberry	postural low back pain	0
mackerel	schilling type myeloid leukemia	0
raphanus sativus	age-related memory disorder	0
arachis hypogaea	diverticula	0
fruit and vegetable juices	gastric neoplasms	0
brewage	blood clots	0
plant arils	neurologic degenerative diseases	1
deli meats	drug dependence	0
beet greens	felv	0
brazil nuts	resting tremor	0
grape juice	throat cancer	0
lime	obesity in childhood	0
carica papayas	uterine fibroid	0
horse bean	somatotropin hypersecretion (acromegaly) syndromes	0
laciniate nightshades	postoperative nausea	0
use sweeteners	situational syncopes	0
soybean	physical suffering	0
sparkling waters	endometrium cancer	0
cured meats	lichen planus	0
study lavender	bacterial vaginosis	0
cassia trees	spinal cord diseases	0
porphyra	cerebral stroke	0
oolong	viral infections	0
fruit juices	manic states	0
convenience food	nutritional disease	0
calendula officinalis	cholera	0
cinnamomum zeylanicum	water-borne hepatitis	0
sweet almond	female sub fertility	0
chinese yam	insulin-dependent diabetes mellitus	0
dioscorea villosa	radiating pain	0
low-salt diet	testicular tumors	0
garden radish	delusory parasitosis	0
high-phytate foods	infantile obesity	0
solanum melongenas	paratuberculosis	0
dragon fruit	vitamin deficiency	0
lemon grasses	menstrual pains	0
texturized vegetable proteins	well-differentiated lymphocytic lymphomas	0
diospyros digyna	fibrositis	0
bean sprouts	granulomatous colitis	0
chanterelle	irritable colon	0
bitter orange trees	central nervous system intracranial disorders	0
fried foods	small non-cleaved-cell lymphoma	0
bitter orange tree	pancreatic cancer	0
mango	acute strokes	0
persea americana	hemolytic jaundice	0
wheat bran	amnesia-memory losses	0
anticancer plant	situational syncopes	0
morinda citrifolias	iron overload	0
amla	chronic obstructive lung disease	0
french fries	low back pains	0
citrus reticulatas	darkness tremors	0
stevia rebaudianas	prion protein diseases	0
ready-prepared foods	age related osteoporosis	0
yoghurt	pruritis	0
portulaca oleracea	hemicrania migraines	0
citrus reticulata	infectious disease	0
seven nutrients	udp-galactose-4-epimerase deficiencies	0
green peas	b cell leukemia	0
rheum rhaponticum	fibromyositis-fibromyalgia syndrome	0
alcoholic beverages	plasma-cell myeloma	0
eating almonds	arterial dysfunction	0
high-fructose corn	dental plaque	0
raw broccoli	lymphocytic lymphomas	0
unrefined plant	chronic airflow obstructions	0
illicium anisatums	charcot disease	0
turnip	infarction	0
healthiest apple	transmissible dementias	0
raw poultry	diffuse mixed-cell lymphomas	0
zinger tea	anal fissure	0
venison	amyloid deposits	0
plant capsule	thyroid cancer	0
tuna fish	male sub-fertility	0
mealtime	cancer of the cervix	0
eupatorium rebaudianum	painful diabetic neuropathy	0
petroselinum crispums	kahler disease	0
cooked meats	sliding esophageal hernias	0
capparis	crushing skull injuries	0
seltzer water	low backache	0
kombucha teas	pulmonary inflammation	0
english walnuts	brain malignant neoplasms	0
adhatoda vasica	substance addiction	0
prunus salicinas	gehrig's disease	0
fagopyrum tataricum	familial dementia	0
swiss chard	irritable colon	0
eating meat	prostatitis	0
thymus vulgaris	wart viruses	0
baby formula	voice box cancer	0
lunch time	penile neoplasm	0
energy drink	cluster headaches	0
grapefruit juice	degenerative intervertebral disk	0
wort	crushing skull injury	0
scrambled eggs	well differentiated lymphocytic lymphoma	0
cooked carrots	beriberi	0
own vitamin	familial dementias	0
plaice	car sickness	0
black currants	lung disease	0
aspartame	steatohepatitis	0
croaker	muscle tremors	0
espresso	norovirus	0
cocktail	gynecomastia	0
popular fruits	benign meningioma	0
pecan	esophageal neoplasm	0
marjoram plants	micturition syncope	0
low fruit	intervertebral disc degenerations	0
different seed	cll lymphoplasmacytoid lymphoma	0
golden delicious	well-differentiated lymphocytic lymphomas	0
eating broccoli	renal neoplasms	0
ocimum basilicum	influenza	0
herr	female sub-fertility	0
collard greens	benign essential tremor	0
jalapeno	cardiovascular conditions	0
irritable bowel kiwi fruit	crushing skull injury	0
assai palm berry	blood clots	0
oryza sativa	splitting pains	0
pimenta diocias	rectal tumors	0
chinese cassias	cancer of stomach	0
emphasizes vegetables	spinal cord degenerative diseases	0
sun-dried raisin	temporary amnesias	0
prosopi	burkitt's lymphoma virus	0
maple	guam disease	0
yolk	esophageal neoplasms	0
sweetening agent	jakob-creutzfeldt syndrome	0
edible grain	acute inflammatory demyelinating polyneuropathy	0
ultra-processed food	coarse tremor	0
dioscorea polystachya	wart	0
golden glow	terminal ileitis	0
endive	polyradiculoneuritide	0
crabapple	low-grade b-cell malignancy	0
cola nitida	ph1-negative myeloid leukemias	0
betel nut	hiatus hernias	0
curry powder	ph1 negative myeloid leukemia	0
moose meat	colitide	0
brown sugar	lichen planus	0
high fructose corn syrup	transitional meningiomas	0
carya illinoenses	subtrochanteric fractures	0
french bean plants	iodine deficiency	0
whiting	pulmonary cancers	0
sweet marjoram	brain cancer	0
beta vulgaris	proliferative bronchiolitides	0
vaccinium angustifolium	diabetic retinopathy	0
texturized vegetable protein	rhabdomyolysis	0
triticum turgidum	childhood obesity	0
kava kava	small round-structured viruses	0
grecian foxglove	minor head injuries	0
soy protein	lens opacity	0
ocimum tenuiflorum	cancer of the prostate	0
elettaria cardamomum	cancer of thyroid	0
flax seed	intractable headache	0
corn syrup	infarction	0
cocoa butter	nanism	0
big meals	malignant lymphoma	0
hibiscus	inappropriate growth hormone secretion syndrome (acromegaly)	0
calling eggs	painful menstruations	0
glucose fructose syrup	zoonotic diseases	0
apple tree	peanut allergies	0
herbal teas	chronic b-lymphocytic leukemia	0
red cabbage	low back pains	0
sugar substitutes	experimental parkinsonisms	0
cuminum	idiopathic polymyositis	0
purple grape	pregnancy pernicious vomiting	0
black coffee	central nervous system intracranial disorders	0
food company	senile tremor	0
group foods	ductal carcinoma	0
euterpe precatoria	skin cancer	0
areca nuts	pyrosis	0
cicer arietinum	liver cancers	0
gluten-free diet	acute coryza	0
citrus aurantiifolias	bechterew disease	0
red tea	encephalopathy	0
zedoary zedoaria	familial guillain-barre syndrome	0
dietary sucrose	deafness	0
glucose-fructose syrup	senile paranoid dementia	0
aloe vera	senile paranoid dementia	0
blackberry	botulism	0
scallion	shock	0
raw alfalfa	penis neoplasm	0
dried pomegranate	dermatozoic delusions	0
decaf	delusory parasitoses	0
split pea	left-sided heart failure	0
kangaroo meat	wheat allergies	0
cicer arietinums	new variant creutzfeldt jakob disease	0
mother cells	penile neoplasm	0
sea bilberry	spongiform encephalopathies	0
powdered sugar	disc degradation	0
areca	continuous tremor	0
elettaria	thrombosis	0
fermented foods	type c oncoviruses	0
hazelnut	brain cysticercosis	0
chili	tussive syncopes	0
vitis	endocrine breast diseases	0
tangerine tree	benign meningioma	0
earl grey tea	virus infections	0
worldwide fruit	multiple sclerosis	0
citrullus	vaginal discharges	0
arginine-rich foods	congenital defect	0
sugar	inflammatory bowel diseases	0
national meat	pancreatitis	0
prunus domestica	foodborne botulisms	0
uncooked foods	small and large cleaved-cell lymphoma	0
include flaxseed	intractable headache	0
sustenance	transient insomnia	0
hemp	visceral obesities	0
food poisoning	mixed-cell lymphoma	0
secale cereale	guam disease	0
anacardium occidentale	diabetic mononeuropathy	0
eating food	deep vein thromboses	0
rheum tanguticum	parkinson disease 2	0
beverage	epithelial cancer	0
pistacia	inflammatory bowel diseases	0
cherry plum tree	body weight	1
cereal grains	convulsive syncopes	0
retail meat	colorectal carcinomas	0
ranking foods	cranial pain	0
shoot	oncogenic viruses	0
hickory trees	transmissible spongiform encephalopathies	0
citron trees	age-related maculopathy	0
banana plants	chronic fatigue syndromes	0
carthamus tinctorius	gum disease	0
mint	primary fibromyalgia	0
watercress	disk degradation	0
breast milks	chromosome 6-linked autosomal recessive parkinsonism	0
abelmoschus	hypolactasia	0
avoid peanuts	renal insufficiencies	0
cooked meat	bipolar disorders	0
illicium anisatum	testicular tumors	0
inadequate fruit	gastro esophageal reflux	0
oyster mushroom	auditory seizure	0
bt corn	renal failure	0
colocasia	landry guillain barre syndrome	0
lard	elevated cholesterol	0
pinto beans	insulin resistance	0
tuna	sleep-related neurogenic tachypnea	0
chamomile tea	age-related maculopathies	0
lunchtime	heatstroke	0
navy beans	nonspecific vaginitis	0
macadamia nut	cervical neoplasm	0
caper	eczema	0
trompillo	cervical migraine syndrome	0
rosa	gluten enteropathies	0
component spices	fibromyalgia fibromyositis syndrome	0
baby spinach	chronic obstructive lung disease	0
common olive tree	peripheral demyelinating autoimmune disease	0
uncooked food	ph1-negative myeloid leukemia	0
vaccinium bracteatum	prostatitis	0
vaccinium macrocarpon	lead poisoning	0
justicia	undifferentiated lymphomas	0
horse beans	presyncope	0
indian laburnums	aphthae	0
mussel	joint pain	0
french bean plant	multiple myositis	0
rose berries	osteoarthrose	0
bran flakes	blood clot	0
aquatic food	galk deficiencies	0
dried apricots	bilateral headache	0
clove	primary growth hormone resistance	0
low meat	hormonal dysfunction	0
hemlock	neurologic degenerative diseases	0
goji berries	nutritional disease	0
foodstuff	mental deterioration	0
quinoa	aids viruses	0
chili pepper	cerebral stroke	0
antioxidant fruits	polymyositis	0
fructose corn	seizure	0
coffee	recurrent brain tumors	0