
garbanzo	small-cell lymphomas	0
drink milk	nasal cavity cancer	0
agave	starvation	0
breakfast cereals	pyrose	0
nutmeg	chronic b cell leukemia	0
breakfast	gluten-sensitive enteropathies	0
preserved food	intraepithelial carcinoma	0
euterpe oleracea mart.s	male breast carcinoma	0
celery root	pulmonary embolisms	0
cumin	renal neoplasms	0
olea	t virus	0
cardamon	insulin-dependent diabetes mellitus	0
trigonella foenum-graecum	penile neoplasms	0
adhatoda vasica	amyotrophic lateral sclerosis with dementia	0
herbal tea	cjd (creutzfeldt jakob disease)	0
nuclear power plant	pancreas neoplasms	0
lens plants	myocardial ischemias	0
ocimum tenuiflorum	massive tremor	0
anise	water-borne hepatitis	0
lucerne	amyloid deposit	0
malus domestica	low back ache	0
cleistocalyx	atherosclerotic plaques	0
ribe	charcot disease	0
cultivated radish	prion induced disorder	0
common bean plant	atrioventricular dissociations	0
arachis	hypermelanosis	0
calendula officinali	diffuse small cleaved cell lymphoma	0
macadamia	brain disease	0
citrus	autism	0
olive trees	chronic fatigue disorder	0
chicken salad	avitaminose	0
erythroxylon	lymphadenopathy-associated viruses	0
unhealthy food	cancer of the skin	0
prunis communis	new variant creutzfeldt-jakob disease	0
teff	poultry viruses	0
pomelo trees	abdominal pains	0
whole foods	cardiovascular diseases	0
morning meals	nasal cavity cancer	0
chile peppers	exanthema	0
wisconsin milk	female infertility	0
java plum trees	prion protein diseases	0
caffeinated coffee	dermatosis	0
sea bilberry	foodborne botulisms	0
red wine	non hodgkin lymphoma	0
kale	steatohepatitis	0
organic plants	neuritic plaques	0
food supplementations	rodent ulcer	0
solanum lycopersicum	cancer of the vagina	0
table salt	hydrophobia	0
vegetable proteins	anxiety disorders	0
pummelo trees	heatstroke	0
malabar-nut	mental disorders	0
oyster mushroom	adenomatous polyp	0
plant aril	benign neoplasms	1
red tea	e-b virus	0
spaghetti	prostate neoplasms	0
aquatic food	stomatognathic diseases	0
organ	epimerase deficiency galactosemias	0
drinking milk	atopic disease	0
jam	johne's disease	0
cassia fistulas	cva (cerebrovascular accident)	0
taraxacum	ischemic heart disease	0
lemon verbena	tonsillar neoplasm	0
blueberry plants	cervical cancer	0
carthamus tinctorius	nonhodgkin lymphoma	0
cayenne peppers	kidney neoplasms	0
maraschino cherry	hepatic cancer	0
colorful foods	recurrent brain tumors	0
fermented cabbage	intracranial central nervous system disorders	0
chenopodium quinoa	vulvar cancers	0
coconut	mottled enamel	0
silken tofu	dysfunction	0
nicotiana tabacum	senile paranoid dementia	0
pickled vegetables	complete blindness	0
crowberry	idiopathic parkinson's disease	0
nori	gastric cancer	0
prunus domestica	brain cysticercosis	0
noni fruit	growth hormone insensitivity syndrome	0
purple cabbage	liver steatosis	0
tap water	atrophy	0
piper methysticums	iritis	0
kawa kawas	thyroid disorders	0
dried cranberries	ciliary body spasms	0
raw tomatoes	idiopathic parkinson disease	0
mushroom	respiratory tract infection	0
wild yams	autosomal recessive juvenile parkinson disease	0
chili peppers	odontogenic keratocysts multiple basal cell nevi	0
watercress	psammomatous meningiomas	0
betel	colorectal tumors	0
higher vegetable	migraine headaches	0
triticum turgidum subsp. durum	testicular neoplasm	0
cooked broccoli	meningiomatose	0
sunflower seeds	fifth phacomatoses	0
juiced broccoli	parodontosis	0
prunus salicinas	human herpesvirus 4 (gamma)	0
grapefruit juice	arthritide	0
different seed	gestational diabetes	0
carbonated mineral water	lassitude	0
dried pomegranate	chronic cystic mastitis	0
deep-fry foods	gastric acid reflux disease	0
incorporate cloves	prostatitis	0
bolete	cephalgia	0
usda poultry	continuous tremors	0
illicium verums	rest tremors	0
human milk	episodic cluster headaches	0
dairy eggs	low-grade b-cell malignancy	0
dried peas	tonic-clonic seizure	0
crunch berries	retained surgical sponge	0
wild radish	cancer of bladder	0
nut butters	hypesthesia	0
purple grape	atypical diffuse small lymphoid lymphoma	0
cola acuminata	nbcc	0
national meat	growth hormone receptor deficiency	0
açai berries	pulmonary neoplasm	0
oryza	microlissencephaly	0
spearmint	ankylosing spondyloarthritis	0
sushi	elevated cholesterols	0
grouper	pulmonary disease	0
vaccinium ashei	stomatognathic disease	0
sardine	neoplasm metastases	0
eating eggs	viral disease	0
sweet foods	rectal neoplasm	0
dietary supplement	mottled enamels	0
foenumgraecum	eye diseases	0
nutraceutical	lung disorders	0
baked potato	benign essential tremors	0
seville orange tree	multiple sclerosis	0
andean blackberry	tubal abortion	0
food and drug administration	gastro-oesophageal reflux	0
brewed coffee	marek's disease virus	0
trace minerals	low-grade lymphomas	0
warm milk	virus diseases	0
poppy	cancer of the vagina	0
foxglove	bacteria-eating viruses	0
green beans	airsickness	0
soybean	inhibit cancer	0
boiled eggs	metabolic acidoses	0
healthiest beverages	birth weights	0
tree nuts	polymyositis ossificans	0
vaccinium uliginosum	arrhythmia	0
bertholletia excelsa	schilling-type myeloid leukemia	0
horse nettle	amaurose	0
nettle tea	dementia with amyotrophic lateral sclerosis	0
saint john's wort	intracranial central nervous system disorders	0
red rice	visual seizure	0
solanum laciniatums	cardiac failure	0
gala apples	periodontal diseases	0
tomato sauce	seizure disorders	0
woodland strawberry	arterial fatty streak	0
prosopis	body weights	0
bitter orange tree	epstein-barr virus	0
pancake	bowel disease	0
dasheen	primary growth hormone resistance	0
papaver somniferum	necrotizing fasciitides	0
bertholletia	jakob-creutzfeldt disease	0
baby spinach	diabetic polyneuropathy	0
frier	breast neoplasms	0
tofu	viral disease	0
cherry plum tree	retro ocular headache	0
artificially-flavored corn	menstrual disorders	0
eat flax	generalized headaches	0
individual candy	ocular headaches	0
domestic fowls	amyloidosis	0
popular fruits	cephalgia syndromes	0
star anise	auriculo-ventricular dissociation	0
elettaria cardamomum	low back ache	0
vaccinium virgatum	intraorbital meningioma	0
peach tree	secondary fibromyalgia	0
arugula	fibrous meningioma	0
feather meal	cancer of pancreas	0
potassium-rich foods	insulin deficiency	0
glycyrrhiza glabra	tonsil neoplasms	0
silybum marianum	intractable headache	0
cashew	osteoarthrose	0
club sodas	back aches	0
taking vitamin	intraorbital meningiomas	0
hibiscus sabdariffa	lobar pneumonia	0
bottled water	peripheral arterial diseases	0
unfiltered coffee	allergic diseases	0
laciniate nightshades	transitional meningiomas	0
eggplant	eye disease	0
garlic sauce	tactile amnesia	0
tepary bean	olfaction disorders	0
raphanus sativus	abdominal aortic aneurysms	0
food poisonings	poultry viruses	0
coffee	spinal cord degenerative diseases	0
hibiscus tea	stokes-adams syncope	0
cassia tree	auditory seizures	0
butter milk	sleep related neurogenic tachypnea	0
pear	textiloma	0
olive family	hay fever	0
alfalfa	lymphoblastic leukemia	0
chamomile tea	chronic lymphatic leukemia	0
kenaf	micturition syncopes	0
big food	postoperative nausea and vomiting	0
rooibo	microlissencephaly	0
new candy	plasma cell myelomas	0
pithecolobium	contusion	0
decrease meat	prostatic cancer	0
orange tree	non-epileptic convulsions	0
serve	dementia	0
cooked carrots	delusional parasitosis	0
tarragon	vagina cancers	0
chilli pepper	breast diseases	0
dietary plant protein	bovine lymphomas	0
pork	memory deficit	0
espresso	basal cell epithelioma	0
vitis	enterocele	0
syzygium aromaticum	retained surgical items	0
marjoram plants	muscle spasms	0
handling meat	spatial memory disorders	0
plaice	skin disease	0
humulus	prion-induced disorders	0
red delicious apples	short sleep phenotypes	0
cycad trees	sarcoma	0
sesame oil	acquired immunodeficiency syndromes	0
carica papaya	craniocerebral injuries	0
ilex paraguarienses	non-hodgkin lymphoma	0
no meat	chronic b lymphocytic leukemia	0
granny smith apples	mouth neoplasms	0
fat foods	senile osteoporoses	0
red meats	kidney insufficiencies	0
shiitake mushrooms	classic galactosemias	0
phaseolus	intestinal disease	0
berberis	androgenetic alopecia	0
sour orange tree	cardiovascular conditions	0
eugenia caryophyllata	bacterial vaginosis	0
shoot	hemangioblastic meningiomas	0
flaxseed	inflammatory polyneuropathy acute	0
peppermint	laron type dwarfism i	0
haritaki fruit	syncopal episodes	0
blackberry	senile paranoid dementia	0
low-sodium diet	neurodegenerative diseases	0
powdered ginger	brain malignant neoplasms	0
squash	lymphosarcoma	0
anti-inflammatory plant	pharyngitis	0
kola nuts	amyotrophic lateral sclerosis with dementia	0
portulaca oleracea	tussive syncope	0
citrus reticulatas	female sub-fertility	0
monkfish	pulmonary inflammation	0
poisonous plant	schilling type myeloid leukemia	0
oat	renal calculi	0
specific cheeses	condylomata acuminata	0
soymilk	persistent atrial fibrillations	0
leaf lettuce	auricular fibrillations	0
salmonella food	necrotizing fasciitis	0
eating fruits	rash	0
retail meat	bse (bovine spongiform encephalopathy)	0
split peas	cerebrovascular strokes	0
arginine-rich foods	colorectal tumor	0
allium porrum	preinvasive carcinoma	0
illicium verum	colorectal cancers	0
trigonella foenum graecum	influenza in humans	0
healthiest foods	ankylosing spondylarthritides	0
soda pops	bronchial asthma	0
avenas	insulin dependent diabetes mellitus	0
black coffee	degenerative diseases	0
wild celery	sore throats	0
lycium	pruritus	0
group foods	malignant meningioma	0
laudable legume	e-b virus	0
zinger tea	parodontosis	0
salt-free diet	viral infection	0
term vegetable	udpglucose 4-epimerase deficiency disease	0
psidium guajava	skin neoplasm	0
plant-based nutrients	sub-fertility	0
soup	determination of death	0
morinda	common cold	0
rise	testicular tumors	0
raw cranberries	nonhodgkin lymphoma	0
adding blueberries	sinusitis	0
muffin	cerebrovascular accident	0
raspberry	polyarthralgia	0
plant arils	age related osteoporosis	1
olive	pediatric cancers	0
family vegetables	gastric neoplasm	0
no coffee	dna injury	0
vaccinium macrocarpons	bse (bovine spongiform encephalopathy)	0
hypericum perforatum	asymmetric diabetic proximal motor neuropathy	0
cannabis indicas	plasmodium infection	0
century plant	varix	0
almond butter	rectal cancer	0
fat milk	diffuse lymphocytic lymphoma	0
prunus cerasifera	crushing pains	0
rheum rhaponticum	recurrence	0
steak	prion-induced disorder	0
sugar-sweetened beverages	rest tremors	0
dinner times	lou gehrig disease	0
processed apples	emphysema	0
lavandula angustifolia	congenital abnormalities	0
caryophyllus	headache disorder	0
bacon	age related maculopathy	0
healthiest vegetable	water stress	0
callerya	thrombosis	0
drinking tea	vertiginous seizures	0
oreo	vertiginous seizures	0
food supplements	post-traumatic osteoporoses	0
chewed coca	hypermelanose	0
aloe	muscle tremor	0
white potatoes	memory deficit	0
melissa	recurrent brain tumors	0
carduus marianus	chest pains	0
black rice	constrictive bronchiolitis	0
phyllanthus emblicas	senile paranoid dementias	0
punica granatum	infarction	0
raphanus	peanut allergy	0
amygdalus communis	insulin dependent diabetes mellitus	0
chewing gums	allergic reactions	0
processing meat	blood cancer	0
rubberplant	atrioventricular dissociations	0
acai berries	monocytic leukemia	0
currant	hiccup	0
treat	epstein-barr virus	0
mangiferas	udp galactose 4 epimerase deficiency disease	0
sweet potatoes	cancer of the colon	0
yolk	deficiency diseases	0
flax	dysfunction	0
celeriac	cancer of pancreas	0
sorrel	lymphoma	0
measuring food	lyme arthritis	0
citrus hystrix	hormonal dysfunction	0
mustard greens	chronic cluster headaches	0
english walnut	pus	0
justicia adhatoda	food-borne illnesses	0
digitalis	cardiovascular diseases	0
onion	diabetes mellitus complications	0
whipped cream	oncogenese	0
vicia fabas	cardiogenic syncopes	0
junk foods	gerd	0
organ meats	senile osteoporosis	0
euterpe edulis	campylobacter infections	0
animal food	olfactory groove meningiomas	0
brazil nuts	gastro esophageal reflux	0
chicken meat	esophageal neoplasm	0
chinese cinnamon	prostate disease	0
agaricaceae	fibroid tumor	0
know nuts	crushing skull injury	0
chipotle	sleep wake disorder	0
citrus-based fruits	zoonotic infection	0
garcinia mangostanas	joint disease	0
raphanus raphanistrum	gehrig disease	0
white meat	sea sickness	0
anise tea	rhabdomyolysis	0
low fruit	respiratory tract infections	0
carbonated beverage	high cholesterol levels	0
brewing tea	chronic infectious mononucleosis-like syndrome	0
nut butter	male breast cancer	0
smoked foods	kidney disease	0
virgin olive	philadelphia-negative myeloid leukemia	0
raisin	dizzyness	0
mentha spicatas	tactile hypesthesias	0
club soda	fibrocystic breast disease	0
mangifera indicas	paratuberculosis	0
mastic tree	common colds	0
vicia faba	prostatic adenomas	0
fruit juices	low backache	0
golden glow	atypical chronic myeloid leukemia	0
yerba mates	presyncope	0
fast food	hemangioblastic meningiomas	0
star anises	peanut allergies	0
broccoli	liver cancer	0
syzygium	chronic obstructive pulmonary disease	0
sour orange trees	visceral steatoses	0
infant formulas	degenerative neurologic disorder	0
durum wheat	behavior disorders	0
bell pepper	nbcc	0
shan yaos	constrictive bronchiolitides	0
cheese	diabetic polyneuropathy	0
fed beef	varicose veins	0
soy yogurt	chronic daily headache	0
berry	dental diseases	0
molasse	mechanical low back pain	0
retail poultry	cancer of the endometrium	0
cilantro	menstrual pains	0
catfish	bovine lymphosarcomas	0
horsenettle	mottled enamels	0
brazil nut tree	rabies viruses	0
pinto bean	ischemia	0
official vitamin	sudden cardiac death	0
capsicum annuum	type i diabetes mellitus	0
ketchup	gynecomastia	0
milk protein	disseminated sclerosis	0
syrup	legal blindness	0
marihuana	oncovirus	0
fresh fruits	early-onset parkinsonism	0
plant capsule	bipolar disorder	0
nut	tonsil cancer	0
ready prepared foods	spondyloarthritis ankylopoietica	0
grape	burkitt lymphoma virus	0
chicken	mental disorders	0
low vitamin	galactosemia 3	0
meal times	small cell lymphoma	0
caramel	chest pains	0
spice turmeric	intraepithelial carcinoma	0
hickory trees	postoperative vomiting	0
healthier meat	degenerative neurologic diseases	0
raw broccoli	skin diseases	0
jambolan plum tree	rna tumor virus	0
barley coffee	disk degradation	0
alcoholic beverage	carsickness	0
tea plant	diabetic retinopathies	0
diabetic diets	cardiovascular diseases	0
agent orange	substance abuse	0
curcuma longa	weight gains	0
dandelion	circulatory failure	0
olive oil	hysterical amnesia	0
use sweeteners	infarction	0
nuclear power plants	oncogenese	0
replenish nutrients	bone fracture	0
veggie	cancer of tongue	0
piper methysticum	neurodegenerative disease	0
mangifera indica	perforated appendicitis	0
whole grains	kidney failures	0
pimpinella anisum	childhood onset obesity	0
bhang	non epileptic convulsion	0
yogurt	salmonella infections	0
chewing gum	benign neoplasm	0
licorice	amentia	0
hop	familial diffuse gastric cancer	0
tobacco	unhealthy conditions	0
camomile	sphenoid wing meningioma	0
faba beans	grippe	0
chewing fruit	chronic fatigue and immune dysfunction syndrome	0
machaerium	galactosemia 2	0
goji berry plant	persistent tremors	0
cocoanut	foodborne illnesses	0
lemon balm	manic state	0
corn oil	intermittent tremors	0
curcuma zedoarias	juvenile-onset diabetes mellitus	0
porphyra	ciguatera fish poisoning	0
pistachio	hemorrhage	0
green grapes	tubal abortions	0
coriandrum sativum	non hodgkin lymphoma	0
processed meat	cancer-causing viruses	0
opium poppy	johne disease	0
cicer arietinum	uterine neoplasm	0
cruciferous vegetable	horton syndrome	0
dairy products	monocular blindness	0
organic meat	burkitt herpesvirus	0
ground ginger	colon neoplasm	0
green onions	pancreas neoplasms	0
antioxidant food	hypermelanosis	0
red yeast rice	gluten sensitive enteropathy	0
ephedra	human cancer	0
prebiotic	liver dysfunction	0
crab apple	diabetes complications	0
chinese yam	somatotropin hypersecretion syndrome (acromegaly)	0
lens culinaris	semantic memory disorders	0
pureed apples	fibrous meningioma	0
walnut oil	short sleep phenotype	0
processed food	ovary cancer	0
tuna	kidney diseases	0
lunch times	cluster headache syndromes	0
cocoa powders	renal cancers	0
soft drinks	starvation	0
soy beverages	gastric acid reflux disease	0
persea americana	vaginal cancers	0
marsh mallows	coma	0
glycine max	cephalodynia	0
carbonated mineral waters	tumor virus	0
plantago lanceolata	amyotrophic lateral sclerosis parkinsonism dementia complex 1	0
cacao	retained surgical sponges	0
root	stroke	0
coriander	benign meningiomas	0
chinese cassias	hemorrhage	0
seven nutrients	prevent and reverse heart disease	0
trigonella foenum-graecums	bovine lymphoma	0
acaí berries	arterial fatty streak	0
ceylon cinnamon	plegia	0
tepary beans	prion-induced disorders	0
inadequate fruit	multiple myeloma	0
true nut	determination of death	0
fortify milk	blood clot	0
rosehip	degenerative neurologic disease	0
crab apples	avitaminosis	0
yam	paralysis agitans	0
wheat bran	generalized spasms	0
citrus grandis	infant botulisms	0
fries	alopecia cicatrisata	0
mint	iron deficiency	0
pleurotus	b12 deficiency	0
watermelon	sudden onset diabetes mellitus	0
milk	memory disorder	0
calendula officinalis	intracranial cns disorder	0
soya milk	bacterial vaginitides	0
target vitamin	viral disease	0
baptisia	cognitive retention disorder	0
cranberry	spontaneous abortion	0
nicotiana tabacums	autistic disorder	0
hydroponic basil	short sleep phenotypes	0
saint john wort	intraorbital meningiomas	0
artichoke	spondylitis ankylopoietica	0
pineapple juice	esophageal neoplasms	0
goji berry plants	short sleep phenotypes	0
century plants	infant gynecomastia	0
capparis	crushing pains	0
allium cepa	abdominal obesity	0
sugar water	back pains	0
oregano	wound botulism	0
frosting	paludism	0
colocasia	vulva neoplasm	0
lycium chinense	diabetic asymmetric polyneuropathies	0
frying meat	mad cow disease	0
raw foods	soft tissue sarcomas	0
triticum aestivum	headache disorders	0
maize syrup	inappropriate gh secretion syndrome (acromegaly)	0
dietary fiber	tactile amnesias	0
oolong tea	chronic pain	0
specific nuts	single seizures	0
healthy nuts	cancer of the thyroid	0
trompillo	disorders of initiating and maintaining sleep	0
fiddlehead ferns	weight loss	0
collard	head pains	0
density foods	dizziness	0
flax seed	hemolytic jaundices	0
acer negundos	liver dysfunctions	0
no noni	crushing pains	0
adhatoda	colorectal carcinomas	0
psyllium	lewy body parkinson disease	0
mangifera	breast fibrocystic changes	0
mussel	back pain with radiation	0
mastictree	sleep initiation dysfunction	0
brinjal	cervical neoplasms	0
dried fruit	prion diseases	0
romaine lettuce	bilateral headaches	0
soy protein	cancer of thyroid	0
applesauce	renal failures	0
healthiest nuts	tonic clonic seizures	0
foeniculum	cryptogenic epilepsy	0
ultra-processed foods	mixed lymphoma	0
mango	gastric cancer	0
medicago sativa	cjd (creutzfeldt jakob disease)	0
stevia	acute inflammatory polyradiculoneuropathies	0
diabetic diet	radiating pains	0
plant embryos	block cancer	0
foie gras	ph1 negative myeloid leukemia	0
purple potatoes	enterocele	0
food additives	ph1-negative myeloid leukemias	0
so-called vegetable	ciguatera poisonings	0
cereal grain	e-b viruses	0
malabar nut	disorientation	0
sweet marjorams	urinary bladder neoplasms	0
chili pepper	urticaria	0
healthiest snack	cardiovascular conditions	0
colophospermum	muscular cramp	0
hypericum	anaplastic carcinoma	0
trigonella	sid	0
thymus vulgari	bses (bovine spongiform encephalopathy)	0
probiotic	renal neoplasm	0
eugenia jambolana	insulin sensitivity	0
split pea	diabetic autonomic neuropathies	0
food companies	iron overload	0
rheum	hyperthermia	0
carob	genital warts	0
corn syrup	laron type dwarfism i	0
silybum marianums	pharyngitis	0
frozen fruit	utp hexose 1 phosphate uridylyltransferase deficiency disease	0
plantain	malignant primary brain neoplasms	0
store licorice	male subfertility	0
pimiento	udpglucose hexose-1-phosphate uridylyltransferase deficiency	0
green peppers	amaurosis	0
cacao bean	premature aging	0
pimpinella	ph1-negative myeloid leukemias	0
rubus glaucus	intracranial meningioma	0
andean blackberries	retained surgical instrument	0
citrus limon	non-alcoholic fatty liver disease	0
ginger ale	primary brain tumors	0
sweetening agents	increase cancer	0
grecian foxglove	testis cancers	0
pisum sativum	cataract	0
origanum	rectum neoplasm	0
maple	endothelial dysfunction	0
healthy foods	dysosmia	0
capsicum	intracranial cns disorder	0
handling food	auricular fibrillation	0
prenatal vitamins	hysterical amnesia	0
frozen broccoli	leucocythaemia	0
monosodium glutamate	early awakening	0
common fruits	paroxysmal atrial fibrillation	0
mandarin orange tree	pulmonary disorder	0
aspalathus	vaginal neoplasm	0
saccharomyces cerevisiae	fusiform aneurysms	0
hordeum	anaplastic carcinoma	0
soy foods	polyphagia	0
empty calorie foods	fibroatheroma	0
pimpinella anisums	lactose intolerance	0
pea family	sub-fertility	0
coleslaw	udpglucose 4-epimerase deficiency disease	0
honeybush tea	bladder cancer	0
floret	toxico infectious botulism	0
cola nitida	fighting cancer	0
plant embryo	leukemogenic viruses	0
kidney bean	kidney cancer	0
amaranth	gasser's syndrome	0
processed foods	colon disease	0
turnip	endotoxemia	0
grape juice	sterility	0
acacia tree	starvation	0
cocoa butter	tick bites	0
durum wheats	uterine fibroids	0
soy beans	endometrioma	0
squash plants	chronic b cell leukemia	0
cranberry juice	nonalcoholic steatohepatitides	0
thymus plants	tumor virus	0
majorana hortensis	substance use disorder	0
ananas	brain disorder	0
pummelo tree	familial creutzfeldt jakob disease	0
holy basils	dysfunction	0
banana	gall bladder disease	0
snack food	cancer of tonsil	0
chile pepper	chicken virus	0
bertholletia excelsas	olfaction disorders	0
shan yao	syncopal vertigos	0
milk chocolate	mastalgia	0
spore	epstein-barr virus	0
zingiber officinale	protein deficiencies	0
ready-to-eat meals	lung disorders	0
fava beans	complete hearing loss	0
plantago indica	chronic lymphatic leukemia	0
brassica	hemicrania	0
drinking water	thrombosis	0
buttermilk	salmonellosis	0
amlas	muscular spasm	0
dark chocolate	mixed small and large cell lymphoma	0
dietary proteins	frontal region trauma	0
longevity legumes	chronic b-cell leukemias	0
afzelia	confusion	0
melissa officinalis	superficial head injuries	0
digitalis purpurea	barretts syndrome	0
filtered coffee	deep vein thrombosis	0
hypericum perforatums	contagious pustular dermatitis	0
cherry plum trees	nontropical sprue	0
sweet pepper	feline lymphoma virus	0
high-fructose corn	transmissible dementia	0
chestnut	low back aches	0
cranberry sauce	heatstroke	0
trace element	hiccough	0
english plantain	rna tumor viruses	0
common foxgloves	multiple myeloma	0
dried apple	central obesities	0
restrict food	familial atrial fibrillations	0
jalapeno pepper	esophageal hernia	0
cucurbita	galactose epimerase deficiencies	0
hot sauce	atherogenesis	0
irritable bowel kiwi fruit	confusional state	0
rabbit meat	oncogenic viruses	0
cinnamomum cassia	intention tremor	0
paella	alopecia cicatrisata	0
carya illinoenses	ulcer	0
extracted fruit	adenoviridae	0
rosemary	ovary neoplasm	0
california avocado	muscular spasm	0
blueberry plant	chronic fatigue syndromes	0
white mallows	gastroesophageal reflux	0
new york coalition for healthy school food	retained surgical instrument	0
jalapeno peppers	gastroesophageal reflux	0
sugar maple	ph1 negative myelogenous leukemia	0
lavender	salami brusher's disease	0
dietary plant proteins	neuritic plaques	0
carrot	arrhythmia	0
skim milk	complete hearing loss	0
oryza sativa	mink encephalopathy virus	0
trace mineral	well differentiated lymphocytic lymphoma	0
papaya	well-differentiated lymphocytic lymphomas	0
dressing	ph1 negative myeloid leukemia	0
nitrate-rich vegetables	seizure disorder	0
food allergy	ketosis-prone diabetes mellitus	0
tachigalia	fifth phacomatosis	0
cuminum cyminums	auricular fibrillations	0
willow tree	auricular fibrillations	0
dangerous plants	deep venous thrombosis	0
sweet marjoram	intractable headaches	0
cinnamomum trees	temporary amnesias	0
morel	bladder neoplasm	0
navy beans	diarrhea	0
cinnamomum verum	sprue	0
narrow-leaved plantains	numbness	0
healthy fruit	virus disease	0
rosa	hereditary galactokinase deficiencies	0
golden delicious	early detection of cancer	0
earl grey tea	pregnancy pernicious vomiting	0
red delicious	peripheral arterial disease	0
myristica fragran	posterior compartment low back pain	0
gluten-free diet	sudden-onset diabetes mellitus	0
healthiest beverage	cognitive retention disorders	0
chamomile oils	myocardial infarction	0
soy bean curds	prediabetic states	0
baby formulas	chronic obstructive lung disease	0
incorporates cloves	foreign object	0
juglan	cerebrovascular accidents	0
individual food	anal fissure	0
cannabis sativa	hiatal hernias	0
apricot	small cell lymphoma	0
sugar substitute	uveitis	0
collard green	orf	0
tangerine trees	ketosis prone diabetes mellitus	0
breast milks	exanthem	0
infects apples	megacolon	0
jell-o	muscle cramps	0
uncooked food	acute monoblastic leukemia	0
andira	scorbutus	0
rowanberry	dissociative amnesia	0
bergamot	heart failure	0
margarine	joint pain	0
rubus idaeus	familial dementia	0
curcuma zedoaria	pyrose	0
vegetable protein	benign intracranial hypertension	0
peppermint oil	muscle tremor	0
soy proteins	basal cell epithelioma	0
caryophyllus aromaticus	hot flashes	0
oregano plant	emesis	0
citron trees	joint pain	0
sweetener	ovarian neoplasm	0
pepper	aids virus	0
bamboo shoots	orthostatic headaches	0
olea europaea	lymphocytic lymphoma	0
oyster mushrooms	colon neoplasm	0
grecian foxgloves	low backache	0
rubus	familial creutzfeldt-jakob diseases	0
antioxidant fruits	sudden-onset diabetes mellitus	0
ready soybeans	eye diseases	0
vaccinium angustifolium	renal calculi	0
filbert	convulsive syncope	0
salami	elevated cholesterol	0
golden raisins	diabetic complications	0
illicium anisatum	dental fluorosis	0
kawa kawa	drug allergies	0
opium poppies	parkinsonism dementia complex of guam amyotrophic lateral sclerosis	0
shiitake	bacteria-eating virus	0
buckwheat	cerebral convexity meningiomas	0
dietary fibers	constrictive bronchiolitis	0
mangosteen	cancer of vagina	0
milk proteins	iodine deficiency	0
norus	gall bladder diseases	0
big meals	perforated appendicitis	0
taro	vulvar neoplasm	0
cannabis	diffuse small cleaved cell lymphoma	0
carya	gale deficiency	0
thymus	common cancers	0
alpine strawberry	macular dystrophies	0
althaea	vaginal discharge	0
butternut squash	kidney neoplasms	0
prettiest fruit	primary brain neoplasm	0
olive tree	classic galactosemia	0
study lavender	male impotence	0
atropa belladonna	acquired immuno deficiency syndrome	0
emblica officinali	endocrine breast diseases	0
include flaxseed	small round-structured viruses	0
burrito	prostate disease	0
lemon grasses	limb tremor	0
almond oil	polyradiculoneuropathy	0
cultivated oat	early onset parkinson disease autosomal recessive	0
kiwi	metastasis	0
bean sprouts	occipital traumas	0
eating broccoli	sexual dysfunction	0
euterpe precatoria	eye diseases	0
syzygium sandwicense	diabetic neuropathies	0
thyme	kidney calculus	0
morning meal	kidney calculi	0
norovirus food	udp-galactose-4-epimerase deficiency diseases	0
artificial sweetener	semirhythmic tremors	0
prunus amygdalus	genital wart	0
vitamin pills	prion-associated disorders	0
english plantains	child obesity	0
red onions	insulin-dependent diabetes mellitus 1	0
different fruits	vagina neoplasms	0
antioxidant vitamin	sleep-related neurogenic tachypnea	0
da huang	cancer of the rectum	0
dairy product	inhibit cancer	0
chenopodium quinoas	diverticulitis	0
brassica nigra	pancreas neoplasm	0
rye bread	esophageal hernia	0
petroselinum	juvenile-onset diabetes mellitus	0
bilberry	breast pains	0
mandarin orange trees	subacute spongiform encephalopathy	0
elettaria cardamomums	colorectal cancer	0
black walnut	urinary bladder cancer	0
dairy yogurt	light-headedness	0
almond	fever	0
legume pods	semirhythmic tremor	0
cayenne	xanthomatous meningiomas	0
swordfish	cancer-causing viruses	0
baker's yeast	galactose-1-phosphate uridyltransferase deficiency	0
avoid peanuts	hepatic neoplasms	0
peach	hepatic neoplasms	0
lunchtime	fibromyalgia	0
juglans nigra	non-hodgkin's lymphoma	0
beef	fibroatheromatous plaque	0
kava kava	guillain-barre syndrome	0
molasses	alzheimer’s disease	0
sesame oils	hiatal hernias	0
contamination meat	mink encephalopathy virus	0
vitis vinifera	pustulosis of palms and soles	0
euterpe	schizoaffective disorders	0
edible grain	ciguatera poisoning	0
sockeye salmon	frontal region trauma	0
jasmine tea	mixed small and large cell lymphoma	0
artificial butter	postural low back pain	0
kaffir lime	b12 deficiency	0
soda waters	spondyloarthritis ankylopoietica	0
potato chips	hemangioblastic meningiomas	0
morinda citrifolias	vulva cancer	0
grapefruit	lyme disease	0
abelmoschus	kill cancer	0
baking chocolate	pancreatitis	0
pyrus	hirsutism	0
citrus grandi	air sickness	0
mustard plants	microglandular adenoses	0
porgy	lymphosarcoma	0
tulsi tea	chronic obstructive airway disease	0
crataegus	bladder disease	0
little meat	non-hodgkins lymphoma	0
color	rupture	0
acer saccharum	physical anhedonias	0
chickpea	burkitt lymphoma virus	0
nut bars	undifferentiated carcinoma	0
iceberg lettuce	small round structured viruses	0
açaí berries	kanner syndrome	0
cardamom	kahler disease	0
beverage	viral hepatitis	0
elephant garlic	amyotrophic lateral sclerosis parkinsonism dementia complex 1	0
brassica napus	kanner's syndrome	0
consumer protection scientific committee on food	sleep related neurogenic tachypnea	0
health nuts	degenerative neurologic disorders	0
zea mays	peanut allergy	0
taraxacum officinale	ekbom psychogenic parasitoses	0
guacamole	continuous tremors	0
added nuts	parkinson's disease	0
stevia rebaudiana	generalized seizure	0
carya illinoensis	cattle leukemia virus	0
shorten	dissociative amnesias	0
triticum vulgare	intermediate-grade lymphoma	0
cymbopogon nardus	intracranial central nervous system disorders	0
white rice	breast pain	0
solanum dulcamaras	diabetic mononeuropathy	0
offal	grave’s disease	0
cuminum cyminum	malignant primary brain neoplasms	0
healthiest fruits	transmissible spongiform encephalopathies	0
component spices	periodontal disease	0
saint johns wort	fibroid tumor	0
nonus	autoimmune disease	0
find pork	non hodgkin's lymphoma	0
pasta	infarction	0
vegetable juices	plasma cell myelomas	0
pimenta officinali	virus infection	0
citrus x paradisi	prostate disease	0
pomegranate fruit	uterine fibroids	0
suggesting fruit	dissociative amnesias	0
phaseolus acutifolius	diabetic neuropathies	0
foodstuff	angiomatous meningioma	0
herbal teas	foodborne illnesses	0
phyllanthus emblica	visual seizures	0
petroselinum crispums	female infertility	0
healthiest apple	vulva neoplasms	0
healthy snacks	polyarthralgia	0
chamomile	temporal region traumas	0
copaifera	birth weight	0
punicaceae	gastroenteritis	0
carica	cognitive impairments	0
anacardium occidentale	high-grade lymphoma	0
english walnuts	drug addiction	0
pistacia lentiscus	grippe	0
foeniculum vulgares	charcot disease	0
energy drink	guillaine barre syndrome	0
squid	diverticula	0
soybean proteins	infection	0
wild bananas	crohns disease	0
white tea	galt deficiencies	0
poultry	ciliary body spasms	0
corn oils	early infantile autism	0
include fennel	cot death	0
hashish	extreme hearing loss	0
octopus	postviral fatigue syndrome	0
roundup-ready soybeans	udpglucose 4-epimerase deficiency disease	0
deli meats	galk deficiency	0
lemon balm tea	psychotic disorders	0
fragaria	brain neoplasms	0
sugar substitutes	fibromyalgia-fibromyositis syndrome	0
healthier foods	atheroma	0
chilli peppers	t viruses	0
poultry products	vitamin deficiencies	0
morinda citrifolia	auricular fibrillation	0
isoglucose	somatosensory seizures	0
daily fruit	preventable cancers	0
narrow leaved plantain	renal failures	0
papaver	thrombus	0
glucose fructose syrup	retained surgical instruments	0
cocos nucifera	seizure disorders	0
sea bilberries	anxiety disorders	0
marijuana	pancreas neoplasm	0
eragrostis	tremor	0
alfalfa sprout	cardiovascular stroke	0
macadamia nuts	effort syncope	0
cider vinegar	parkinsonism dementia complex of guam amyotrophic lateral sclerosis	0
acer	penile cancer	0
fabaceae	superficial head injuries	0
tumeric	pediatric obesity	0
black beans	intraventricular meningioma	0
nut bar	cognitive decline	0
chinese cassia	perioral tremors	0
stem vegetables	udp-galactose-4-epimerase deficiency diseases	0
hickory nuts	gallbladder diseases	0
fatty foods	postviral fatigue syndromes	0
fagopyrum sagittatum	norwalk-like viruses	0
hemp plant	short sleeper syndrome	0
wheat	parkinsonian diseases	0
avena sativa	galk deficiency	0
cortland	polymyositis	0
tangerine tree	insulin-dependent diabetes mellitus	0
garcinia mangostana	intestinal disease	0
exotic fruit	sliding esophageal hernia	0
daily nut	parodontose	0
syzygium jambos	menstrual pains	0
fruit juice	vulvar neoplasm	0
cider	retained surgical needle	0
carbonated drinks	amnesia	0
oatmeal	cancer of the testis	0
peanut butter	sclerosis	0
black walnuts	cancer of the liver	0
walnut	burkitt's lymphoma virus	0
flesh foods	ciguatera fish poisoning	0
citrus fruit	somatotropin (acromegaly) hypersecretion syndrome	0
thymus plant	norwalk like viruses	0
salmonella-infected eggs	atherosclerose	0
fresh meat	hemolytic jaundice	0
soda pop	burkitt herpesvirus	0
pistachio nut tree	felv	0
wheatgrass	postoperative nausea and vomiting	0
liquor	hormonal dysfunction	0
broth	ekbom delusory parasitosis	0
snack	effort syncopes	0
coco	zoonotic diseases	0
bitter orange trees	low backache	0
fenugreek seeds	retinitis	0
mustard seeds	tick bite	0
persea	female subfertility	0
rooibos tea	human papillomavirus viruses hpv	0
wild yam	regional ileitides	0
zedoary zedoaria	ankylosing spondylarthritides	0
chinese cinnamons	primary brain tumors	0
saffron crocus	subacute spongiform encephalopathy	0
vaccinium bracteatums	tactile amnesia	0
ranking foods	colic	0
celery	oral disease	0
seltzer water	low back aches	0
apium graveolens	lung inflammation	0
white wine	insomnia disorders	0
canned fruit	rest tremor	0
legume pod	autosomal recesssive juvenile parkinsonism	0
linum usitatissimum	sarcopenia	0
gui zhi	acute autoimmune neuropathies	0
high-fiber food	pancreas cancer	0
leguminosae	food borne illnesses	0
brain-invasive pork	bovine spongiform encephalitis	0
safflower oils	neurotic anxiety states	0
food additive	intraepithelial prostatic neoplasia	0
drink tea	cancer of liver	0
cinnamomum aromaticum	degenerative intervertebral discs	0
raw garlic	juvenile onset diabetes	0
decaf	senile paranoid dementia	0
cream cheese	renal insufficiencies	0
black tea	vaginal neoplasm	0
betel nut	aortic aneurysm	0
rice	vulvar cancer	0
beetroot	porcine endogenous retroviruses	0
confection	paralysis agitans	0
ficus	deep venous thrombosis	0
goji berry	neoplasm metastasis	0
tv dinners	human papilloma virus	0
dietary protein	hypesthesia	0
nutritional yeast	nausea	0
soy cheese	cancer of vagina	0
high-fructose maize syrup	marie struempell disease	0
plantago ovata	senile osteoporosis	0
kidney beans	single seizures	0
japanese plums	muscle cramps	0
not-necessarily-so-healthy foods	ductal carcinoma	0
regular olive	endometrial neoplasms	0
mashed potatoes	cancer of the endometrium	0
coconut milk	autosomal recessive familial parkinson disease	0
fagopyrum tataricum	different cancer	0
sun-dried raisin	v cjd (variant creutzfeldt jakob disease)	0
ready-prepared foods	brain malignant neoplasms	0
guibourtia	creutzfeldt-jakob disease	0
holy basil	cramp	0
delonix	bechterews disease	0
fried foods	diabetic neuralgia	0
sesamum	testicular neoplasms	0
cooking meat	gall bladder disease	0
sugary foods	auricular fibrillations	0
soy cheeses	periorbital headaches	0
chocolate	experimental parkinsonisms	0
radicchio	postoperative nausea	0
chocolate bars	psoriasis	0
dietary supplements	neuralgic migraine	0
high-fat meal	peanut allergies	0
poenumgraecum	tremor	0
flammulina	autosomal recesssive juvenile parkinsonism	0
solanum melongena	gorlin goltz syndrome	0
prunus armeniaca	migraine variant	0
pistacia vera	sleep initiation and maintenance disorders	0
saffron	acute strokes	0
french bean plants	birth defect	0
unfertilized eggs	cancer of breast	1
lamb chops	sprue	0
experience food	water-borne hepatitis	0
anacardium occidentales	blood cancer	0
narrow-leaved plantain	bipolar disorders	0
caper	prostatic adenoma	0
texturized soy protein	non-alcoholic fatty liver disease	0
orange	thyroid cancer	0
assai palm	gastric neoplasm	0
dried plums	autosomal recessive parkinsonism	0
chinese food	mild cognitive impairment	0
deep-fried foods	female sub-fertility	0
vaccinium macrocarpon	uterine cervical cancer	0
thymus vulgaris	cardiovascular stroke	0
vital nutrients	irritable bowel syndromes	0
toxic plant	corpse	0
fennel seeds	low back ache	0
chinook salmon	degenerative neurologic diseases	0
biometal	indigestion	0
low-fat diet	chronic lymphoblastic leukemias	0
exotic fruits	congestive heart failure	0
myristica fragrans	hysterical amnesias	0
turmeric	migraine headaches	0
prunus persica	endometrioma	0
vaccinium corymbosum	gnathostoma infections	0
jambolan plum trees	diverticulitis	0
chamomile oil	manic state	0
chlorella	diffuse undifferentiated lymphoma	0
cocoa plants	non-alcoholic fatty liver disease	0
phaseolus vulgaris	atrioventricular dissociations	0
placenta	infectious mononucleosis viruses	0
curcuma longas	diabetes related complications	0
cassia fistula	pancreatic cancers	0
shellfish	lichen ruber planus	0
gravy	colon disease	0
little saffron	insomnia disorders	0
tea hibiscus	fatty liver	0
multivitamin	pulmonary thromboembolisms	0
noncaloric sweetener	reticuloendotheliosis virus	0
chocolate pudding	infant botulism	0
nettle	lyssa	0
bad foods	retained surgical tool	0
marjoram plant	b12 deficiency	0
four nuts	wheat hypersensitivity	0
cassia	intermediate-grade lymphoma	0
drinking orange	food-borne illnesses	0
drink	gerd	0
supper	burkitts lymphoma virus	0
milk thistles	parietal region traumas	0
rhubarb	hip fractures	0
ground beef	manic disorders	0
canned food	intestinal diseases	0
rose berries	rachitide	0
lycium barbarum	galactose-1-phosphate uridyltransferase deficiency	0
tisane	water stress	0
avocado	lung diseases	0
bitter nightshades	intervertebral disk degeneration	0
grape seeds	gerd	0
roselle	degenerative neurologic disorder	0
citrus paradisi	familial parkinson disease	0
ephedras	endotoxemia	0
mackerel	painful menstruation	0
cold-steeping tea	infantile autism	0
lens culinari	urinary bladder disease	0
poppy seed	schizophrenia	0
real chocolate	heartburn	0
citrus aurantiifolia	virus disease	0
iv vitamin	congenital defect	0
toronja	sliding esophageal hernia	0
faba bean	auriculo-ventricular dissociations	0
kiwi fruits	anxiety disorders	0
shiitake mushroom	brains cancer	0
zea	pancreatic cancers	0
cappari	short sleeper syndrome	0
seed	pseudopelade	0
olive oils	fifth phacomatosis	0
celebration meal	mixed-cell lymphoma	0
curry	primary brain tumors	0
marsh mallow	hypercapnia	0
arecas	aortic aneurysms	0
antioxidant-rich food	dental fluoroses	0
apple tree	early-onset parkinsonism	0
hawthorn	autosomal dominant. juvenile parkinson disease	0
swiss chard	left-sided heart failure	0
food colors	generalized headaches	0
potable water	bone neoplasm	0
dietary sugars	visual seizure	0
triticum turgidum	ileocolitis	0
abelmoschus esculentus	heart failure	0
philadelphia cream cheese	severe mental disorders	0
allium sativum	food-borne diseases	0
recommend tea	cranial pains	0
tempeh	neurodegenerative disorders	0
snack foods	irritable colon	0
neutraceutical	arthritis	0
basil	rabies virus	0
nutriceutical	intraorbital meningioma	0
arachis hypogaea	sarcopenia	0
dietary sucrose	gehrigs disease	0
contaminated meat	male pattern baldness	0
proteus mirabilis	prostatic neoplasm	0
so-called meat	rectum cancer	0
junk food	seasickness	0
pimenta diocias	peripheral artery disease	0
topical ginger	influenza	0
apricot tree	small non-cleaved-cell lymphoma	0
cocktail	memory losses	0
red cabbage	mania	0
frequent meals	familial dementia	0
kawa	carcinomatose	0
seville orange trees	diabetic polyneuropathy	0
psidium	human papillomavirus viruses	0
plantago seed	lactose malabsorption	0
banana plant	headache	0
lemon balms	colonic cancers	0
green teas	gall bladder disease	0
added sweeteners	colorectal carcinoma	0
decaffeinated tea	meningioma	0
solanum tuberosums	acute inflammatory polyneuropathy	0
eating nuts	mild neurocognitive disorder	0
flowering shrub	spondylitis ankylopoietica	0
cantaloupe	male impotence	0
fatty meal	drug dependence	0
lemon trees	impaired sensations	0
frozen spinach	primary brain tumor	0
dinner	undifferentiated lymphomas	0
dried food	phage	0
yerba mate	toxic megacolon	0
malus	paratuberculose	0
entree	central obesity	0
saint johnswort	adolescent gynecomastia	0
seltzer waters	endometrial cancer	0
food pyramid	brain diseases	0
indian laburnums	utp hexose-1-phosphate uridylyltransferase deficiency	0
big apples	fibromyalgia-fibromyositis syndromes	0
eating food	palmoplantaris pustulosis	0
ground flax	sudden infant death	0
pimenta diocia	inflammation	0
lemongrass	tonic seizures	0
bread mold	lung cancers	0
ginger	bse (bovine spongiform encephalopathy)	0
tea leaves	allergic reaction	0
allspice	cancer of kidney	0
bran flakes	wheat hypersensitivity	0
areca catechus	gastroenteritis	0
dried apples	marek's disease virus	0
althaea officinalis	catarrh	0
eat chocolate	ocular headache	0
origanum vulgare	e b virus	0
solanum melongenas	chronic lymphoblastic leukemia	0
fruit and vegetable juices	age-related bone losses	0
whole grain	galk deficiencies	0
ganja	acquired immune deficiency syndrome virus	0
psidium guajavas	relapse	0
scallion	migraine disorder	0
horse beans	pulmonary disease	0
orange juice	gustatory seizures	0
gooseberry	periadenitis mucosa necrotica recurrens	0
dragon fruit	osteoarthrosis deformans	0
green lentils	cacosmia	0
lard	pregnancy induced diabetes	0
chard	impaired sensation	0
açaí berry	chronic infectious mononucleosis like syndrome	0
lentil	cancer of thyroid	0
bibhitaki fruit	brains cancer	0
low-salt diet	secondary insomnia	0
acai berry	bechterew disease	0
lentinus edodes	hepatic failure	0
persimmon	bipolar disorders	0
kava	lightheadedness	0
bagel	gall stone	0
fresh ginger	acute stroke	0
candy bars	auto-immune diseases	0
anise seed	ekbom dermatozoic delusions	0
okra	early infantile autism	0
sea food	fatty liver	0
osmanthus tea	hypercapnia	0
mustard	norwalk-like viruses	0
cabbage	lyme arthritis	0
actual fruit	muscular cramp	0
solanum laciniatum	sleep disorders	0
tuna fish	lou gehrig disease	0
phytonutrient-rich food	ovary neoplasm	0
powdered sugar	tonsil neoplasms	0
anticancer plant	sliding hiatal hernia	0
edible grains	fibroid	0
flax seeds	spinal meningiomas	0
black raspberries	inflammation	0
egg	heart block	0
solanum tuberosum	jakob creutzfeldt syndrome	0
cooking oil	epileptic seizures	0
cocoa plant	familial creutzfeldt jakob disease	0
eugenia jambos	benign meningiomas	0
intoxicant	essential tremor	0
dripping	uterine fibroids	0
illicium	dementia with amyotrophic lateral sclerosis	0
carbonated beverages	todd's paralysis	1
tomato	kidney insufficiencies	0
new vitamin	bruise	0
diospyro	lou gehrig's disease	0
cicer arietinums	generalized headache	0
reindeer meat	bovine leukemias	0
texturized soy proteins	undifferentiated carcinoma	0
roughage	paratuberculose	0
deli meat	postural low back pain	0
eugenia sandwicensis	flatulence	0
cymbopogon	grippe	0
almond trees	colon cancers	0
smoked food	mixed lymphocytic-histiocytic lymphoma	0
phaseolus vulgari	epithelioid sarcoma	0
brew	galactose 1 phosphate uridylyltransferase deficiency	0
food manufacturers	amyloidose	0
drug administration united states food	fibrocystic mastopathy	0
mirobalanus embilicas	heart blocks	0
candy	thyroid carcinoma	0
amla	visual seizure	0
jelly	hydrophobia	0
fenugreek	polyphagia	0
sweet almond	widespread chronic pains	0
scrambled eggs	myelomatose	0
solanum	effort syncopes	0
eating meat	craniocerebral trauma	0
rye	esophageal neoplasm	0
last meal	cryptogenic epilepsy	0
carbonated water	chronic illness	0
origanum onites	bovine lymphomas	0
plant kingdom	degenerative neurologic diseases	0
radish	generalized headaches	0
whole grain cereals	ekbom dermatozoic delusions	0
fuji apples	early detection of cancer	0
cod	encephalon disease	0
soft drink	insulin sensitivity	0
petroselinum crispum	condylomata acuminata	0
calendula	jakob-creutzfeldt disease	0
acid-binding vegetables	orthostatic headache	0
yeast rice	autoimmune condition	0
maple syrup	idiopathic polymyositis	0
fagopyrum	tussive syncope	0
origanum majorana	rhabdomyolys	0
cannabis sativas	growth hormone receptor deficiency	0
romaine	foodborne botulism	0
maguey	non hodgkins lymphoma	0
carrot juice	pulmonary embolisms	0
pimenta officinalis	female sub fertility	0
meal	parietal region traumas	0
billion eggs	perioral tremor	0
sauerkraut	human t cell leukemia virus type iii	0
plum trees	cognitive dysfunctions	0
common olive trees	amyloid plaques	0
conventional food	cancer of the pancreas	0
sweet basil	malignant epithelial neoplasm	0
ocimum basilicums	drug abuse	0
laciniate nightshade	throat cancer	0
pistachio nut trees	psychogenic parasitosis	0
red pepper	autosomal dominant parkinsonism	0
canned foods	pill rolling tremors	0
raw poultry	age-related memory disorder	0
hickory nut	pancreas cancer	0
fagopyrum esculentum	chronic cluster headaches	0
lycopersicon esculentum	non-hodgkins lymphoma	0
honey	cerebrovascular apoplexy	0
apple	cardiovascular strokes	0
cured meats	birth weight	0
mentha	breast malignant neoplasms	0
whole wheat	kidney insufficiency	0
french fries	premenstrual syndromes	0
turkey meat	arrythmia	0
green pepper	influenza	0
animal-based foods	amyloidosis	0
pea families	mixed lymphocytic-histiocytic lymphomas	0
herb	passive tremors	0
linum	sleep wake disorder	0
food poisoning	bruise	0
eugenia malaccensis	bechterews disease	0
cannabi	thyroid diseases	0
organic foods	different cancer	0
green peas	urinary tract infection	0
licorice root	brain neoplasm	0
miso	generalized headaches	0
frying foods	familial creutzfeldt-jakob disease	0
raw meat	gluten-sensitive enteropathy	0
peach trees	hay fever	0
aubergine	communicable disease	0
gluten	insulin resistance	0
hot peppers	esophageal neoplasm	0
eugenia cumini	cancer of ovary	0
pomelo tree	small noncleaved cell lymphoma	0
ale	atherosclerosis	0
sugar	small round-structured viruses	0
musa	uterine cancers	0
dessert	myelomatosis	0
apium graveolens var. rapaceum	insulin-dependent diabetes mellitus	0
mock meats	asthma	0
maize	cardiac arrhythmias	0
syzygium malaccense	breast diseases	0
whiting	acute monoblastic leukemias	0
plantago	myocardial infarction	0
indian laburnum	mouth neoplasm	0
black sapotes	sphenoid wing meningioma	0
alcoholic beverages	psychogenic parasitoses	0
assai palm berry	auto-immune diseases	0
gmo soybeans	ponv	0
wine	classic galactosemias	0
coca	barrett's syndrome	0
humulus lupulus	urticarias	0
soy milk	mottled enamel	0
algarrobo	chronic obstructive airway disease	0
salad	amyotrophic lateral sclerosis parkinsonism dementia complex 1	0
corylus	cardiovascular diseases	0
whole grain cereal	esophageal hernia	0
glycyrrhiza	throbbing headache	0
portulaca oleraceas	paraesophageal hiatal hernia	0
cayenne pepper	gastric acid reflux	0
cinnamomum zeylanicum	vagina neoplasms	0
nightshade	bovine lymphosarcoma	0
hummus	childhood onset obesity	0
sweetening agent	testis cancers	0
vitamin	somatotropin hypersecretion syndromes (acromegaly)	0
cucumis melo	galactosemia 2	0
emphasizes vegetables	sphenoid wing meningiomas	0
aspartame	cancer of the testis	0
coca cola	low grade lymphoma	0
dietary fats	indigestion	0
indian gooseberries	disseminated sclerosis	0
beta vulgaris	growth hormone insensitivity syndrome	0
osmanthus	sleep initiation dysfunctions	0
apium graveolens var. dulce	adenovirus	0
clove	contusion	0
anacardium	cancer of the cervix	0
sticker	neurocysticercose	0
mustard oil	gingivitide	0
acer negundo	primary brain tumor	0
endive	macular dystrophies	0
citrullus	bronchiolitis obliterans	0
linseed	fibroatheroma	0
kava kavas	insulin dependent diabetes mellitus	0
eden foods	low back aches	0
fennel	mental disorders	0
hazelnut	new variant creutzfeldt jakob disease	0
cookie	cancer of the uterus	0
zedoary zedoarias	chest pains	0
food allergies	non alcoholic fatty liver disease	0
citronella	cancer of bone	0
common bean plants	anoxemia	0
garden radish	bechterew's disease	0
hickory tree	right-sided heart failure	0
bt corn	dissociative amnesias	0
wort	infantile colic	0
peanut	hyperemesis gravidarum	0
soy	diabetic mononeuropathy	0
theobroma cacao	leprosy	0
red lentils	periodontal disease	0
food supplement	myeloma-multiple	0
aspalathus linearis	peripheral autoimmune demyelinating disease	0
brewage	recurrent brain tumor	0
clathrotropis	acute fulminating multiple sclerosis	0
include apples	marsh fever	0
teosinte	transitional meningioma	0
chinese rhubarb	pernicious vomiting of pregnancy	0
lavandula	delusory parasitosis	0
eugenia aromatica	retained surgical sponges	0
fake meat	esophagitis	0
lemon grass	carcinoma of endometrium	0
coconut water	rhabdomyolys	0
persea americanas	thinness	0
white mallow	multiple myositides	0
fast foods	bone neoplasms	0
cow's milk	gingivitis	0
legume family	muscle tenderness	0
plant zygotes	chronic pains	0
brussel sprout	vertebrogenic pain syndrome	0
citrus aurantiums	hepatitis	0
specific foods	rheumatoid spondylitis	0
flavoring	colorectal carcinomas	0
texturized vegetable proteins	cadaver	0
guava	fibroatheromatous plaque	0
mother cell	cot deaths	0
macadamia nut	ketosis prone diabetes mellitus	0
own vitamin	allergic reactions	0
bellis	confusional state	0
contaminated foods	ulcer	0
beer	tongue neoplasms	0
turmeric root	bechterew disease	0
sweetened cereal	hyperthermia	0
kangaroo meat	deaf mutism	0
reason food	ovarian cancers	0
pretzel	spindle cell carcinoma	0
no-calorie sweeteners	oral disease	0
sea-food	remittent fever	0
table sugar	palsy	0
citrus hystrices	iddm	0
dioscorea villosa	primary insomnia	0
eupatorium rebaudianums	sclerosis	0
fruit-shaped marshmallows	dna injuries	0
dinner time	darkness tremors	0
pudding	auto-immune disease	0
kiwi fruit	rna tumor virus	0
dioscorea batatas	iodine deficiency	0
justicia	peanut hypersensitivity	0
paprika	fibrose	0
flaked coconut	abdominal cramps	0
plantago arenaria	viral infections	0
syzygium jambolanum	single seizures	0
apple juice	artery disease	0
secale cereale	anoxia	0
fava bean	bowel diseases	0
black sapote	esophageal hernia	0
brassica juncea	cervicitis	0
bread	stokes adams syncope	0
squash seeds	arthrosis	0
pickled foods	growth hormone receptor defect	0
lemon	primary malignant brain tumors	0
emblica officinalis	hepatic cancers	0
bitter nightshade	angioblastic meningioma	0
holy basil tea	prostatic cancers	0
fungus	schizoaffective disorder	0
larder	fibromyositis fibromyalgia syndrome	0
milkshake	groundnut hypersensitivity	0
health food	hemicrania migraine	0
fryer	cirrhosis	0
sea vegetable	milk sugar intolerance	0
ribes nigrum	fissure in ano	0
hibiscus	prelingual deafness	0
betel nuts	diffuse mixed cell lymphoma	0
sesame	weight gains	0
sustenance	gluten enteropathy	0
emphasize plant	degenerative neurologic disorder	0
food company	drunkenness	0
triticum	age related maculopathies	0
pistil	senile paranoid dementia	0
overpriced vitamin	transmissible dementia	0
parsley	fifth phacomatoses	0
mustard plant	prediabetic state	0
high-phytate foods	transient insomnia	0
weed	acquired immunodeficiency syndromes	0
calling eggs	breast cancer	0
millet	ovarian cancers	0
anchovy	muscle pain	0
moose meat	sleep initiation dysfunction	0
blossom	contusion	0
jerusalem artichokes	esophageal neoplasm	0
alcohol	fibroid tumors	0
sweet orange	inappropriate gh secretion syndrome (acromegaly)	0
citron tree	congenital abnormality	0
indian gooseberry	gluten-sensitive enteropathy	0
preserved foods	visceral steatoses	0
assai palms	hemangiopericytic meningiomas	0
squashe	childhood obesity	0
pecan	cerebrovascular strokes	0
whale meat	human t lymphotropic virus type iii	0
including cloves	acute confusional migraine	0
yellow vegetables	landry guillain barre syndrome	0
mentha x piperita	premenstrual syndrome	0
tea	guillain-barré syndrome	0
good soybeans	osteoporosis	0
breakfast times	cancer of uterus	0
raisin bran	testicular cancers	0
common olive tree	plasma-cell myelomas	0
strawberry	well differentiated lymphocytic lymphoma	0
lemon tree	regional enteritis	0
beet	drug abuse	0
chinese yams	tongue cancers	0
sweet basils	nephrolith	0
hordeum vulgare	flatulence	0
aloe vera	hirsutism	0
dioscorea opposita	age-related bone loss	0
french bean plant	osteoarthrosis deformans	0
citrus medica	gingivitide	0
low-calorie diet	cataract	0
yoghurt	variant creutzfeldt jakob disease	0
mastic trees	pustulosis of palms and soles	0
coriandrum	acute inflammatory polyneuropathies	0
fructose corn	dental diseases	0
safflower oil	infant obesity	0
sell meat	atherosclerotic plaques	0
vegetable oil	car sickness	0
rutabaga	bovine leukoses	0
lunch time	undifferentiated carcinomas	0
diospyros digyna	non-hodgkin lymphoma	0
horsebean	food borne illnesses	0
chervil	starvation	0
jalapeno	scurvy	0
plantago psyllium	intermittent tremors	0
infant formula	epithelioid sarcomas	0
ilex paraguariensis	somatotropin (acromegaly) hypersecretion syndromes	0
organic milk	carcinomatose	0
natto	udpglucose 4 epimerase deficiency disease	0
cooked tomatoes	chronic headaches	0
amomum cardamomums	diffuse mixed small and large cell lymphoma	0
zingiber officinales	bilateral sciatica	0
ultra-processed food	constrictive bronchiolitis	0
cicer	acute confusional migraines	0
cola	ankylosing spondylarthritides	0
plant capsules	lymphadenopathy-associated virus	0
corn sugar	cysticercose	0
sausage	primary brain neoplasms	0
rice milk	salmonella infection	0
sprout	protein deficiencies	0
beta vulgari	cancer of the cervix	0
food coloring	cranial pains	0
lettuce	voice box cancer	0
ice creams	hot flashes	0
areca catechu	pancreatitis	0
cereal	pseudocoma	0
healthy snack	als (amyotrophic lateral sclerosis)	0
horse nettles	testicular cancers	0
high fructose corn syrup	migraine disorders	0
collard greens	parkinson's disease	0
plant-based foods	treat cancer	0
boiled broccoli	vulvar neoplasms	0
hemlock	persistent atrial fibrillation	0
greenery	bewilderment	0
tomato juice	small lymphocytic lymphomas	0
pecan trees	sore throat	0
soy beverage	cataract	0
breakfast cereal	fibroid tumor	0
chia seeds	myelogenous leukemia	0
suggesting apple	celiac disease	0
largest meal	nontropical sprue	0
fresh basil	cardiovascular diseases	0
gum acacia	microlissencephaly	0
spicy food	sclerosis	0
brown sugar	retained surgical tools	0
happy meal	cardiac diseases	0
marjoram	dissociative amnesia	0
mealtime	nonalcoholic fatty liver	0
plum tree	degenerative disease	0
organic food	amyotrophic lateral sclerosis motor neuron disease	0
dioscorea polystachya	senile tremors	0
kombucha tea	pancreas neoplasms	0
alfalfa sprouts	cardiogenic syncope	0
pease	human papillomavirus viruses hpv	0
soda water	ruptured appendicitis	0
stuff	intractable headache	0
chili	paludism	0
dried yeast	human influenzas	0
ready-prepared food	cancer of the cervix	0
texturized vegetable protein	amaurose	0
poroporo	cancer of the esophagus	0
pumpkin	intermittent tremors	0
eragrostus	polyradiculoneuropathy	0
grilled meat	proliferative bronchiolitis	0
sour fruit	diabetic neuralgia	0
soy bean	cognitive retention disorders	0
atropa belladonnas	acquired immunodeficiency syndrome	0
blueberry	fibrose	0
dietary supplementations	amentia	0
croaker	a-v dissociation	0
flounder	malignancy	0
roasted almonds	zoonotic diseases	0
candy bar	undifferentiated lymphomas	0
citrus sinenses	cancer of vagina	0
rose hips	multiple myelomas	0
dietary fat	zoonotic infection	0
pumpkin pie	ischemic heart disease	0
sweet almonds	secondary fibromyalgias	0
ceratonia	clonic seizure	0
rooibos	cancer of thyroid	0
toxic plants	burkitt lymphoma virus	0
brown rice	birth defect	0
piper nigrum	heart attacks	0
dark meat	memory disorder	0
areca	excess cancer	0
rubus fruticosus	degenerative intervertebral discs	0
oxen meat	somatotropin hypersecretion syndrome (acromegaly)	0
frozen cranberries	mild neurocognitive disorder	0
hemp	ankylosing spondylarthritis	0
international nut	cow disease	0
lactuca sativa	eczematous dermatitides	0
fragaria vesca	schizoaffective disorders	0
curcuma	limb cramps	0
carbonated drink	diffuse mixed cell lymphoma	0
ocimum basilicum	venous thrombosis	0
cooked meat	avitaminose	0
linum usitatissimums	early onset parkinsonism	0
undercooked meat	chronic fatigue disorder	0
barley	celiac sprue	0
sea vegetables	gorlin syndrome	0
prosopi	hemolytic jaundices	0
assai palm berries	parkinsonian syndromes	0
woodland strawberries	galactose 1 phosphate uridyltransferase deficiency	0
pistacia	hypoxemia	0
pimenta	undifferentiated carcinomas	0
soy bean curd	stokes-adams syncopes	0
poultry meat	experimental parkinsonism	0
sandwich	mild neurocognitive disorder	0
oats	food borne diseases	0
red peppers	kidney calculi	0
wild celeries	limb tremors	0
stryphnodendron	pancreatic neoplasm	0
hamburger	hepatic failure	0
mayo	pulmonary embolism	0
purslane	situational syncope	0
rheum tanguticum	fibromyalgia-fibromyositis syndromes	0
bell peppers	genital wart	0
cocoa	cancer of the prostate	0
nonfat meal	air sickness	0
uncooked foods	milk sugar intolerance	0
pecan tree	reduced sensations	0
dress	auricular fibrillations	0
hot pepper	landry-guillain-barre syndrome	0
herr	verruca	0
ground meat	brain vascular accidents	0
horse bean	nbcc	0
barberry	joint pain	0
popcorn	intestinal disease	0
mirobalanus embilica	virus	0
potato	mammalgia	0
common foxglove	deafness	0
golden delicious apples	light headedness	0
concord grapes	arterial fatty streak	0
box elders	neurodegenerative diseases	0
red meat	ciliary body spasms	0
carbonated waters	fetal iodine deficiency disorder	0
commercial milk	cardiac diseases	0
poisonous plants	pyrose	0
goiaba	degenerative intervertebral discs	0
venison	widespread chronic pain	0
pomegranate	rectum cancer	0
citrus bergamia	htlv-iii	0
alpine strawberries	burkitt herpesvirus	0
plum	tussive syncopes	0
orange trees	ankylosing spondyloarthritides	0
acer saccharums	grippe	0
squash plant	todd paralysis	0
wheat brans	inflammatory disorder	0
cupcake	diffuse lymphoma	0
java plum tree	ovarian cancer	0
eating almonds	preterm births	0
dried fruits	feminization	0
apricot trees	cancer of prostate	0
neu5gc-rich food	prion disease	0
althea officinalis	bilateral headache	0
coconut oil	marie-struempell disease	0
leafy vegetables	ciliary body spasm	0
cinnamon	contagious pustular dermatitis	0
syzygium cumini	motor seizure	0
brussels sprouts	breast carcinoma	0
soy bean proteins	age-related maculopathy	0
euchresta	bovine spongiform encephalopathy	0
vodka	autosomal recessive familial parkinson disease	0
convenience food	chromosome 6-linked autosomal recessive parkinsonism	0
curried tofu	small cleaved cell lymphoma	0
ovary	nonalcoholic fatty liver	0
citrus aurantium	rheumatoid spondylitis	0
sour cream	generalized seizure	0
daucus carota	autoimmune disease	0
msg	dissociative amnesia	0
açai berry	vulvar neoplasm	0
low meat	intracranial central nervous system disorders	0
lens plant	body weights	0
consumed chocolate	static tremor	0
cucumis sativus	fifth phacomatoses	0
liquorice	experimental parkinsonisms	0
indian corn	coronary heart disease	0
sparkling waters	vagina cancers	0
mentha piperita	amyloidosis	0
cucumber	thermal hypesthesia	0
bok choy	philadelphia-negative myeloid leukemias	0
nutrient-dense foods	spindle-cell carcinomas	0
raw alfalfa	cancer of the testis	0
snail meat	memory disorders	0
sesame seeds	postural syncope	0
restructured meat	hypercholesteremia	0
carica papayas	kidney stone	0
pumpkin seeds	visceral obesities	0
poppy seeds	carcinomatosis	0
soy food	rhabdomyolysis	0
asparagus	foodborne disease	0
fenugreek seed	hhv-4	0
amomum cardamomum	situational syncopes	0
illicium anisatums	acute fulminating multiple sclerosis	0
hemp plants	non-b hepatitis enterically-transmitted non-a	0
andropogon nardus	rectal tumor	0
cereal grains	migraine variant	0
bean sprout	primary fibromyalgia	0
areca nuts	human herpesvirus 4	0
breakfast time	hypersensitivity	0
concord grape	dna injuries	0
baby carrots	intracranial neoplasms	0
avocado fruit	mottled enamel	0
coriandrum sativums	amnestic states	0
vaccinium bracteatum	drug allergy	0
meal time	secondary fibromyalgia	0
juglans regia	meningotheliomatous meningioma	0
crabapple	diabetic asymmetric polyneuropathy	0
black teas	muscle sorenesses	0
refined olive	pulmonary inflammation	0
citrus aurantiifolias	guam disease	0
crocus sativus	cancer of lung	0
avena	epithelioid sarcoma	0
artificial sweeteners	cancer of the bladder	0
safflower	oral cancer	0
natural vitamin	brain diseases	0
unrefined plant	et-nanbh	0
oolong	carotid sinus syncopes	0
euterpe oleracea	human herpesvirus 4	0
sugar maples	diabetic asymmetric polyneuropathies	0
chanterelle	bowel diseases	0
lima beans	acute confusional migraine	0
cultivated oats	zoonotic infectious disease	0
flavourer	regional ileitis	0
drinking coffee	spasm	0
worldwide fruit	physical sufferings	0
cauliflower	hypovolemic shock	0
nicotiana	dermatozoic delusion	0
mesquite	regional ileitis	0
almond milk	muscular cramp	0
white bread	bladder neoplasms	0
pie	acute autoimmune neuropathies	0
pineapple	acute monoblastic leukemia	0
citrus sinensis	tubal abortions	0
dried blueberries	drug allergies	0
cocos nuciferas	tonsil neoplasms	0
jelly beans	amyotrophic lateral sclerosis	0
pomegranate seeds	auricular fibrillation	0
sparkling water	dairy product intolerance	0
animal-based vitamin	temporary amnesia	0
cooked meats	congestive heart failure	0
prunus dulcis	cancer of the tonsil	0
vegetarianism	food-borne diseases	0
citrus reticulata	juvenile-onset diabetes mellitus	0
beet greens	severe mental disorders	0
berberi	hemangiopericytic meningioma	0
ready-to-eat meal	galactosemia iii	0
national pork	malignant brain neoplasms	0
cynara scolymus	bacterial vaginitis	0
american meat	common cancer	0
anana	dripped virus	0
goji berries	schizophrenic disorder	0
solanum dulcamara	infant obesity	0
melissa officinali	social anxiety disorder	0
energy drinks	resting tremors	0
cucumis melos	proliferative bronchiolitides	0
white pepper	medical conditions	0
ocimum sanctum	atherosclerose	0
glucose-fructose syrup	auditory seizure	0
crataegus monogynas	rectum cancers	0
crataegus monogyna	left sided heart failure	0
cassia cinnamon	syncopal episode	0
vegetable juice	felv	0
portulaca oleracae	meningiomatosis	0
prunus salicina	stomach cancers	0
mint tea	sleep initiation and maintenance disorders	0
mother cells	gluten enteropathy	0
spice saffron	cardiovascular stroke	0
pepsi	deficiency diseases	0
sunfish	viral disease	0
curry powder	lung disease	0
maize oil	atypical cluster headaches	0
portulaca	endotoxemia	0
rose	tonic clonic seizures	0
mentha spicata	tubal abortion	0
sweetleaf	jaundice	0
leek	paraosmia	0
pea	migraine disorder	0
kavas	paludism	0
trace elements	intervertebral disk degenerations	0
maize oils	gall bladder diseases	0
eggnog	osteoarthritis	0
black currants	head trauma	0
dinnertime	guam disease	0
crocus	spatial memory disorders	0
sunchoke	hepatocellular cancers	0
regular carrots	neurologic degenerative conditions	0
oregano plants	dental fluoroses	0
fermented foods	breast fibrocystic disease	0
lime	gastric acid reflux disease	0
secale	uterine fibroids	0
antioxidant foods	severe mental disorders	0
plant zygote	endometrium carcinomas	0
spinach	diabetic amyotrophy	0
butter	deep-venous thrombosis	0
seafood	sleep initiation dysfunctions	0
triticum durum	vitamin deficiencies	0
dog rose berries	creutzfeldt jakob disease	0
vaccinium myrtillus	rodent ulcers	0
thousand foods	microglandular adenoses	0
chai tea	infectious diseases	0
monitoring food	multiple myositis	0
pizza	sleep initiation and maintenance disorders	0
pinto beans	microglandular adenoses	0
marshmallow	age-related osteoporosis	0
citrus fruits	intraventricular meningioma	0
cannabis indica	heart attacks	0
pithecellobium	alcoholism	0
cured meat	carcinogenese	0
cassia trees	diabetic mononeuropathies	0
garlic	marek's disease virus	0
bean	preventable cancers	0
flavorer	viral hepatitis	0
kohlrabi	inflammation	0
favorite meals	cancer of mouth	0
citrus maxima	kidney diseases	0
convenience foods	acute monocytic leukemias	0
sweet peppers	postoperative nausea	0
dioscorea	malignant lymphoma	0
apple trees	myeloid leukemia	0
broad beans	malignant epithelial neoplasm	0
broccoli raab	lou gehrig's disease	0
salsa	secondary insomnia	0
dried foods	small cleaved-cell lymphoma	0
dietary soybean proteins	nutritional disease	0
horsemeat	arterial dysfunction	0
kombucha teas	alopecia	0
purine-rich plant	uterine cancer	0
fig	heart disease	0
amorpha	dyslipidemia	0
pine nuts	coronary heart diseases	0
soy sauce	craniocerebral trauma	0
vinegar	htlv-iii	0
cuminum	secondary fibromyalgia	0
processed meats	diabetes mellitus complication	0
dog rose	multiple sclerosis	0
anti-inflammatory foods	skin cancers	0
weekly meat	infectious diseases	0
spinacia oleracea	ankylosing spondyloarthritides	0
pleurotus ostreatus	left-sided heart failure	0
banana plants	malignant epithelial tumor	0
antioxidant-rich foods	cancer of the vulva	0
halibut	stomatognathic diseases	0
granny smith	remittent fever	0
citrus medicas	amyotrophic lateral sclerosis with dementia	0
hibiscus cannabinus	muscle cramp	0
almond tree	bronchiolitis obliterans	0
cocoa powder	galactose epimerase deficiency	0
common plant	ekbom delusional parasitoses	0
foeniculum vulgare	common bile duct calculi	0
healthy food	sick headache	0
crave chocolate	granulomatous enteritis	0
breast milk	apneas	0
diospyros digynas	androgenic alopecias	0
japanese plum	animal virus	0
zucchini	insulin resistance	0
black pepper	delusional parasitosis	0
kola nut	cancer-causing viruses	0
rheum officinale	intervertebral disc degenerations	0
baby formula	spinal cord diseases	0
corn	chronic obstructive lung disease	0
black currant	bronchial asthma	0
snacktime	cancer of the bladder	0
actual licorice	age related macular degeneration	0
cycad	epithelial cancer	0
wolfberry	galt deficiencies	0
cruciferous foods	stomach ulcer	0
veal	endometrial cancers	0
quinoa	effort syncope	0
triticum spelta	galactokinase deficiency disease	0
digitalis lanata	paroxysmal atrial fibrillations	0
punica granatums	osteoarthrosis	0
purple rice	cataract	0
whortleberry	autoimmune disease	0
raw food	galactosemia 3	0
milk thistle	sterility	0
stevia rebaudianas	intermediate-grade lymphoma	0
eupatorium rebaudianum	heartburn	0
dried apricots	fibroid	0
flower	breast carcinoma	0
domestic fowl	insulin-dependent diabetes mellitus	0
elettaria	intraepithelial neoplasm	0
green tea	histamine cephalgias	0
sweeten	endometrium carcinoma	0
high fructose maize syrup	ciguatera poisonings	0
belladonna	mad cow disease	0
flammulina velutipes	bacterial vaginitis	0
steamer	migraine disorders	0
poultry product	undifferentiated lymphomas	0
lipomul	udp-galactose-4-epimerase deficiency disease	0
citrus bergamias	diabetic asymmetric polyneuropathy	0
cherry	bipolar disorders	0
ice cream	cancer of the testes	0