
chia seeds	infantile obesity	0
pizza	inflammatory bowel disease	0
kava kava	acute inflammatory demyelinating polyneuropathy	0
skim milk	low back pains	0
psyllium	chronic b-lymphocytic leukemia	0
milk chocolate	common bile duct gall stones	0
chinese rhubarb	protein deficiencies	0
cayenne pepper	manic disorder	0
scrambled eggs	gehrig's disease	0
fatty foods	ramsay hunt paralysis syndrome	0
margarine	biliary calculi	0
morning meal	parkinsonism-dementia complex of guam amyotrophic lateral sclerosis	0
prunus cerasifera	pancreatic neoplasm	0
bagel	tongue cancers	0
ocimum basilicum	eye disease	0
powdered sugar	cognitive retention disorder	0
rye	craniocerebral trauma	0
taking vitamin	aphthous ulcer	0
celery	prelingual deafness	0
grapefruit	atypical diffuse small lymphoid lymphoma	0
sugar	cancer of liver	0
fabaceae	utp hexose-1-phosphate uridylyltransferase deficiency	0
poroporo	microglandular adenosis	0
domestic fowls	uterine fibroma	0
chamomile tea	cholera	0
turnip	action tremor	0
açaí berries	micturition syncopes	0
yoghurt	autosomal dominant juvenile parkinsonism	0
black rice	confusion	0
calendula officinalis	kidney calculi	0
healthy snacks	tubal abortion	0
emblica officinali	memory deficit	0
kidney beans	mastitis	0
mackerel	diffuse small cleaved-cell lymphoma	0
soy beverages	transmissible dementia	0
vaccinium macrocarpon	pulmonary neoplasms	0
coco	plasmodium infections	0
snacktime	lung disease	0
black walnut	somatotropin hypersecretion (acromegaly) syndrome	0
common fruits	liver dysfunction	0
rose hips	drug allergy	0
wheat brans	adenovirus	0
replenish nutrients	lou gehrig's disease	0
incorporate cloves	hyperemesis gravidarum	0
toxic plants	blindness	0
plantago lanceolata	deep venous thrombosis	0
eating food	intraepithelial prostatic neoplasias	0
grape seeds	gastric ulcers	0
chinese cassias	memory deficit	0
ground beef	birth defects	0
caffeinated coffee	metastasis	0
pimiento	degenerative diseases	0
hickory trees	colonic neoplasm	0
wild radish	burkitt herpesvirus	0
topical ginger	igf-1 deficiency	0
largest meal	burn	0
dried fruits	retroviridae	0
cola acuminata	olfaction disorders	0
avena sativa	spiral fractures	0
areca catechu	complete hearing loss	0
marijuana	postural syncope	0
chai tea	cholera	0
rose berries	growth hormone insensitivity syndrome	0
rhubarb	tonic-clonic seizure	0
citrus-based fruits	burkitt herpesvirus	0
hashish	lyme disease	0
treat	small cleaved-cell lymphoma	0
phyllanthus emblica	thyroid cancers	0
tea plant	autosomal dominant juvenile parkinson disease	0
laudable legume	undifferentiated carcinomas	0
caper	chromosome 6-linked autosomal recessive parkinsonism	0
dark chocolate	mad cow diseases	0
vegetable juices	parkinsonian disorders	0
amygdalus communis	tumor	0
quinoa	disrupted in b-cell malignancy	0
bran flakes	pustulosis palmaris et plantaris	0
proteus mirabilis	darkness tremors	0
white pepper	ulcerative colitis	0
chewing fruit	forehead traumas	0
cucumis melos	stomach cancer	0
swiss chard	abdominal migraine	0
horse beans	deafness	0
baptisia	male breast enlargement	0
zinger tea	prion protein disease	0
vegetable proteins	lou gehrig's disease	0
pummelo tree	abdominal cramp	0
mangiferas	complete blindness	0
goji berries	asymmetric diabetic proximal motor neuropathy	0
common olive tree	lower back pains	0
nut bar	peripheral arterial disease	0
poisonous plants	rabies viruses	0
mustard seeds	deficiency diseases	0
rutabaga	breast disease	0
berberis	pus	0
diabetic diet	age-related maculopathy	0
pimenta diocias	hiatus hernias	0
preserved food	human flu	0
warm milk	flatus	0
beta vulgari	ph1 negative myeloid leukemia	0
canned food	age related memory disorders	0
edible grains	atherosclerotic plaque	0
bertholletia excelsa	familial atrial fibrillations	0
pepsi	cancer of ovary	0
plaice	autosomal dominant parkinsonism	0
thymus vulgaris	brain malignant neoplasm	0
avoid peanuts	head pain	0
wisconsin milk	psychosis	0
own vitamin	fibromyalgia	0
thymus plants	charcot disease	0
allium porrum	palmoplantaris pustulosis	0
new vitamin	gorlin syndrome	0
myristica fragran	iritis	0
include fennel	dissociative amnesias	0
dried foods	hiv	0
health nuts	menstrual pains	0
fat milk	short sleep phenotypes	0
whortleberry	forehead traumas	0
marsh mallow	parodontosis	0
mentha	bladder neoplasms	0
horsemeat	gum disease	0
pistachio nut tree	pediatric cancers	0
dietary soybean proteins	brittle diabetes mellitus	0
rose	arthralgia	0
hemp	marsh fever	0
mint tea	legal blindness	0
kidney bean	juvenile-onset diabetes mellitus	0
lemon balm	rickets	0
morinda	female subfertility	0
target vitamin	monocytic leukemia	0
solanum	blood clots	0
plant-based nutrients	visceral steatosis	0
chenopodium quinoas	renal cancer	0
hickory nut	secondary insomnia	0
curcuma zedoarias	semantic memory disorders	0
food and drug administration	ulcer	0
soy foods	autosomal recessive juvenile parkinsonism	0
food pyramid	benign prostatic hypertrophy	0
cannabis indicas	encephalopathy	0
whole grain cereal	menstrual pains	0
fragaria	tonsillar cancer	0
eating eggs	premature births	0
banana plant	peanut allergy	0
wheat bran	renal insufficiency	0
fava bean	udp-galactose-4-epimerase deficiencies	0
daucus carota	necrotizing fasciitides	0
alcoholic beverages	johne's disease	0
portulaca	halitosis	0
illicium anisatum	familial atrial fibrillations	0
curcuma	chronic fatigue syndromes	0
citrus reticulatas	ketosis-prone diabetes mellitus	0
include apples	stokes-adams syncopes	0
chenopodium quinoa	anal fissure	0
processed foods	salmonellosis	0
orange trees	anaplastic carcinoma	0
carbonated drink	diabetic mononeuropathy simplex	0
hibiscus sabdariffa	hypoascorbemia	0
cassia fistulas	cerebrovascular accidents	0
raw broccoli	glaucoma	0
cruciferous foods	continuous tremor	0
rubus idaeus	liver cancer	0
tomato juice	spindle cell sarcoma	0
suggesting fruit	dyschezia	0
soda pop	tonsillar neoplasm	0
assai palm berry	sensory seizure	0
antioxidant foods	bechterew disease	0
kiwi fruits	thyroid disease	0
health food	allergic diseases	0
isoglucose	galactose-1-phosphate uridylyltransferase deficiency	0
healthier meat	substance dependence	0
brown sugar	arterial dysfunction	0
dinner times	deglutitional syncopes	0
pudding	aids viruses	0
trompillo	acute cerebrovascular accident	0
sweet marjoram	feline lymphoma viruses	0
thousand foods	carotid sinus syncopes	0
biometal	metabolic acidosis	0
processed meats	hormonal dysfunction	0
berry	feminization	0
nut	ebv	0
cynara scolymus	lymphocytic lymphomas	0
use sweeteners	thyroid diseases	0
chewing gums	vagina neoplasms	0
syzygium cumini	mania	0
cherry plum tree	fibroatheroma	0
different seed	cancer-causing viruses	0
muffin	lymphadenopathy-associated viruses	0
pepper	dysmenorrhea	0
dietary fiber	diabetes related complications	0
goji berry plants	mouth neoplasm	0
humulus lupulus	atherosclerosis	0
unrefined plant	congenital defects	0
pithecellobium	breast pains	0
pimenta officinali	experimental parkinson diseases	0
fungus	syncopal vertigo	0
chili	parietal region trauma	0
anchovy	bilateral headache	0
restrict food	cattle leukemia virus	0
seven nutrients	bone fracture	0
measuring food	bone neoplasms	0
linum usitatissimums	lymphoma	0
coconut milk	multiple sclerosis	0
cinnamomum verum	penile cancer	0
white wine	periorbital headache	0
acer	osteoarthrosis deformans	0
cheese	malignant meningioma	0
digitalis	long sleeper syndromes	0
olive trees	bipolar affective psychoses	0
citron trees	epithelioma	0
no noni	kidney neoplasms	0
carica papaya	burkitt's lymphoma virus	0
pithecolobium	familial tremor	0
hydroponic basil	galactose-1-phosphate uridylyltransferase deficiency	0
glycyrrhiza	thyroid carcinomas	0
raw garlic	heart block	0
beverage	vagina neoplasm	0
guibourtia	muscular spasms	0
apple juice	jakob creutzfeldt syndrome	0
peanut butter	vaginal neoplasm	0
glycine max	kahler disease	0
jalapeno peppers	multiple myositides	0
real chocolate	weight losses	0
cicer	chronic cluster headaches	0
prunus dulcis	cancer of the esophagus	0
pistacia	bacterial infection	0
fennel seeds	colonic cancer	0
andropogon nardus	early detection of cancer	0
healthiest beverages	single seizure	0
cow's milk	bovine leukemias	0
squid	metastatic cancer	0
crataegus monogyna	gnathostoma infections	0
bitter nightshade	primary malignant brain neoplasms	0
maize oil	pregnancy-induced diabetes	0
maguey	smell disorders	0
red onions	bovine lymphosarcomas	0
turmeric root	pulmonary neoplasms	0
soya milk	gall bladder disease	0
barley	tonic seizure	0
milk thistle	olfactory seizures	0
crab apples	acne	0
citrus maxima	sleep disorder	0
okra	recrudescence	0
organ	post ictal confusion	0
red peppers	jakob creutzfeldt syndrome	0
hemp plant	fibrocystic changes of breast	0
horse nettle	t virus	0
nicotiana	bacterial vaginitis	0
mango	hypolactasia	0
lunchtime	laron syndrome	0
group foods	congenital defects	0
know nuts	creutzfeldt-jakob syndrome	0
betel nuts	human influenzas	0
green teas	acute inflammatory polyneuropathies	0
seafood	canker sore	0
boiled eggs	abdominal cramp	0
eating almonds	polyradiculoneuritis	0
eugenia sandwicensis	esophageal neoplasms	0
chocolate pudding	auto-immune diseases	0
hot peppers	prostate neoplasms	0
soda pops	vulva cancer	0
sushi	splitting pain	0
low vitamin	atrial fibrillations	0
malus	germinoblastoma	0
soy proteins	sudden infant death	0
squash plant	painful diabetic neuropathies	0
usda poultry	diabetic mononeuropathies	0
calling eggs	left-sided heart failure	0
cantaloupe	dairy product intolerance	0
myristica fragrans	viral infections	0
osmanthus tea	fibromyositis fibromyalgia syndrome	0
crocus	chronic b-lymphocytic leukemias	0
cuminum	psychotic disorders	0
arginine-rich foods	manic-depressive psychoses	0
punica granatums	micturition syncope	0
salmonella-infected eggs	histamine cephalgia	0
drinking tea	inappropriate gh secretion syndrome (acromegaly)	0
dinner	orthostasis	0
philadelphia cream cheese	cough	0
flowering shrub	intraorbital meningiomas	0
frozen cranberries	colon disease	0
toxic plant	recurrent low back pain	0
corn sugar	human t-cell leukemia virus type iii	0
healthy snack	sudden-onset diabetes mellitus	0
brassica	visceral steatosis	0
olea	burkitt's lymphoma virus	0
dog rose	diabetic complications	0
rubus	essential tremors	0
carbonated beverages	cardiac failure	0
ananas	male breast cancer	0
contamination meat	myocardial ischemia	0
sugar water	udpglucose hexose 1 phosphate uridylyltransferase deficiency	0
black coffee	gingivitide	0
family vegetables	complete hearing loss	0
indian gooseberries	pancreas cancers	0
orange juice	barretts syndrome	0
sea food	tongue neoplasms	0
purslane	aortic aneurysm	0
artificial butter	gehrig disease	0
carya	status migrainosus	0
betel	uterine cancers	0
wild celeries	brain disorders	0
whole wheat	parkinsonian syndromes	0
peach trees	disorientation	0
sugar-sweetened beverages	hypoxemia	0
musa	ankylosing spondylarthritides	0
leaf lettuce	infectious virus	0
actual licorice	pregnancy-induced diabetes	0
milk	deaf mutism	0
sour cream	complications of diabetes mellitus	0
punicaceae	spondylarthritis ankylopoietica	0
different fruits	sliding esophageal hernia	0
coleslaw	symptom clusters	0
macadamia nut	feline leukemia virus	0
bilberry	chronic b-lymphocytic leukemias	0
squash plants	small non cleaved cell lymphoma	0
soy bean curds	fibrocystic disease of breast	0
pimenta diocia	brain cancer	0
plant kingdom	liver dysfunction	0
granny smith apples	heart disease	0
brown rice	ekbom delusory parasitosis	0
jalapeno pepper	amnestic state	0
decrease meat	acidose	0
willow tree	clonic seizures	0
coca cola	senile plaques	0
green peas	prostate neoplasm	0
rheum tanguticum	familial diffuse gastric cancer	0
açai berries	hiatal hernia	0
avenas	terminal cancer	0
dripping	corpse	0
sunchoke	phage	0
agaricaceae	juvenile-onset diabetes mellitus	0
oregano	limb cramps	0
corn oils	preterm birth	0
butternut squash	muscular spasm	0
chinook salmon	acquired immunologic deficiency syndrome	0
meal	ramsay hunt paralysis syndrome	0
chocolate bars	generalized headache	0
tumeric	communicable diseases	0
pistachio	intervertebral disk degeneration	0
cannabis	disc degenerations	0
ready-prepared food	urinary bladder disease	0
pickled vegetables	blood cancer	0
lemon balms	arthralgia	0
dietary supplementations	benign neoplasms	1
trigonella	viral diseases	0
breakfast time	essential tremor	0
squashe	bewilderment	0
green tea	rabies	0
dietary plant protein	bipolar disorder	0
spaghetti	bacterial infection	0
catfish	colorectal tumor	0
zucchini	somatotropin hypersecretion (acromegaly) syndrome	0
apple tree	fissure in ano	0
shorten	numbness	0
dangerous plants	anhedonia	0
vitis vinifera	female sterility	0
plantago seed	phlebothrombose	0
wine	elevated cholesterols	0
foie gras	retained surgical instruments	0
cacao	oncogenic viruses	0
cod	pancreatitis	0
sparkling waters	parodontose	0
chanterelle	penile cancers	0
healthiest snack	pyrexia	0
poultry products	lung neoplasms	0
black currant	kidney failure	0
american meat	protein deficiency	0
organ meats	autosomal recesssive juvenile parkinsonism	0
alcohol	impotence	0
soy bean proteins	human cancer	0
allspice	rodent ulcers	0
cocoa plant	sinusitis	0
texturized soy proteins	allergic reaction	0
banana plants	pustulosis of palms and soles	0
extracted fruit	guam form amyotrophic lateral sclerosis	0
pyrus	epithelioid sarcomas	0
burrito	lyme arthritis	0
dressing	adenomatous polyps	0
pomegranate seeds	epstein-barr virus	0
clathrotropis	lichen planus	0
grilled meat	growth hormone receptor defect	0
almond milk	gasser syndrome	0
origanum onites	udp-galactose-4-epimerase deficiency	0
prunus armeniaca	arthralgia	0
bread	abdominal pains	0
chamomile oils	colorectal tumors	0
plant embryo	virus diseases	0
antioxidant fruits	prostatic adenomas	0
citrus aurantiifolias	chronic b-cell leukemias	0
acai berry	kanners syndrome	0
dioscorea opposita	primary fibromyalgia	0
high fructose corn syrup	small lymphocytic lymphoma	0
thymus vulgari	feline lymphoma virus	0
goji berry plant	limb cramp	0
fagopyrum esculentum	tumor	0
soy bean	post-ictal confusion	0
food additive	myocardial ischemia	0
avocado	different cancer	0
breakfast times	gale deficiencies	0
frosting	aphthous ulcers	0
sour orange tree	cow disease	0
cookie	birth weight	0
black walnuts	cranial pains	0
gooseberry	guam form amyotrophic lateral sclerosis	0
infant formula	mesothelioma	0
chinese cinnamon	cerebrovascular apoplexy	0
oatmeal	drug habituation	0
beet greens	fibrocystic disease of breast	0
red rice	dysmenorrhea	0
nettle tea	varicose veins	0
raisin	osteoarthritide	0
virgin olive	widespread chronic pains	0
filtered coffee	wheat hypersensitivity	0
ketchup	cardiogenic syncopes	0
white tea	congenital defect	0
trace element	guam form of amyotrophic lateral sclerosis	0
baby carrots	crushing skull injury	0
hop	colorectal carcinoma	0
chestnut	heat stroke	0
mirobalanus embilicas	foreign objects	0
cannabis indica	degenerative neurologic diseases	0
drink tea	laron type dwarfism i	0
egg	galactose epimerase deficiencies	0
ready prepared foods	meningotheliomatous meningioma	0
cooked meats	multiple meningiomas	0
potassium-rich foods	enterocele	0
tangerine tree	arthritis	0
dietary supplements	determination of death	0
citron tree	primary insomnia	0
no meat	respiratory infections	0
artificial sweetener	abdominal cramp	0
coca	deglutitional syncopes	0
chinese yam	polyradiculoneuritis	0
vitamin pills	dermatosis	0
breakfast cereal	torsion fractures	0
soy sauce	deep-venous thromboses	0
bhang	hysterical amnesia	0
processed apples	gastric neoplasm	0
regular olive	eczematous dermatitides	0
poppy	hemangiopericytic meningiomas	0
vaccinium uliginosum	marie struempell disease	0
pureed apples	terminal ileitis	0
moose meat	legal blindness	0
squash	status migrainosus	0
agave	kidney calculi	0
green grapes	thrombus	0
andira	deep vein thromboses	0
pea	colon cancers	0
mangosteen	strains and sprains	0
raw meat	human herpesvirus 4 (gamma)	0
consumed chocolate	acute monocytic leukemia	0
sour orange trees	familial atrial fibrillations	0
monosodium glutamate	testicular tumors	0
vitis	prediabetic states	0
official vitamin	posterior fossa meningiomas	0
blackberry	anhedonia	0
fenugreek	malignant epithelial neoplasm	0
colorful foods	nervous system degenerative diseases	0
foeniculum vulgares	sneezing	0
exotic fruits	ciliary body spasm	0
black sapotes	acute autoimmune neuropathies	0
acer saccharum	intermediate grade lymphoma	0
cooked tomatoes	water borne hepatitis	0
cultivated oat	retained surgical tools	0
blueberry plant	parkinson’s disease	0
triticum spelta	dermatozoic delusion	0
eugenia jambolana	cellulite	0
unfertilized eggs	idiopathic proctocolitis	0
lactuca sativa	primary malignant brain tumors	0
cymbopogon nardus	sarcopenia	0
secale cereale	grippe	0
frequent meals	insulin-dependent diabetes mellitus	0
white rice	brain disorder	0
pea family	miscarriage	0
higher vegetable	eye disease	0
red meat	disc degradations	0
wheat	cerebrovascular accidents	0
zedoary zedoaria	lobar pneumonias	0
snack foods	ciguatera poisoning	0
incorporates cloves	colon disease	0
eragrostis	rectal tumors	0
acai berries	colon cancer	0
lycium barbarum	substance use disorders	0
amla	inflammatory bowel diseases	0
vicia fabas	arthralgia	0
tuna	cow disease	0
mustard oil	involuntary quivers	0
afzelia	progressive disorder	0
brewage	intractable headaches	0
split peas	spatial memory disorders	0
flesh foods	coronary diseases	0
so-called vegetable	deep venous thrombosis	0
anacardium	involuntary quivers	0
sugar maples	fibrocystic breast disease	0
syzygium jambos	utp hexose 1 phosphate uridylyltransferase deficiency	0
vaccinium corymbosum	subacute spongiform encephalopathy	0
fagopyrum sagittatum	physical sufferings	0
tulsi tea	fibroid tumor	0
walnut oil	galactokinase deficiency disease	0
soy milk	occipital traumas	0
national pork	brain neoplasms	0
justicia	parietal region trauma	0
brassica nigra	vaginal cancers	0
eugenia cumini	idiopathic polymyositides	0
almond tree	neurodegenerative diseases	0
uncooked foods	massive tremors	0
syzygium aromaticum	cancer of the skin	0
plant zygote	mental deteriorations	0
turmeric	spinal cord disease	0
swordfish	skin disease	0
white bread	bacterial vaginitis	0
billion eggs	human papillomavirus viruses hpv	0
trigonella foenum-graecum	disc degradations	0
lettuce	light-headedness	0
cicer arietinums	thyroid neoplasm	0
coriander	common cold	0
althaea officinalis	lichen ruber planus	0
candy	bacterial vaginitides	0
retail meat	autosomal recessive parkinsonism	0
prenatal vitamins	social anhedonias	0
sunfish	aphthous ulcer	0
coriandrum sativum	ekbom delusory parasitosis	0
flax seeds	amyloidose	0
chile pepper	human t-cell leukemia virus type iii	0
natto	post traumatic osteoporosis	0
oryza sativa	diarrhea	0
new candy	drug allergies	0
reason food	multiple meningiomas	0
monitoring food	headache disorders	0
salt-free diet	growth hormone receptor deficiency	0
whole foods	painful diabetic neuropathy	0
legume pod	mouth cancers	0
oyster mushroom	leprosy	0
rooibo	degenerative diseases	0
soy food	uveitis	0
animal-based vitamin	infantile obesity	0
norovirus food	mental deteriorations	0
marshmallow	thyroid adenomas	0
eggplant	cjd (creutzfeldt jakob disease)	0
food company	cancer of uterus	0
celery root	lymphatic sarcomas	0
pomegranate fruit	undifferentiated carcinomas	0
salad	non-alcoholic fatty liver disease	0
cymbopogon	joint diseases	0
turkey meat	myelomatose	0
lens culinaris	juvenile onset diabetes mellitus	0
citrus bergamia	chronic pain	0
baked potato	cervix cancer	0
kohlrabi	diarrhea	0
fatty meal	lung inflammations	0
petroselinum crispum	deep venous thromboses	0
hordeum vulgare	mammary cancer	0
coconut	reactive confusion	0
liquorice	chronic disease	0
teff	cancer of the thyroid	0
sugar substitute	auto-immune disease	0
red cabbage	somatosensory seizure	0
flounder	circulatory failure	0
noni fruit	determination of death	0
new york coalition for healthy school food	cancer of the bladder	0
rooibos tea	cellulite	0
peach	vulva neoplasm	0
diabetic diets	cancer of vulva	0
phaseolus vulgaris	b cell leukemia	0
java plum tree	cardiovascular stroke	0
animal food	udp-galactose-4-epimerase deficiencies	0
whole grain cereals	acquired blindness	0
triticum vulgare	granulomatous colitis	0
chinese cinnamons	headache syndromes	0
frier	esophageal neoplasm	0
candy bars	lobar pneumonias	0
kava kavas	bone neoplasms	0
ground ginger	confusional state	0
tisane	vagina cancers	0
eugenia malaccensis	small non cleaved cell lymphoma	0
toronja	disrupted in b-cell malignancy	0
rheum rhaponticum	urinary bladder diseases	0
kombucha teas	galactose-1-phosphate uridyltransferase deficiency	0
fermented cabbage	vitamin deficiency	0
brassica juncea	open head injury	0
norus	persistent tremor	0
ocimum basilicums	type i diabetes mellitus	0
rowanberry	acne vulgaris	0
lard	burkitt's lymphoma virus	0
lemon grass	felv	0
linum	necrotizing fascitis	0
silybum marianums	human herpesvirus 4 (gamma)	0
flax seed	bronchiolitis	0
weekly meat	dizzyness	0
boiled broccoli	vulva neoplasm	0
foxglove	epithelioma	0
juiced broccoli	renal failure	0
shiitake mushroom	kidney cancer	0
fuji apples	anoxia	0
lemon	backache	0
weed	cerebrovascular apoplexy	0
purple potatoes	spatial memory disorders	0
dried yeast	cancer of the lung	0
kiwi	prostatic adenomas	0
safflower oils	pseudocoma	0
caryophyllus	gluten-sensitive enteropathy	0
citrus medicas	ovary neoplasms	0
açai berry	gastro esophageal reflux	0
euterpe precatoria	age-related bone loss	0
cabbage	diffuse well differentiated lymphocytic lymphoma	0
lipomul	headache	0
spinach	senile plaques	0
cleistocalyx	minor head injury	0
vital nutrients	brain malignant neoplasm	0
root	primary growth hormone resistance	0
cashew	sudden cardiac death	0
lamb chops	drug use disorders	0
mentha piperita	familial creutzfeldt jakob disease	0
syrup	weight loss	0
ilex paraguarienses	human t cell lymphotropic virus type iii	0
oxen meat	human herpesvirus 4 (gamma)	0
garlic sauce	skin neoplasms	0
carica papayas	macular degenerations	0
piper nigrum	early diagnosis of cancer	0
english walnut	ruptured appendicitis	0
chervil	esophagus cancers	0
dried peas	degenerative arthritis	0
bean sprout	cancer of brain	0
food supplements	perioral tremor	0
smoked food	type 1 diabetes mellitus	0
barberry	male breast carcinoma	0
elettaria	age-related macular degenerations	0
drinking orange	morning sickness	0
aspalathus linearis	human cancer	0
larder	small lymphocytic lymphoma	0
century plants	amnesia-memory losses	0
taraxacum officinale	bilateral sciatica	0
pinto bean	body weight	0
parsley	lobar pneumonia	0
dried apricots	widespread chronic pain	0
acaí berries	inhibit cancer	0
good soybeans	iritis	0
wild yams	leukovirus	0
pease	primary fibromyalgia	0
marsh mallows	thyroid neoplasm	0
dog rose berries	degenerative diseases	0
pea families	experimental parkinson disease	0
cocoa powders	acute monocytic leukemias	0
fresh ginger	prostatic neoplasm	0
bertholletia	metabolic acidosis	0
marjoram plant	idiopathic proctocolitis	0
mentha x piperita	cancer of the mouth	0
soda water	pruritis	0
taraxacum	generalized headache	0
chewed coca	heart diseases	0
split pea	malignant meningioma	0
tea	breast malignant neoplasm	0
white potatoes	occipital region traumas	0
anise	prostatic intraepithelial neoplasms	0
frozen fruit	diverticulitis	0
almond trees	right sided heart failure	0
bolete	hemorrhoid	0
phaseolus vulgari	ileocolitis	0
common bean plants	birth weight	0
tempeh	gastro-esophageal reflux	0
curried tofu	mastodynia	0
radicchio	infarction	0
nut butters	acute cerebrovascular accidents	0
eden foods	left sided heart failure	0
natural vitamin	e b virus	0
sweet almond	creutzfeldt jakob syndrome	0
pineapple	retro-ocular headaches	0
cucumis sativus	brain malignant neoplasm	0
dandelion	paratuberculose	0
arugula	renal failures	0
stevia	varix	0
high fructose maize syrup	amyloid plaque	0
kola nuts	vulvar cancer	0
miso	lymphatic sarcoma	0
cassia fistula	intracranial neoplasms	0
shellfish	cephalodynia	0
dioscorea	neurodegenerative disorders	0
food supplement	polyp	0
red lentils	migraine	0
eating fruits	vitamin deficiencies	0
brazil nut tree	cancer of the ovary	0
dried pomegranate	bipolar disorder	0
silybum marianum	polyradiculoneuropathy	0
yerba mates	prostatitis	0
eggnog	colon neoplasms	0
vitamin	human t cell lymphotropic virus type iii	0
soybean	bovine leukemia virus	0
origanum vulgare	brief reactive psychosis	0
fresh basil	age-related memory disorder	0
caramel	kanner's syndrome	0
fresh meat	pancreatic cancers	0
convenience food	reducing cancer	0
raphanus raphanistrum	prion diseases	0
ribes nigrum	generalized headache	0
amomum cardamomums	pill rolling tremor	0
orange tree	static tremor	0
blossom	diffuse undifferentiated lymphoma	0
atropa belladonnas	cardiac arrhythmias	0
saint john wort	leukemia virus	0
daily nut	gustatory seizures	0
hot sauce	intraepithelial neoplasms	0
broth	multiple sclerosis	0
mastic trees	abdominal migraine	0
chili peppers	ankylosing spondylarthritis	0
sorrel	kill cancer	0
mustard plant	neuralgic migraines	0
cinnamomum zeylanicum	amentia	0
corylus	phlebothrombosis	0
mayo	joint pains	0
sweeten	insomnia disorder	0
bitter nightshades	testicular cancers	0
beer	somatotropin hypersecretion (acromegaly) syndromes	0
pickled foods	experimental lung inflammation	0
ginger	sore throats	0
phyllanthus emblicas	crushing skull injury	0
soy yogurt	acute monocytic leukemias	0
tomato	malignant epithelial neoplasms	0
olive oils	small and large cleaved-cell lymphoma	0
anti-inflammatory foods	prostatic intraepithelial neoplasms	0
sweetener	meningotheliomatous meningiomas	0
persimmon	uterine cancers	0
almond oil	colitis gravis	0
prunus salicinas	multiple sclerosis	0
salmonella food	chronic pains	0
pecan trees	meningioma	0
prunis communis	diabetes-related complication	0
red delicious apples	cancer of the uterus	0
fries	gall stone	0
milkshake	lymphoplasmacytoid lymphoma	0
deli meats	prostatic cancers	0
sea bilberries	ph1-negative myeloid leukemias	0
ephedra	fibroid tumors	0
ilex paraguariensis	gall stone	0
amaranth	jaundice	0
soup	sleep-related neurogenic tachypneas	0
little saffron	itch	0
trace elements	senile paranoid dementias	0
granny smith	dental fluorosis	0
concord grapes	primary fibromyalgias	0
assai palm	lewy body parkinson's disease	0
inadequate fruit	cervicitis	0
stem vegetables	monocytic leukemia	0
dried apple	acute inflammatory polyneuropathies	0
added nuts	epstein-barr virus	0
table sugar	strains and sprains	0
prunus salicina	chronic b cell leukemia	0
soymilk	peripheral autoimmune demyelinating disease	0
dairy yogurt	age related osteoporosis	0
cuminum cyminums	social anhedonias	0
mandarin orange trees	post-traumatic osteoporosis	0
prettiest fruit	myalgia	0
glycyrrhiza glabra	muscle tremor	0
capsicum annuum	cognitive impairment	0
whiting	tongue cancers	0
citrus hystrices	spinal meningioma	0
arachis hypogaea	scurvy	0
edible grain	colitide	0
oregano plant	abdominal aortic aneurysm	0
chocolate	hypercapnia	0
pimpinella anisum	burkitt's lymphoma virus	0
collard	b cell chronic lymphocytic leukemia	0
phaseolus acutifolius	lou gehrig disease	0
dinner time	cardiac failure	0
amorpha	udpglucose 4 epimerase deficiency disease	0
legume pods	endometrium carcinomas	0
suggesting apple	ebv	0
coriandrum sativums	dyschezia	0
cycad	parkinsonism-dementia complex of guam amyotrophic lateral sclerosis	0
poultry meat	mental disorder	0
pomelo trees	paratuberculose	0
little meat	cacosmia	0
placenta	visceral obesity	0
sparkling water	diabetic complications	0
teosinte	crohns disease	0
delonix	meningotheliomatous meningiomas	0
diospyros digynas	back ache	0
peppermint oil	deep-vein thrombosis	0
unfiltered coffee	muscle pain	0
prunus domestica	jakob creutzfeldt disease	0
true nut	hypoesthesia	0
vinegar	corpse	0
sesame oils	kidney insufficiency	0
purple grape	cancer of the tonsil	0
sweet basils	physical sufferings	0
carrot juice	diabetic mononeuropathy	0
food companies	male sterility	0
flower	torsion fractures	0
food supplementations	tonsillar neoplasms	0
mangifera	penile cancer	0
euterpe	encephalon diseases	0
juglans nigra	pulmonary embolisms	0
neu5gc-rich food	hyperpigmentation	0
cannabis sativas	brain vascular accident	0
cooking meat	epithelioma	0
restructured meat	deep-venous thrombosis	0
cassia trees	heart diseases	0
gravy	epithelioma	0
curcuma zedoaria	chronic fatigue syndrome	0
iv vitamin	venous thromboses	0
shiitake mushrooms	basal cell carcinomas	0
emblica officinalis	diabetic complication	0
cider	prostate neoplasm	0
olive	psychogenic parasitoses	0
glucose-fructose syrup	apnea	0
eugenia aromatica	unilateral headache	0
dried apples	tonic seizure	0
kombucha tea	ocular headaches	0
jerusalem artichokes	cancer of the vagina	0
jambolan plum trees	rebound insomnia	0
seltzer water	spindle cell sarcomas	0
peppermint	apnea	0
baby formula	senile paranoid dementia	0
scallion	mptp-induced experimental parkinsonism	0
cream cheese	texidor twinge	0
hemlock	drug allergies	0
melissa officinali	variant creutzfeldt-jakob disease	0
dasheen	hemolytic-uremic syndrome	0
deli meat	hyperventilation syncopes	0
plant arils	familial atrial fibrillations	0
red delicious	colorectal tumors	0
fennel	newborn gynecomastia	0
leguminosae	reverse cancer	0
cured meats	torsion fracture	0
calendula	malignant epithelial tumors	0
hibiscus	peanut allergy	0
so-called meat	tumor viruses	0
wort	kidney insufficiency	0
pancake	joint diseases	0
taro	throbbing headache	0
saffron	gout	0
cucurbita	cancer of the bone	0
intoxicant	circulatory collapse	0
opium poppy	lactose intolerance	0
bt corn	sore throats	0
açaí berry	fibromyalgia-fibromyositis syndromes	0
pork	norwalk-like viruses	0
citronella	malignant lymphoma	0
amlas	brain disorder	0
stryphnodendron	pleomorphic lymphoma	0
olive oil	diffuse small cleaved-cell lymphoma	0
cocoanut	meningiomatose	0
pisum sativum	salmonella infection	0
cured meat	involutional osteoporosis	0
lemon trees	neoplasm	0
camomile	pancreatitis	0
persea americanas	fibroid	0
pineapple juice	primary parkinsonism	0
century plant	cervix neoplasm	0
shoot	abdominal cramps	0
hibiscus cannabinus	open head injury	0
added sweeteners	meningotheliomatous meningioma	0
chard	infectious disease	0
saint johns wort	migraine disorder	0
processed food	male breast tumor	0
walnut	eczematous dermatitis	0
chinese yams	familial tremors	0
seville orange trees	age-related osteoporosis	0
citrus aurantium	liver steatosis	0
almond	cancer of the rectum	0
lentil	urinary bladder cancer	0
basil	diffuse lymphocytic lymphoma	0
apricot	gall bladder diseases	0
decaffeinated tea	anaplastic carcinomas	0
broccoli	parkinson’s disease	0
fructose corn	periodontal disease	0
foeniculum vulgare	tongue cancers	0
dark meat	foreign bodies	0
aubergine	premenstrual tensions	0
snack food	ankylosing spondylitis	0
hummus	thyroid cancers	0
vegetarianism	atherosclerotic plaques	0
lemon grasses	post-traumatic osteoporoses	0
yeast rice	galactokinase deficiency diseases	0
adhatoda vasica	retained surgical tools	0
eupatorium rebaudianums	early onset parkinsonism	0
density foods	age-related memory disorder	0
cooked meat	venous thromboses	0
brain-invasive pork	coarse tremors	0
aloe	tonsil cancer	0
haritaki fruit	painful diabetic neuropathies	0
gala apples	mixed lymphocytic-histiocytic lymphoma	0
rheum	senile osteoporosis	0
prebiotic	colon cancer	0
cruciferous vegetable	elevated cholesterols	0
flavorer	sick headaches	0
leek	steatohepatitis	0
junk foods	varicose vein	0
red meats	b cell leukemia	0
jalapeno	auriculo ventricular dissociation	0
low-salt diet	myeloma-multiple	0
red tea	muscle pains	0
areca	cll lymphoplasmacytoid lymphomas	0
artificial sweeteners	diffuse lymphomas	0
nut butter	lewy body parkinson disease	0
dietary fibers	psammomatous meningiomas	0
spice turmeric	encephalon diseases	0
venison	infantile colic	0
orange	posterior fossa meningioma	0
ceratonia	radiating pain	0
high-phytate foods	acromegaly	0
thymus	convulsive syncope	0
tarragon	diffuse mixed-cell lymphomas	0
pistacia vera	lyssa	0
flammulina	peripheral demyelinating autoimmune disease	0
drug administration united states food	hemolytic jaundices	0
ready-to-eat meals	benign prostatic hypertrophy	0
glucose fructose syrup	upper respiratory infection	0
spore	bone neoplasms	0
osmanthus	cancer of the vagina	0
woodland strawberry	disc degenerations	0
andean blackberries	coarse tremors	0
cappari	phlebothrombose	0
hypericum perforatum	crohn’s disease	0
mentha spicata	androgenic alopecia	0
raw foods	sudden onset diabetes mellitus	0
dairy eggs	diabetic neuralgias	0
ginger ale	epithelial cancers	0
dietary supplement	heat stroke	0
sour fruit	burkitt herpesvirus	0
acid-binding vegetables	testicular cancer	0
cranberry	breast pain	0
zea mays	galactose epimerase deficiency	0
colocasia	palsy	0
fried foods	lymphadenopathy-associated viruses	0
goji berry	cerebral stroke	0
carbonated mineral water	salmonellosis	0
areca nuts	papillary meningiomas	0
cinnamomum cassia	neuralgic migraine	0
grapefruit juice	uterine fibroma	0
digitalis lanata	carcinogenic retroviruses	0
no coffee	prediabete	0
happy meal	rna tumor viruses	0
specific cheeses	strains and sprains	0
nicotiana tabacums	gastro-oesophageal reflux	0
hawthorn	crohn's enteritis	0
soy beverage	penile neoplasm	0
big food	small non-cleaved-cell lymphomas	0
espresso	oncogenesis	0
serve	norovirus	0
cocoa butter	national cancer	0
hypericum	bacterial vaginitides	0
contaminated meat	pulmonary inflammation	0
euterpe edulis	cognitive impairment	0
common foxgloves	male breast tumor	0
algarrobo	chronic headache	0
japanese plums	deep-venous thrombosis	0
horse bean	generalized seizures	0
copaifera	muscular spasms	0
garbanzo	rabies	0
herb	bladder diseases	0
roasted almonds	insulin-dependent diabetes mellitus	0
cereal grains	deep venous thromboses	0
golden delicious	spongiform encephalopathies	0
petroselinum crispums	prostate cancers	0
ale	reduced sensations	0
syzygium jambolanum	peripheral artery disease	0
prosopis	lymphadenopathy-associated viruses	0
mushroom	monocytic leukemia	0
plant capsules	hereditary galactokinase deficiency	0
white mallows	disc degeneration	0
triticum durum	tumorigenese	0
cycad trees	hyperventilation syncopes	0
porphyra	deficiency diseases	0
soy beans	coronary diseases	0
plantago psyllium	urinary tract infection	0
nori	eye disease	0
sweet pepper	rectum neoplasm	0
pie	charcot disease	0
colophospermum	galactosemia 3s	0
junk food	arthritis	0
lavender	muscle pains	0
vaccinium macrocarpons	variant creutzfeldt-jakob disease	0
foeniculum	small cleaved cell lymphoma	0
cooked carrots	posterior fossa meningiomas	0
maple syrup	lactose malabsorption	0
jell-o	chronic cluster headache	0
machaerium	brain vascular accident	0
gmo soybeans	virus infections	0
mastictree	airsickness	0
spinacia oleracea	intention tremors	0
horse nettles	primary brain tumors	0
collard greens	cancer of the breast	0
erythroxylon	chronic insomnia	0
retail poultry	transmissible dementias	0
white mallow	huntington’s disease	0
paprika	e b virus	0
squash seeds	smell disorders	0
healthy food	acute coryza	0
cocoa powder	retained surgical item	0
honey	male breast cancer	0
english plantains	acute strokes	0
fermented foods	small and large cleaved-cell lymphoma	0
solanum tuberosum	virus disease	0
pinto beans	effort syncope	0
ocimum sanctum	oncogenic virus	0
stevia rebaudianas	subacute spongiform encephalopathy	0
dried cranberries	fibrose	0
eat chocolate	parkinsonian syndromes	0
navy beans	endothelial dysfunction	0
iceberg lettuce	skin cancers	0
feather meal	mild cognitive impairment	0
probiotic	age related macular degeneration	0
rubus glaucus	cancer of ovary	0
honeybush tea	idiopathic intracranial hypertension	0
triticum turgidum	toxico-infectious botulism	0
sweet marjorams	neurocysticercosis	0
apium graveolens var. rapaceum	sudden-onset diabetes mellitus	0
saint john's wort	spinal cord disease	0
nitrate-rich vegetables	foreign objects	0
common plant	angioblastic meningioma	0
pomegranate	precordial catch	0
commercial milk	neurotic anxiety states	0
jasmine tea	atypical cluster headaches	0
oyster mushrooms	chronic diseases	0
lemongrass	skin neoplasm	0
vaccinium virgatum	senile plaques	0
silken tofu	familial dementias	0
liquor	cancer of the penis	0
emphasizes vegetables	retro ocular headache	0
safflower	uterine cervical cancers	0
persea americana	cephalgia syndromes	0
faba bean	bladder neoplasm	0
black beans	spontaneous abortion	0
pleurotus	juvenile onset diabetes	0
lucerne	urinary bladder neoplasms	0
food allergies	cardiac arrhythmia	0
include flaxseed	human flu	0
plant-based foods	spiral fracture	0
eugenia caryophyllata	gassers syndrome	0
oat	canker sore	0
plant aril	childhood onset obesity	0
sausage	aids viruses	0
processed meat	exanthem	0
stevia rebaudiana	anxiety neuroses	0
zingiber officinales	nonalcoholic fatty livers	0
trigonella foenum graecum	pruritis	0
plantago	seizure disorders	0
citrullus	preterm birth	0
atropa belladonna	brain malignant neoplasm	0
healthiest apple	rectal cancer	0
fenugreek seed	mixed-cell lymphomas	0
vaccinium angustifolium	bacteria-eating virus	0
piper methysticums	cjd (creutzfeldt-jakob disease)	0
citrus grandis	neuritic plaques	0
maple	thyroid adenomas	0
thyme	brain neoplasms	0
soy	spondylarthritis ankylopoietica	0
althea officinalis	insulin resistance	0
mesquite	oxygen deficiencies	0
soft drinks	secretory meningioma	0
bad foods	sphenoid wing meningioma	0
coconut oil	non epileptic convulsion	0
clove	disk degradations	0
food poisoning	thermal hypesthesia	0
millet	motor seizure	0
jelly	aortic aneurysm	0
asparagus	constrictive bronchiolitis	0
alpine strawberries	jaundice	0
star anise	rectal neoplasms	0
coffee	charcot disease	0
entree	endometrial carcinoma	0
sweet foods	determination of death	0
sweet orange	confusion	0
salsa	paraesophageal hernias	0
whale meat	neurotic anxiety state	0
calendula officinali	recrudescence	0
chipotle	gasser syndrome	0
fortify milk	small round structured viruses	0
actual fruit	cancer of the skin	0
flavourer	effort syncope	0
roundup-ready soybeans	drug allergy	0
fast foods	senile osteoporosis	0
wild bananas	single seizures	0
citrus fruits	manic-depressive psychoses	0
eupatorium rebaudianum	sick headaches	0
green beans	lung cancer	0
tap water	galt deficiency	0
elettaria cardamomum	early infantile autism	0
individual food	diffuse mixed cell lymphoma	0
hazelnut	sinusitis	0
canned fruit	hysterical amnesia	0
goiaba	experimental parkinson diseases	0
baby spinach	stokes-adams syncopes	0
high-fructose corn	stomach cancer	0
vicia faba	congenital abnormality	0
citrus aurantiifolia	guam form of amyotrophic lateral sclerosis	0
triticum aestivum	develop cancer	0
nutraceutical	reactive confusion	0
big apples	cattle leukemia virus	0
regular carrots	somatotropin (acromegaly) hypersecretion syndrome	0
aspalathus	cryptogenic epilepsies	0
undercooked meat	pus	0
lavandula angustifolia	disc degenerations	0
vegetable juice	variant creutzfeldt jakob disease	0
illicium verum	vulva cancer	0
durum wheat	microcephaly	0
anana	breast tumors	0
antioxidant vitamin	parasagittal meningiomas	0
wild celery	tubal abortions	0
dietary sugars	experimental parkinsonisms	0
greenery	hypolactasia	0
four nuts	amyotrophic lateral sclerosis parkinsonism dementia complex 1	0
fryer	epimerase deficiency galactosemia	0
tree nuts	scorbutus	0
nutritional yeast	vulva cancers	0
brew	visceral steatoses	0
romaine lettuce	abdominal pain	0
brussels sprouts	brain malignant neoplasm	0
last meal	persistent atrial fibrillations	0
cider vinegar	acute monoblastic leukemia	0
molasses	heartburn	0
capparis	terminal ileitis	0
garcinia mangostanas	autosomal recessive juvenile parkinsonism	0
collard green	cancer of colon	0
solanum dulcamaras	cacosmia	0
roselle	ileocolitis	0
national meat	endemic cretinism	0
curry powder	gastric cancer	0
plum tree	cancer of stomach	0
plantago ovata	congenital abnormalities	0
guacamole	obesity in adolescence	0
bertholletia excelsas	cellulite	0
cinnamon	age related maculopathies	0
specific foods	acquired immune deficiency syndrome virus	0
mussel	hydrophobia	0
digitalis purpurea	uterine cervical cancer	0
pistachio nut trees	b cell leukemia	0
brinjal	spiral fracture	0
color	passive tremor	0
vaccinium bracteatums	inappropriate growth hormone secretion syndrome (acromegaly)	0
apium graveolens var. dulce	endocrine breast disease	0
citrus fruit	autosomal recessive juvenile parkinson disease	0
poenumgraecum	ulcerative colitis	0
dragon fruit	transmissible dementia	0
foenumgraecum	small noncleaved-cell lymphoma	0
meal times	fibromyalgia-fibromyositis syndrome	0
plantago indica	vertex headache	0
study lavender	uterine leiomyoma	0
radish	feline lymphoma virus	0
low meat	schizophrenic disorder	0
contaminated foods	et-nanbh	0
cardamom	pancreas neoplasm	0
garlic	diffuse lymphocytic lymphoma	0
safflower oil	cancer of the uterine cervix	0
tv dinners	liver steatosis	0
origanum majorana	torsion fracture	0
dried blueberries	obesity in adolescence	0
carduus marianus	high blood pressure	0
sunflower seeds	galactose 1 phosphate uridyltransferase deficiency	0
yerba mate	germinoblastoma	0
aquatic food	ciliary neuralgias	0
energy drinks	bilateral deafness	0
cranberry sauce	gallbladder diseases	0
infant formulas	diverticulosis	0
humulus	spontaneous abortions	0
chicken	delusory parasitosis	0
pimenta	intervertebral disc degenerations	0
garden radish	well-differentiated lymphocytic lymphomas	0
black sapote	tumorigenese	0
chamomile oil	uterine cervical cancer	0
drinking water	spinal cord disorders	0
red wine	auditory seizure	0
psidium guajavas	atherogenesis	0
canned foods	anoxia	0
mealtime	neurologic degenerative conditions	0
frozen broccoli	kidney calculi	0
drinking coffee	growth hormone receptor defect	0
cinnamomum trees	developed cancer	0
alfalfa sprouts	occipital region trauma	0
ice creams	rna tumor viruses	0
faba beans	prostatic hypertrophy	0
soy bean curd	milk sugar intolerance	0
club sodas	unhealthy conditions	0
rosa	burkitt's lymphoma virus	0
plant embryos	cva (cerebrovascular accident)	0
carbonated waters	autistic disorder	0
grecian foxglove	vertiginous seizures	0
chinese cassia	lobar pneumonias	0
spicy food	brain vascular accidents	0
porgy	degenerative arthritis	0
bacon	hiatal hernias	0
sweetened cereal	royal free disease	0
morning meals	diabetic autonomic neuropathy	0
hordeum	colonic cancer	0
rice milk	bacterial infections	0
abelmoschus esculentus	arthropathy	0
apricot trees	autoimmune diabetes	0
dietary plant proteins	cystic breast disease	0
solanum melongenas	upper respiratory infections	0
green peppers	kidney calculus	0
fenugreek seeds	coarse tremors	0
chamomile	chronic fatigue and immune dysfunction syndrome	0
acacia tree	breast malignant tumors	0
oreo	pseudocoma	0
breast milk	sleep wake disorders	0
black currants	hemolytic jaundices	0
maize oils	motor seizures	0
butter milk	copd	0
bellis	neonatal tremors	0
garcinia mangostana	pediatric cancers	0
longevity legumes	colorectal neoplasms	0
brassica napus	acute monocytic leukemia	0
lens plants	somatosensory seizures	0
tofu	myeloma multiple	0
currant	vulvar cancer	0
monkfish	physical anhedonia	0
pine nuts	benign brain neoplasms	0
decaf	utp hexose 1 phosphate uridylyltransferase deficiency	0
english plantain	leukemia virus	0
secale	dims (disorders of initiating and maintaining sleep)	0
sesame oil	primary insomnia	0
trace mineral	tumorigenese	0
food allergy	angioblastic meningioma	0
fruit and vegetable juices	pulmonary embolisms	0
breast milks	nonalcoholic steatohepatitides	0
japanese plum	liver dysfunctions	0
lavandula	bilateral headaches	0
recommend tea	mastitis	0
brazil nuts	dysosmia	0
allium sativum	guillain-barre syndrome	0
foodstuff	dims (disorders of initiating and maintaining sleep)	0
indian corn	flatulence	0
petroselinum	fibrocystic mastopathy	0
macadamia	darkness tremors	0
belladonna	inappropriate growth hormone secretion syndrome (acromegaly)	0
acer negundo	muscle pain	0
holy basil tea	complete blindness	0
mock meats	bacterial infection	0
citrus grandi	olfactory seizure	0
rheum officinale	cancer of the ovary	0
emphasize plant	small noncleaved-cell lymphoma	0
fig	halitose	0
crataegus	upper respiratory infection	0
snack	hormonal dysfunction	0
cola	gastro-oesophageal reflux	0
saccharomyces cerevisiae	sciatica	0
oryza	acute inflammatory demyelinating polyradiculoneuropathy	0
morel	marie struempell disease	0
cherry	mouth neoplasms	0
da huang	vulva neoplasms	0
alfalfa	kill cancer	0
fruit juice	ileocolitis	0
kangaroo meat	basal cell carcinoma	0
dairy products	reduced sensations	0
mangifera indicas	creutzfeldt jakob syndrome	0
herbal tea	hypoxia	0
rabbit meat	cancer of the testes	0
legume family	canker sores	0
lycium	soft tissue sarcoma	0
black pepper	malignant brain neoplasms	0
food manufacturers	gall stones	0
solanum melongena	epileptic seizure	0
berberi	uterine cervical neoplasms	0
lunch times	cancer of endometrium	0
herbal teas	prostatitis	0
eragrostus	back pain with radiation	0
melissa	rheumatoid spondylitis	0
applesauce	low back aches	0
golden raisins	chronic pains	0
green lentils	atrial fibrillation	0
alcoholic beverage	cervical migraine syndrome	0
beta vulgaris	weight gain	0
watermelon	pseudoaphakia	0
carob	weight reductions	0
mastic tree	bleed	0
spice saffron	weight reductions	0
msg	cancer of mouth	0
raw tomatoes	mottled enamel	0
cilantro	cretinism	0
healthiest nuts	myocardial infarction	0
plant capsule	idiopathic intracranial hypertension	0
shiitake	sleep disorders	0
organic plants	hyperthermia	0
golden glow	cancer of liver	0
diospyro	steatohepatitide	0
wolfberry	cancer of the esophagus	0
healthy foods	back pain with radiation	0
raspberry	ileocolitis	0
crab apple	tonsillar cancer	0
molasse	cancer of the kidney	0
sesame seeds	intermittent tremors	0
carya illinoensis	acute fulminating multiple sclerosis	0
melissa officinalis	influenza in humans	0
kiwi fruit	neurodegenerative disease	0
pecan tree	intervertebral disk degeneration	0
chicken meat	dripped virus	0
frying foods	iritide	0
healthiest fruits	light headedness	0
tea hibiscus	paroxysmal atrial fibrillations	0
lemon balm tea	galk deficiencies	0
sardine	schilling-type myeloid leukemia	0
crataegus monogynas	deep vein thromboses	0
saffron crocus	neurologic degenerative disease	0
syzygium malaccense	water-borne hepatitis	0
prunus persica	global amnesia	0
alfalfa sprout	hip fractures	0
hibiscus tea	prostate disease	0
high-fructose maize syrup	cancer-causing herpesvirus	0
sandwich	chronic illness	0
agent orange	low back aches	0
sweet peppers	cranial pains	0
whipped cream	high cholesterol levels	0
acer saccharums	tumor of rete testis	0
eugenia jambos	myelomatosis	0
citrus medica	memory disorders	0
find pork	a v dissociation	0
plant zygotes	inflammatory bowel disease	0
individual candy	prostatic intraepithelial neoplasm	0
ranking foods	cancer of rectum	0
low-calorie diet	colicky pains	0
ribe	senile osteoporosis	0
hickory nuts	plasma cell myelomas	0
milk proteins	sneezing	0
tea leaves	aphthous ulcer	0
syzygium sandwicense	semantic memory disorder	0
ice cream	gastric ulcer	0
linum usitatissimum	pediatric cancers	0
papaver	perioral tremors	0
antioxidant food	diabetes related complications	0
store licorice	cerebral convexity meningioma	0
kawa kawas	zoonotic infectious diseases	0
aspartame	intention tremors	0
vaccinium myrtillus	male breast tumor	0
soda waters	pancreatitide	0
bean	zoonotic infectious disease	0
purine-rich plant	myelomatose	0
plantago arenaria	amentia	0
artichoke	htlv-iii	0
leafy vegetables	senile osteoporosis	0
cupcake	ciguatera poisonings	0
juglan	hair loss	0
mint	uterine fibroids	0
confection	human flu	0
cannabi	polyradiculoneuritis	0
anti-inflammatory plant	fibrocystic changes of breast	0
cassia tree	gastric acid reflux	0
experience food	sleep wake disorder	0
kaffir lime	penis neoplasms	0
durum wheats	infarction	0
vaccinium bracteatum	neonatal tremors	0
bok choy	intraepithelial neoplasm	0
aloe vera	gastroenteritide	0
cocos nuciferas	mixed lymphocytic histiocytic lymphoma	0
solanum dulcamara	mucous colitides	0
juglans regia	somatotropin hypersecretion syndrome (acromegaly)	0
potable water	lyme disease	0
bibhitaki fruit	cryptogenic epilepsy	0
sugar maple	oncornavirus	0
citrus	postviral fatigue syndromes	0
nonfat meal	galactosemia 2s	0
lens culinari	inflammatory demyelinating polyneuropathy	0
pomelo tree	mouth cancer	0
consumer protection scientific committee on food	v cjd (variant creutzfeldt jakob disease)	0
ground flax	acquired immunodeficiency syndrome	0
seed	non hodgkin lymphoma	0
cortland	monocular blindness	0
fresh fruits	amyotrophic lateral sclerosis parkinsonism dementia complex 1	0
mirobalanus embilica	proteinuria	0
citrus sinensis	insulin deficiency	0
dried plums	dyslipoproteinemia	0
carbonated beverage	oral neoplasms	0
pumpkin	carsickness	0
narrow-leaved plantain	primary growth hormone resistance	0
prosopi	diffuse myofascial pain syndrome	0
crave chocolate	galactosemia iiis	0
flammulina velutipes	cataract	0
food coloring	muscle cramps	0
maize	tonic clonic seizures	0
shan yaos	sea sickness	0
sun-dried raisin	growth hormone insensitivity syndrome	0
irritable bowel kiwi fruit	coma	0
plum trees	lou gehrig's disease	0
specific nuts	gangrene	0
cocoa	tubal abortion	0
malabar-nut	ulcerative colitis type inflammatory bowel disease	0
mandarin orange tree	temporary amnesias	0
cinnamomum aromaticum	aneurysm	0
gluten	subacute spongiform encephalopathy	0
pasta	influenza in humans	0
sugary foods	pancreatic cancers	0
horsenettle	migraine disorders	0
romaine	zoonotic infectious diseases	0
fed beef	myeloma-multiple	0
popcorn	leukemogenic virus	0
assai palm berries	heart attacks	0
sticker	ankylosing spondylitis	0
rice	morning sickness	0
frozen spinach	viral diseases	0
high-fat meal	human papillomavirus viruses	0
veal	gorlin syndrome	0
celeriac	gehrigs disease	0
marihuana	colicky pains	0
banana	plasmodium infections	0
watercress	animal viruses	0
flavoring	plasmodium infection	0
dietary fat	prostatic cancers	0
carica	human influenza	0
psidium guajava	comatose	0
majorana hortensis	atherogenesis	0
oregano plants	gastro oesophageal reflux	0
paella	influenza in humans	0
arecas	prostatic intraepithelial neoplasm	0
curry	a v dissociation	0
zedoary zedoarias	lung inflammations	0
dietary protein	premenstrual tension	0
hypericum perforatums	respiratory tract infections	0
almond butter	limb cramp	0
popular fruits	ductal carcinomas	0
hot pepper	ekbom delusory parasitoses	0
grape juice	jaundice	0
abelmoschus	severe mental disorder	0
human milk	pancreatic cancer	0
ocimum tenuiflorum	vulva cancers	0
pimpinella anisums	brain disorder	0
milk protein	psychogenic parasitoses	0
alpine strawberry	chronic b-cell leukemias	0
favorite meals	vaginal discharge	0
arachis	stokes-adams syncopes	0
grape	obesity	0
beef	venous thromboses	0
poultry product	postural syncopes	0
pumpkin pie	pneumonia	0
stuff	cognitive decline	0
laciniate nightshades	head injury	0
plantain	fibrocystic breast disease	0
sell meat	breast carcinoma	0
illicium anisatums	splitting pain	0
wheatgrass	osteoporose	0
nightshade	parkinsonism-dementia complex of guam amyotrophic lateral sclerosis	0
capsicum	female infertility	0
infects apples	reticulum-cell sarcomas	0
sprout	experimental parkinson diseases	0
food colors	spinal cord disorders	0
healthy fruit	muscle tremors	0
elettaria cardamomums	hemorrhage	0
morinda citrifolia	mild cognitive impairments	0
corn	guam form amyotrophic lateral sclerosis	0
cocoa plants	episodic cluster headaches	0
english walnuts	cryptogenic epilepsies	0
jelly beans	sciatica	0
supper	prostatic neoplasm	0
blueberry plants	drug allergy	0
rosemary	diverticula	0
mother cell	chronic obstructive lung disease	0
opium poppies	human t-cell leukemia virus type iii	0
black raspberries	hemolytic jaundices	0
raphanus	acute stroke	0
herr	human mammary neoplasms	0
deep-fried foods	subwakefullness syndromes	0
sauerkraut	crohn's disease	0
buttermilk	schizophreniform disorders	0
fiddlehead ferns	limb tremors	0
concord grape	intraepithelial carcinoma	0
raphanus sativus	cancer of the prostate	0
bread mold	small round structured viruses	0
dress	brain disorders	0
not-necessarily-so-healthy foods	tonic seizures	0
olive tree	drug hypersensitivity	0
bamboo shoots	chronic headache	0
nuclear power plant	hemicrania	0
mashed potatoes	somatotropin (acromegaly) hypersecretion syndrome	0
flaxseed	philadelphia-negative myeloid leukemia	0
tachigalia	age related maculopathies	0
lemon verbena	esophageal cancers	0
corn syrup	sensory seizure	0
acer negundos	irritable bowel syndromes	0
offal	hepatic failure	0
crunch berries	breast neoplasms	0
fruit juices	feline leukemia virus	0
endive	retro-ocular headaches	0
healthiest foods	gum disease	0
vegetable protein	muscle pains	0
chickpea	multiple meningioma	0
kawa kawa	renal calculi	0
nut bars	heat strokes	0
cucumis melo	hansen's disease	0
justicia adhatoda	cephalgia syndrome	0
lycopersicon esculentum	wheat hypersensitivities	0
sweetleaf	human papilloma virus	0
brussel sprout	nonalcoholic fatty livers	0
butter	galt deficiency	0
sockeye salmon	legal blindness	0
tepary beans	neurodegenerative disorder	0
term vegetable	paraesophageal hernia	0
pear	ductal carcinomas	0
sustenance	lewy body parkinson's disease	0
thymus plant	oncornavirus	0
raw poultry	laron dwarfism	0
common olive trees	schizoaffective disorders	0
avocado fruit	rheumatoid arthritis	0
component spices	lead poisonings	0
adhatoda	muscle cramps	0
whole grain	galactokinase deficiencies	0
kawa	lichen planus	0
healthiest beverage	steatohepatitis	0
drinking milk	gustatory seizure	0
carrot	post-ictal confusion	0
low fruit	non-hodgkin lymphoma	0
chilli pepper	diffuse small cleaved cell lymphoma	0
laciniate nightshade	parodontose	0
piper methysticum	alzheimer’s disease	0
caryophyllus aromaticus	mixed-cell lymphomas	0
persea	non-hodgkin's lymphoma	0
steak	beriberi	0
sweet basil	schizoaffective disorders	0
papaver somniferum	avitaminose	0
nicotiana tabacum	pulmonary disorder	0
cereal grain	arthrosis	0
dinnertime	uterine cervical cancers	0
areca catechus	epilepsy	0
strawberry	senile tremor	0
food additives	drug hypersensitivity	0
neutraceutical	senile osteoporosis	0
ready soybeans	chronic lymphocytic leukemias	0
lima beans	posterior compartment low back pain	0
conventional food	enzootic bovine leukoses	0
origanum	age related macular degeneration	0
hamburger	manic disorder	0
antioxidant-rich foods	dissociative amnesias	0
punica granatum	texidor twinge	0
texturized vegetable proteins	diabetic neuralgias	0
animal-based foods	cognitive dysfunctions	0
cassia cinnamon	acute monoblastic leukemia	0
breakfast cereals	colicky pain	0
cultivated radish	juvenile onset diabetes mellitus	0
green pepper	e-b virus	0
meal time	allergic reaction	0
ephedras	jakob creutzfeldt syndrome	0
french bean plant	baldness	0
spearmint	ekbom delusory parasitoses	0
chile peppers	feline leukemia virus	0
apple	autistic disorders	0
lens plant	female sub-fertility	0
prunus amygdalus	retained surgical sponges	0
raw food	substance use disorder	0
multivitamin	mottled enamels	0
sea bilberry	ankylosing spondyloarthritis	0
phytonutrient-rich food	senile plaque	0
hickory tree	low-grade b-cell malignancy	0
brewing tea	viral disease	0
malus domestica	non-b hepatitis epidemic non-a	0
cauliflower	pseudocoma	0
box elders	short sleeper syndromes	0
citrus limon	well-differentiated lymphocytic lymphoma	0
holy basil	prostatic intraepithelial neoplasia	0
domestic fowl	zoonotic diseases	0
dioscorea polystachya	flatulence	0
carthamus tinctorius	philadelphia-negative myeloid leukemias	0
assai palms	lung diseases	0
malabar nut	intracranial cns disorder	0
eat flax	cancer of rectum	0
chicken salad	memory disorders	0
solanum laciniatum	painful menstruations	0
bitter orange trees	lewy body parkinson disease	0
candy bar	acute inflammatory demyelinating polyneuropathy	0
powdered ginger	inherited human transmissible spongiform encephalopathies	0
overpriced vitamin	ekbom delusional parasitoses	0
citrus bergamias	protein deficiencies	0
linseed	menstrual pains	0
carbonated water	fibroatheromatous plaques	0
crabapple	tonsil neoplasms	0
broad beans	seizure	0
handling meat	rectum neoplasm	0
pistacia lentiscus	hypermelanosis	0
theobroma cacao	fibroatheromatous plaque	0
soybean proteins	acquired immunodeficiency syndromes	0
kale	pleomorphic lymphoma	0
holy basils	tongue cancer	0
diospyros digyna	broken bones	0
cayenne peppers	preinvasive carcinoma	0
sesame	small non-cleaved-cell lymphomas	0
cranberry juice	preventing cancer	0
sweet potatoes	skin diseases	0
eating broccoli	colon disease	0
blueberry	motor seizure	0
tomato sauce	amnestic states	0
mentha spicatas	catarrh	0
anise seed	precordial catch syndrome	0
sweetening agents	rectal cancers	0
rye bread	sub-fertility	0
rise	human t-cell lymphotropic virus type iii	0
saint johnswort	morning sickness	0
fake meat	juvenile onset diabetes mellitus	0
triticum turgidum subsp. durum	pruritis	0
common foxglove	numbness	0
eating nuts	chronic obstructive lung disease	0
cereal	guillain-barré syndrome	0
portulaca oleraceas	aneurysm	0
no-calorie sweeteners	retro-ocular headaches	0
bergamot	peanut allergies	0
portulaca oleracea	proteinuria	0
indian gooseberry	periodontal disease	0
elephant garlic	syncopal episode	0
lentinus edodes	arrhythmia	0
dietary sucrose	alopecia cicatrisatas	0
white meat	nausea	0
poultry	smell disorder	0
nutriceutical	esophageal neoplasms	0
preserved foods	galactose-1-phosphate uridyltransferase deficiencies	0
common bean plant	vulva neoplasm	0
low-sodium diet	mptp induced experimental parkinsonism	0
vegetable oil	alactasia	0
daily fruit	premature birth	0
healthy nuts	primary parkinsonism	0
cicer arietinum	neurodegenerative disorders	0
euterpe oleracea	iron deficiency	0
potato chips	female pattern baldness	0
indian laburnum	membranous cataracts	0
dietary fats	dizziness	0
pimpinella	intention tremors	0
triticum	transmissible spongiform encephalopathy	0
cold-steeping tea	senile plaque	0
oolong tea	fibroid uterus	0
empty calorie foods	neurological condition	0
uncooked food	lobar pneumonia	0
nonus	dna injuries	0
international nut	aortic aneurysm	0
coconut water	endometrial neoplasms	0
sesamum	high-grade lymphoma	0
exotic fruit	action tremor	0
cannabis sativa	senile paranoid dementia	0
ceylon cinnamon	nanism	0
snail meat	stroke	0
avena	carcinogenesis	0
corn oil	histamine cephalgias	0
citrus aurantiums	tumor viruses	0
woodland strawberries	encephalon disease	0
sea vegetable	acquired deafness	0
anacardium occidentales	saccular aneurysm	0
grouper	gynecomastia	0
mustard plants	lung inflammations	0
maize syrup	neonatal tremor	0
bitter orange tree	canker sore	0
rosehip	primary brain tumors	0
jambolan plum tree	benign brain neoplasms	0
euchresta	head traumas	0
organic foods	aphthous ulcers	0
nutmeg	alopecia	0
soy cheeses	sphenoid wing meningioma	0
nettle	early detection of cancer	0
ultra-processed foods	plasma-cell myelomas	0
cacao bean	prion induced disorder	0
broccoli raab	rhabdomyolysis	0
golden delicious apples	oxygen deficiencies	0
hemp plants	pulmonary diseases	0
cooked broccoli	colorectal neoplasm	0
including cloves	focal seizures	0
organic milk	gale deficiency	0
tangerine trees	testis neoplasms	0
gluten-free diet	rabies virus	0
pimenta officinalis	water-borne hepatitides	0
red yeast rice	severe mental disorder	0
morinda citrifolias	neuralgic migraine	0
floret	udp-galactose-4-epimerase deficiencies	0
california avocado	horton's syndrome	0
purple rice	breast tumor	0
antioxidant-rich food	galt deficiency	0
sweet almonds	liver disease	0
wild yam	melanoma	0
kola nut	infectious mononucleosis virus	0
vaccinium ashei	kidney stone	0
worldwide fruit	anthrax	0
seville orange tree	foodborne diseases	0
healthiest vegetable	small and large cleaved-cell lymphoma	0
kavas	leukemia	0
milk thistles	gastro esophageal reflux	0
french bean plants	sphenoid wing meningioma	0
bell peppers	congenital abnormality	0
carbonated mineral waters	circulatory collapse	0
licorice root	seasickness	0
poppy seed	nervous system degenerative diseases	0
fragaria vesca	pseudocoma	0
pleurotus ostreatus	infertility	0
sugar substitutes	auriculo ventricular dissociation	0
citrus x paradisi	frontal region traumas	0
cocktail	intraepithelial neoplasms	0
deep-fry foods	galactose-1-phosphate uridylyltransferase deficiencies	0
plum	common cancer	0
curcuma longas	deep-venous thromboses	0
curcuma longa	ileocolitis	0
crocus sativus	benign brain neoplasms	0
fast food	burn	0
dairy product	common cold	0
dried fruit	nonhodgkin lymphoma	0
organic meat	lymphadenopathy-associated viruses	0
drink	male breast neoplasms	0
citrus hystrix	foreign object	0
raw cranberries	anxiety disorder	0
pretzel	hepatitis	0
cardamon	chronic illness	0
jam	disc degeneration	0
refined olive	emesis	0
ganja	pustulosis palmaris et plantaris	0
food poisonings	dims (disorders of initiating and maintaining sleep)	0
citrus paradisi	generalized spasm	0
earl grey tea	well-differentiated lymphocytic lymphomas	0
phaseolus	neurologic degenerative disease	0
bottled water	terminal cancer	0
olive family	bilateral headaches	0
oolong	ovary cancer	0
green onions	spondylarthritis ankylopoietica	0
chewing gum	nanism	0
marjoram	periorbital headaches	0
energy drink	chronic fatigue syndromes	0
bean sprouts	pulmonary inflammation	0
ovary	iodine deficiency	0
low-fat diet	near-death experience	0
yellow vegetables	olfactory groove meningioma	0
kenaf	xanthomatous meningiomas	0
portulaca oleracae	drug hypersensitivities	0
red pepper	halitose	0
healthier foods	cll lymphoplasmacytoid lymphoma	0
horsebean	sleep related neurogenic tachypnea	0
anticancer plant	coma	0
roughage	iritis	0
steamer	ankylosing spondyloarthritis	0
salami	precordial catch	0
mangifera indica	mammalgia	0
bell pepper	acne vulgaris	0
andean blackberry	mucous colitides	0
sea-food	juvenile onset diabetes	0
anise tea	microglandular adenoses	0
black teas	pseudocoma	0
gum acacia	galk deficiency	0
gui zhi	cancer of bladder	0
fat foods	ekbom delusory parasitosis	0
illicium verums	flatulence	0
fagopyrum tataricum	episodic cluster headache	0
java plum trees	age related macular degeneration	0
texturized soy protein	diabetic mononeuropathy simplex	0
pecan	ovary neoplasm	0
syzygium	degenerative intervertebral disk	0
frying meat	autosomal recesssive juvenile parkinsonism	0
trigonella foenum-graecums	bacterial vaginosis	0
cooking oil	sleeplessness	0
tuna fish	osteoarthrosis deformans	0
vodka	autosomal dominant. juvenile parkinson disease	0
yam	central nervous system cysticercosis	0
organic food	fibromyalgia	0
cumin	familial creutzfeldt-jakob disease	0
apium graveolens	olfactory seizure	0
ultra-processed food	philadelphia-negative myeloid leukemia	0
french fries	human immunodeficiency virus	0
dessert	ciliary body spasm	0
celebration meal	autosomal dominant parkinsonism	0
betel nut	norwalk like viruses	0
poisonous plant	hyperventilation syncope	0
beetroot	cancer of cervix	0
coriandrum	myocardial infarctions	0
apricot tree	asymmetric diabetic proximal motor neuropathy	0
rubberplant	manic-depressive psychosis	0
big meals	ischemic heart diseases	0
euterpe oleracea mart.s	premenstrual tensions	0
halibut	ischemic heart diseases	0
peach tree	chronic cystic mastitis	0
apple trees	small non-cleaved-cell lymphoma	0
ready-prepared foods	impotence	0
maraschino cherry	muscular rheumatism	0
nutrient-dense foods	cardiac arrhythmias	0
callerya	deglutitional syncopes	0
solanum lycopersicum	marek's disease virus	0
shan yao	substance-induced organic mental disorders	0
solanum tuberosums	fibrocystic disease of breast	0
flaked coconut	visual seizure	0
whole grains	breast pain	0
sweetening agent	smell disorders	0
citrus reticulata	sleep related neurogenic tachypnea	0
brewed coffee	severe congenital microcephaly	0
macadamia nuts	chronic b-cell leukemia	0
processing meat	acute inflammatory polyneuropathies	0
carya illinoenses	malignant melanoma	0
medicago sativa	zoonotic infectious disease	0
zea	parkinsonian syndromes	0
black tea	physical anhedonia	0
olea europaea	hydrophobia	0
cassia	high blood pressures	0
dioscorea batatas	nonhodgkins lymphoma	0
unhealthy food	pregnancy-induced diabetes	0
adding blueberries	goiter	0
lime	dental diseases	0
narrow leaved plantain	germinoblastic sarcomas	0
dried food	chronic obstructive lung disease	0
anacardium occidentale	basal cell epitheliomas	0
potato	non hodgkin lymphoma	0
baker's yeast	cancer of the rectum	0
guava	breast malignant neoplasms	0
chlorella	inherited human transmissible spongiform encephalopathies	0
lemon tree	male breast cancer	0
lunch time	soft tissue sarcoma	0
peanut	hypoxia	0
soy cheese	left-sided heart failure	0
raw alfalfa	gluten-sensitive enteropathy	0
veggie	deep-vein thromboses	0
chilli peppers	disk degradations	0
tepary bean	joint diseases	0
ready-to-eat meal	laron type dwarfism i	0
fagopyrum	postoperative vomiting	0
filbert	insulin-dependent diabetes mellitus	0
ground meat	drunkenness	0
mustard greens	gastroesophageal reflux disease	0
smoked foods	primary fibromyalgia	0
dioscorea villosa	blood cancers	0
pumpkin seeds	gingivitide	0
artificially-flavored corn	dna injuries	0
onion	asymmetric diabetic proximal motor neuropathy	0
club soda	breast malignant neoplasm	0
ficus	syncopal episodes	0
purple cabbage	pyrosis	0
psidium	degenerative intervertebral discs	0
marjoram plants	multiple myositides	0
indian laburnums	soft tissue sarcoma	0
table salt	respiratory tract infection	0
yolk	hypospadia	0
cucumber	parasagittal meningioma	0
cayenne	environmental cancer	0
sea vegetables	ischemic heart diseases	0
convenience foods	unilateral headaches	0
seltzer waters	colorectal cancer	0
dietary proteins	well-differentiated lymphocytic lymphoma	0
cola nitida	somatosensory seizures	0
zingiber officinale	jaundice	0
star anises	intermittent tremors	0
oats	hypoascorbemia	0
mother cells	cardiac arrhythmias	0
baking chocolate	cancer of the penis	0
raisin bran	kidney failure	0
yogurt	chronic airflow obstruction	0
chili pepper	benign prostatic hyperplasia	0
rubus fruticosus	congenital hypothyroidism	0
trace minerals	esophageal hernia	0
amomum cardamomum	creutzfeldt jacob disease	0
fruit-shaped marshmallows	penis cancers	0
reindeer meat	neoplasm metastases	0
soy protein	vertex headaches	0
high-fiber food	cancer-causing viruses	0
noncaloric sweetener	tubal abortion	0
kava	thyroid disease	0
cocos nucifera	central nervous system degenerative diseases	0
solanum laciniatums	burkitt lymphoma virus	0
cuminum cyminum	thyroid neoplasms	0
crowberry	pulmonary inflammation	0
lycium chinense	gastroesophageal reflux	0
breakfast	galactokinase deficiency disease	0
rooibos	asthma	0
buckwheat	vagina cancers	0
flax	malignant epithelial neoplasms	0
barley coffee	disorder	0
grecian foxgloves	lobar pneumonias	0
octopus	psychotic disorder	0
fava beans	male pattern baldness	0
poppy seeds	prostate cancer	0
cultivated oats	oncogenesis	0
papaya	diabetic autonomic neuropathy	0
croaker	ciliary body spasms	0
chinese food	transmissible dementia	0
mustard	sprains and strains	0
drink milk	schizoaffective disorders	0
pummelo trees	convulsive seizure	0
tobacco	primary growth hormone resistance	0
nuclear power plants	renal cancer	0
beet	irritable bowel syndromes	0
citrus sinenses	chronic obstructive airway disease	0
soft drink	udp-galactose-4-epimerase deficiencies	0
cherry plum trees	cancer of the testis	0
narrow-leaved plantains	remittent fever	0
licorice	nutritional disease	0
althaea	thyroid carcinomas	0
allium cepa	inflammatory diseases	0
eating meat	back pain without radiation	0
texturized vegetable protein	posterior compartment low back pain	0
illicium	gastric neoplasms	0
baby formulas	scurvy	0
pistil	childhood onset obesity	0
carbonated drinks	manic disorders	0
handling food	fatty liver disease	0