
milk thistle	painful diabetic neuropathies	0
chai tea	ekbom delusional parasitoses	0
citrus medicas	primary brain tumor	0
rosehip	leukemogenic viruses	0
meal	deep vein thrombosis	0
osmanthus	posterior fossa meningioma	0
breast milk	sclerosis	0
elettaria	cll lymphoplasmacytoid lymphomas	0
decaf	bone cancer	0
venison	atrophy	0
solanum lycopersicum	communicable disease	0
citrus fruits	malignant epithelial tumor	0
pomelo tree	benign meningioma	0
vegetable oil	inhibit cancer	0
curry	necrotizing fasciitis	0
artificial sweetener	myocardial ischemia	0
drug administration united states food	dementia with amyotrophic lateral sclerosis	0
ultra-processed food	uterus cancers	0
vaccinium corymbosum	chronic airflow obstructions	0
ephedra	ekbom delusional parasitosis	0
sandwich	post-traumatic osteoporosis	0
healthiest fruits	epithelial cancer	0
kavas	galt deficiencies	0
oolong tea	virus	0
colocasia	mouth neoplasm	0
apium graveolens var. rapaceum	drop attack	0
ceratonia	epstein-barr virus	0
cocktail	intracranial neoplasms	0
suggesting fruit	pregnancy pernicious vomiting	0
lemon balm	diabetic amyotrophy	0
triticum spelta	alopecia	0
syzygium jambos	gluten enteropathy	0
mayo	brain benign neoplasm	0
popcorn	spindle cell carcinoma	0
white mallows	wheat allergies	0
white mallow	ovary neoplasms	0
sea vegetables	subacute spongiform encephalopathies	0
pea family	adolescent obesity	0
lens culinari	lung diseases	0
broad beans	unhealthy conditions	0
chanterelle	tremor	0
cooked carrots	delusional parasitoses	0
fried foods	stokes adams syncope	0
olive oil	parkinsonism dementia complex of guam amyotrophic lateral sclerosis	0
spore	zoonotic infection	0
eat chocolate	galactosemia iiis	0
nut bar	galactokinase deficiency disease	0
musa	parkinsonism dementia complex of guam amyotrophic lateral sclerosis	0
baking chocolate	disc degeneration	0
sweetener	chronic airflow obstructions	0
bertholletia excelsas	utp hexose 1 phosphate uridylyltransferase deficiency	0
pomegranate	guillaine barre syndrome	0
white tea	endometrial cancers	0
crocus	gustatory seizure	0
ready-prepared food	postural syncope	0
pistachio	itch	0
wild celery	philadelphia negative myeloid leukemia	0
stem vegetables	physical sufferings	0
leafy vegetables	pregnancy induced diabetes	0
texturized soy proteins	virus infection	0
avena sativa	senile plaques	0
proteus mirabilis	back pains	0
triticum durum	age-related macular degeneration	0
purslane	upper respiratory tract infections	0
drink tea	human t cell leukemia virus type iii	0
chicken salad	temporal region traumas	0
mandarin orange tree	feline leukemia virus	0
soy food	fibroatheromatous plaque	0
health nuts	bone neoplasms	0
regular olive	chronic gum disease	0
cod	environmental cancer	0
phaseolus acutifolius	dwarfism	0
sweet marjorams	neurodegenerative disorder	0
smoked foods	anemia	0
mentha	chronic headache	0
maize syrup	animal virus	0
turkey meat	enzootic bovine leukoses	0
snack food	psoriase	0
cynara scolymus	pustulosis palmaris et plantaris	0
laciniate nightshades	canker sores	0
big apples	medical conditions	0
turnip	autosomal dominant. juvenile parkinson disease	0
opium poppies	crohns disease	0
oxen meat	diverticulum	0
kawa	hypoxemia	0
deep-fried foods	gall stone	0
white meat	cancer-causing viruses	0
shoot	tumor	0
include fennel	recurrent brain tumor	0
color	nonhodgkin lymphoma	0
arugula	fifth phacomatosis	0
malabar-nut	prostate cancer	0
concord grapes	diffuse mixed cell lymphoma	0
mint tea	tactile amnesia	0
club soda	basal cell epitheliomas	0
rosemary	variant creutzfeldt-jakob disease	0
trace element	mesothelioma	0
honey	premature aging	0
elettaria cardamomum	reticulum-cell sarcoma	0
millet	postural syncopes	0
açaí berries	thermal hypesthesia	0
horsenettle	inappropriate gh secretion syndrome (acromegaly)	0
biometal	recurrent brain tumor	0
thymus plant	joint pains	0
chestnut	human influenzas	0
density foods	tongue neoplasms	0
tisane	atheromatous plaques	0
apple juice	colorectal cancers	0
skim milk	stomach ulcer	0
nutritional yeast	brain vascular accidents	0
vaccinium ashei	muscle tremor	0
acer negundos	cancer of thyroid	0
saint johnswort	urinary bladder neoplasm	0
chamomile oil	hereditary galactokinase deficiencies	0
organic milk	gall stones	0
coffee	inflammatory polyneuropathy acutes	0
arachis hypogaea	acute inflammatory demyelinating polyneuropathy	0
euterpe oleracea	icterus	0
jasmine tea	myelopathy	0
syzygium aromaticum	resting tremor	0
rise	plasma cell myeloma	0
oryza	cognitive declines	0
solanum tuberosums	prion-induced disorder	0
plum trees	infant obesity	0
intoxicant	pustular psoriasis of palms and soles	0
betel	postural low back pain	0
liquor	abdominal cramp	0
citrus grandi	cot death	0
supper	gall bladder diseases	0
melissa	visceral steatosis	0
mustard greens	tussive syncopes	0
acaí berries	ovary neoplasms	0
plantago lanceolata	muscle tenderness	0
american meat	dna injury	0
horse nettle	degenerative arthritis	0
split pea	relapse	0
crab apple	galt deficiencies	0
wild radish	intraepithelial prostatic neoplasias	0
peanut butter	xanthomatous meningioma	0
ready prepared foods	spindle cell sarcomas	0
eugenia malaccensis	pill rolling tremors	0
jelly beans	senile tremors	0
rose berries	epithelioid sarcomas	0
mussel	malignant tumor of urinary bladder	0
pistacia	zoonotic infections	0
cardamom	primary fibromyalgias	0
monkfish	lung cancer	0
glucose fructose syrup	juvenile onset diabetes	0
molasses	hiatus hernia	0
plant aril	dissociative amnesia	0
lavandula	malignant tumor of urinary bladder	0
curcuma longas	early detection of cancer	0
century plant	hirsutism	0
digitalis purpurea	spindle cell sarcoma	0
flavoring	small-cell lymphomas	0
iceberg lettuce	fifth phacomatosis	0
pea families	mastalgia	0
fabaceae	viral diseases	0
hypericum perforatum	diabetic neuralgias	0
anacardium	beriberi	0
pumpkin seeds	physical suffering	0
cayenne	cervical migraine syndrome	0
beet	back pains	0
entree	pattern baldness	0
soybean proteins	bronchiolitis	0
ice cream	udp-galactose-4-epimerase deficiencies	0
acai berries	chronic cluster headaches	0
taro	ankylosing spondylarthritis	0
sweet peppers	coronary heart diseases	0
solanum	open head injuries	0
pimenta	vagina cancer	0
mustard plant	early onset parkinson disease autosomal recessive	0
persea americanas	migraine variant	0
high-phytate foods	diverticulitide	0
beverage	transmissible dementias	0
carrot juice	auto-immune disease	0
coriander	leukovirus	0
retail meat	chronic infectious mononucleosis-like syndrome	0
rye bread	muscle soreness	0
coco	uveitis	0
grouper	cancer of the vagina	0
mastic trees	marsh fever	0
olive oils	male pattern baldness	0
nut	cow disease	0
indian laburnums	deafness	0
dog rose	syncope	0
areca catechus	deaf-mutism	0
kawa kawa	atypical cluster headache	0
cooking oil	sunburn	0
alcohol	lou gehrig disease	0
eggnog	milk sugar intolerance	0
alfalfa sprout	acquired immune deficiency syndrome virus	0
jerusalem artichokes	common bile duct gallstones	0
brewed coffee	mink encephalopathy virus	0
turmeric root	degenerative disease	0
carica	inner ear cancer	0
silken tofu	esophageal hernia	0
deli meat	preventing cancer	0
little meat	develop cancer	0
oryza sativa	intervertebral disk degeneration	0
study lavender	cerebral convexity meningioma	0
calendula	hypesthesia	0
processed meat	endometrial neoplasms	0
narrow-leaved plantains	dental fluoroses	0
spice saffron	syndrome	0
ceylon cinnamon	anxiety neuroses	0
corn	gestational diabetes	0
bamboo shoots	intervertebral disk degeneration	0
calendula officinalis	nutritional disease	0
raphanus raphanistrum	penis cancers	0
coriandrum sativum	nafld	0
lens culinaris	b-cell chronic lymphocytic leukemia	0
vegetarianism	chronic pain	0
curcuma longa	atrioventricular dissociations	0
flower	intracranial central nervous system disorders	0
texturized soy protein	reticuloendotheliosis viruses	0
marsh mallows	infant botulism	0
mustard plants	cryptogenic epilepsy	0
floret	kidney calculi	0
low-sodium diet	kidney disease	0
steamer	vulva neoplasms	0
endive	multiple myositides	0
processed meats	pseudotumor cerebri	0
citrus paradisi	auriculo-ventricular dissociation	0
healthy snacks	bovine leukemia	0
sugar substitute	amyloid plaque	0
cinnamomum aromaticum	brain vascular accident	0
fagopyrum tataricum	saccular aneurysm	0
pecan	lens opacities	0
malus	idiopathic parkinson's disease	0
carbonated mineral waters	prostatic adenoma	0
red rice	cervix neoplasms	0
thymus	arterial dysfunction	0
reindeer meat	mouth cancers	0
nut butter	starvation	0
handling meat	endometriose	0
dietary supplementations	fights cancer	0
cuminum	brain vascular accident	0
sugary foods	colon cancers	0
pimenta officinali	experimental lung inflammations	0
brewage	heart decompensation	0
illicium	micturition syncope	0
soda pops	idiopathic polymyositides	0
salmonella-infected eggs	coronary heart disease	0
gooseberry	micturition syncopes	0
cocoa plant	asthma	0
crataegus monogyna	intracranial cns disorder	0
broccoli	bacterial vaginitis	0
phaseolus vulgaris	weight reductions	0
amla	intertrochanteric fractures	0
soymilk	venereal wart	0
cherry plum tree	parkinson disease 2	0
macadamia nut	infant obesity	0
milk	gossypiboma	0
daily fruit	spinal cord diseases	0
citrullus	muscle tenderness	0
pasta	acute myeloid leukemia	0
citrus hystrices	meningotheliomatous meningiomas	0
aloe vera	clonic seizures	0
french bean plant	ovarian neoplasms	0
last meal	mixed small and large cell lymphoma	0
scrambled eggs	proliferative bronchiolitis	0
plant-based foods	pulmonary disease	0
common plant	acute autoimmune neuropathy	0
citrus sinenses	psychotic disorders	0
yeast rice	sliding hiatal hernia	0
chili peppers	retro-ocular headaches	0
canned foods	clear cell meningioma	0
crab apples	gastroesophageal reflux disease	0
adhatoda	brain vascular accidents	0
pithecolobium	malignant epithelial tumor	0
orange trees	bovine leukemias	0
dioscorea batatas	long sleeper syndrome	0
fat foods	avitaminosis	0
cinnamomum zeylanicum	acute inflammatory polyneuropathies	0
rose	vaginal cancers	0
chamomile	amyotrophic lateral sclerosis	0
bell pepper	central obesities	0
tea leaves	secretory meningiomas	0
suggesting apple	nonalcoholic fatty livers	0
cicer arietinums	experimental lung inflammation	0
psidium guajava	recurrence	0
noncaloric sweetener	cva (cerebrovascular accident)	0
dairy product	bovine lymphomas	0
soda waters	atopic diseases	0
salt-free diet	androgenetic alopecia	0
grape	bladder tumors	0
eugenia cumini	polyphagia	0
pistacia lentiscus	nonalcoholic fatty liver disease	0
wild yams	intestinal disease	0
digitalis	gum disease	0
rubus glaucus	toxico-infectious botulism	0
cortland	remittent fever	0
carya illinoensis	primary malignant brain neoplasms	0
margarine	microlissencephaly	0
grape juice	fibrositide	0
areca	insomnia disorder	0
beet greens	remittent fever	0
plant-based nutrients	posterior fossa meningioma	0
gluten-free diet	steatohepatitide	0
pistachio nut trees	breast pain	0
curcuma zedoarias	head trauma	0
lime	udp-galactose-4-epimerase deficiency	0
cucumis sativus	catarrh	0
crowberry	mammary cancer	0
cassia tree	breast adenosis	0
fatty foods	intraventricular meningioma	0
emphasize plant	reducing cancer	0
pizza	galactokinase deficiencies	0
colophospermum	johne disease	0
tree nuts	bacteria-eating virus	0
malus domestica	paludism	0
plantago psyllium	breast fibrocystic change	0
crataegus	bone neoplasm	0
romaine lettuce	bladder tumors	0
boiled eggs	gorlin-goltz syndrome	0
feather meal	abdominal cramp	0
mealtime	periodontal diseases	0
carica papayas	auditory seizures	0
sell meat	intestinal disease	0
rooibos	burkitt lymphoma virus	0
dietary plant protein	jakob creutzfeldt disease	0
butter	deglutitional syncopes	0
different seed	olfactory seizures	0
apium graveolens var. dulce	asymmetric diabetic proximal motor neuropathy	0
catfish	amnesia memory loss	0
butternut squash	ulcerative colitis type inflammatory bowel disease	0
sustenance	baldness	0
infects apples	substance abuses	0
allium porrum	pediatric cancers	0
fed beef	psychotic disorder	0
incorporate cloves	undifferentiated carcinomas	0
red delicious apples	lightheadedness	0
shellfish	uterus cancers	0
split peas	leucocythemia	0
anacardium occidentales	generalized headaches	0
store licorice	gall bladder diseases	0
potassium-rich foods	spindle-cell carcinoma	0
rubus fruticosus	hypercapnia	0
malabar nut	tumor	0
tobacco	breast malignant tumor	0
cranberry sauce	experimental lung inflammations	0
lemon verbena	parasagittal meningiomas	0
delonix	occipital trauma	0
açaí berry	dims (disorders of initiating and maintaining sleep)	0
petroselinum	premenstrual tensions	0
new york coalition for healthy school food	apneas	0
pistacia vera	mixed lymphocytic-histiocytic lymphoma	0
red delicious	varix	0
linum usitatissimum	ciliary body spasm	0
cassia	early diagnosis of cancer	0
whipped cream	atherogenesis	0
cola	pleomorphic lymphomas	0
serve	transmissible dementias	0
maple syrup	dyschezia	0
food colors	autism	0
beta vulgaris	eczematous dermatitides	0
kombucha tea	neonatal tremor	0
happy meal	insulin dependent diabetes mellitus 1	0
unfertilized eggs	spindle cell carcinoma	0
plant arils	malignant lymphomas	0
pork	hormonal dysfunction	0
dioscorea opposita	uveitide	0
cocoa butter	macular degenerations	0
roselle	fibromyalgia-fibromyositis syndromes	0
rubus idaeus	behavior disorders	0
solanum tuberosum	intraepithelial neoplasms	0
blossom	nonalcoholic fatty livers	0
glycyrrhiza	liver steatoses	0
star anises	thyroid neoplasms	0
ocimum basilicums	blv	0
cocos nucifera	skin neoplasm	0
raw broccoli	necrotizing fascitides	0
celebration meal	multiple myeloma	0
ocimum tenuiflorum	amyloid plaques	0
andean blackberries	clonic seizure	0
vitamin	testis cancers	0
olea europaea	multiple meningioma	0
junk food	verruca	0
fragaria vesca	continuous tremor	0
dietary fibers	pulmonary inflammation	0
dried foods	halitose	0
tofu	urticarias	0
chinese food	mottled enamel	0
artificial butter	neurodegenerative disease	0
eating almonds	infantile colic	0
yam	gehrig disease	0
mesquite	retained surgical tools	0
carrot	viral hepatitis	0
holy basils	minor head injuries	0
red cabbage	bse (bovine spongiform encephalopathy)	0
barberry	confusional state	0
organic food	female sub fertility	0
chicken	water stress	0
bean	parasagittal meningiomas	0
mackerel	zoonotic disease	0
walnut	galactosemia 2s	0
grecian foxglove	abdominal pains	0
sour orange trees	weight gain	0
japanese plum	pharyngitis	0
sour fruit	intracranial cns disorders	0
purple rice	gehrigs disease	0
plant embryos	dental plaque	0
tangerine tree	amyloid plaque	0
lentinus edodes	weight gains	0
calendula officinali	hemorrhoid	0
assai palm	breast cancers	0
callerya	graves disease	0
common foxgloves	cancer of the bladder	0
prunus persica	uterus neoplasm	0
norus	gastric ulcers	0
sparkling waters	small noncleaved-cell lymphomas	0
squash plants	gustatory seizures	0
petroselinum crispum	bilateral sciaticas	0
salad	malignant tumor of breast	0
ground meat	tonsil neoplasm	0
juglans regia	uterus neoplasms	0
chilli peppers	small lymphocytic lymphoma	0
morel	non-hodgkin lymphoma	0
mirobalanus embilica	pulmonary neoplasm	0
citrus x paradisi	fibrose	0
pie	splitting pain	0
cashew	intraepithelial carcinoma	0
rheum tanguticum	mania	0
wild bananas	hemorrhoid	0
tuna	intraepithelial neoplasms	0
no noni	non-epileptic convulsion	0
eat flax	psammomatous meningiomas	0
olive tree	atrioventricular dissociation	0
sweetened cereal	burn	0
chilli pepper	substance addiction	0
shiitake	human immunodeficiency viruses	0
blueberry plants	zoonotic infectious diseases	0
morinda citrifolias	pulmonary cancers	0
zea	muscle cramps	0
dietary fiber	impaired sensations	0
trigonella foenum graecum	hot flashes	0
ginger ale	norwalk like viruses	0
dried apple	cerebrovascular strokes	0
cow's milk	cephalodynia	0
carbonated mineral water	hysterical amnesias	0
potato chips	endometrioma	0
prunus amygdalus	retro-ocular headaches	0
crunch berries	lens opacity	0
antioxidant vitamin	abdominal aortic aneurysms	0
watermelon	dysfunction	0
sugar	benign neoplasm	1
stevia rebaudianas	birth defect	0
garbanzo	chest pains	0
horsebean	backache	0
trace minerals	rectum neoplasm	0
prunus domestica	genital wart	0
almond	parasagittal meningiomas	0
rhubarb	tumor of rete testis	0
fryer	atrioventricular dissociations	0
replenish nutrients	fibrocystic changes of breast	0
dried fruit	high blood pressures	0
bilberry	male breast neoplasm	0
portulaca oleracea	alopecia	0
spearmint	visceral steatoses	0
radish	cardiac sudden death	0
sugar water	fibrous meningiomas	0
prenatal vitamins	kidney failure	0
cassia trees	manic disorder	0
official vitamin	pyrose	0
holy basil tea	arterial dysfunction	0
organic foods	acquired immuno deficiency syndrome	0
agaricaceae	familial tremor	0
bagel	joint disease	0
favorite meals	diabetic asymmetric polyneuropathies	0
soy bean proteins	disorder	0
drink milk	gallstone	0
nutriceutical	bovine leukemia virus	0
citron tree	malignant neoplasm of breast	0
lard	phlebothrombosis	0
illicium verums	intermediate-grade lymphoma	0
food and drug administration	carotid sinus syncope	0
saint john's wort	lung cancer	0
majorana hortensis	cot deaths	0
hawthorn	prostatic adenomas	0
colorful foods	gastric acid reflux disease	0
nettle	lewy body parkinson's disease	0
breakfast cereals	pustulosis of palms and soles	0
indian corn	chronic lymphoblastic leukemia	0
sparkling water	global amnesia	0
green onions	bronchiolitide	0
portulaca oleraceas	occipital trauma	0
faba bean	infant botulism	0
alfalfa sprouts	migraine disorder	0
foeniculum vulgare	numbness	0
rowanberry	malignant meningioma	0
brew	substance-related disorders	0
antioxidant-rich food	unilateral headache	0
hot peppers	myocardial ischemias	0
myristica fragran	skin disease	0
eating meat	allergy	0
common bean plants	leukemia	0
healthier foods	crohns disease	0
andira	galactose epimerase deficiencies	0
trace elements	sudden cardiac death	0
individual food	fibroatheromatous plaque	0
acer saccharums	cystic disease of breast	0
persea americana	lobar pneumonia	0
powdered sugar	periorbital headaches	0
caryophyllus aromaticus	atherogenesis	0
almond milk	common bile duct gallstones	0
sauerkraut	todds paralysis	0
lycium barbarum	disk degeneration	0
areca catechu	b12 deficiency	0
component spices	weight losses	0
flowering shrub	growth hormone receptor defect	0
ready soybeans	insulin dependent diabetes mellitus 1	0
celery	hiccup	0
ginger	uterine fibromas	0
hop	small lymphocytic lymphoma	0
potato	memory disorders	0
pear	lyssa	0
prunus armeniaca	cancer of the esophagus	0
drink	strain	0
antioxidant fruits	saturnine tremor	0
cannabis indica	hiatus hernia	0
sour orange tree	intraepithelial prostatic neoplasias	0
illicium anisatum	familial creutzfeldt-jakob disease	0
dessert	acute fulminating multiple sclerosis	0
ephedras	cow disease	0
solanum dulcamaras	pancreas neoplasm	0
wild yam	leukemogenic virus	0
red tea	diabetic neuropathy	0
foeniculum vulgares	cancer of rectum	0
beta vulgari	esophageal hernia	0
agave	idiopathic polymyositis	0
restrict food	virus	0
asparagus	small lymphocytic lymphoma	0
collard greens	myelomatosis	0
eating fruits	classic galactosemias	0
arecas	schizophrenic disorder	0
target vitamin	severe mental disorder	0
corylus	lobar pneumonia	0
century plants	allergy	0
secale cereale	male breast tumor	0
oyster mushroom	familial tremor	0
spaghetti	galactose epimerase deficiencies	0
hashish	sudden infant death	0
cocoanut	sinusitide	0
pickled vegetables	disorder	0
durum wheat	gale deficiency	0
artichoke	udp galactose 4 epimerase deficiency	0
fast food	degenerative neurologic disease	0
black currants	non-b hepatitis enterically-transmitted non-a	0
laciniate nightshade	cognitive dysfunctions	0
emphasizes vegetables	experimental parkinson disease	0
rheum	bilateral headaches	0
cannabis sativa	pediatric obesity	0
bean sprout	skin neoplasms	0
narrow leaved plantain	benign brain neoplasms	0
solanum melongena	testis cancers	0
new candy	e-b virus	0
sardine	trochanteric fractures	0
daucus carota	epstein-barr virus	0
kidney beans	fibrous meningioma	0
poppy seeds	malignant brain neoplasm	0
sea food	smell disorder	0
red meat	jakob creutzfeldt syndrome	0
kenaf	numbness	0
willow tree	forehead traumas	0
fortify milk	male subfertility	0
cereal	bovine lymphosarcomas	0
purine-rich plant	zoonotic infectious disease	0
fungus	birth defect	0
filbert	involutional osteoporosis	0
cymbopogon nardus	uterine cancer	0
triticum aestivum	pneumonia	0
dog rose berries	endometrium carcinomas	0
orange tree	chronic fatigue-fibromyalgia syndrome	0
horse bean	delusional parasitosis	0
eugenia jambolana	mottled enamel	0
teosinte	verruca	0
dragon fruit	bacterial vaginosis	0
citrus sinensis	senile plaques	0
glycyrrhiza glabra	galt deficiency	0
olea	hemicrania	0
poenumgraecum	eye diseases	0
fig	diabetic neuralgias	0
cardamon	prion protein disease	0
octopus	diabetes related complications	0
nut butters	mechanical low back pain	0
alfalfa	spondylitis ankylopoietica	0
dressing	pancreas cancers	0
organic plants	colonic neoplasm	0
eating nuts	colorectal cancers	0
linseed	udp-galactose-4-epimerase deficiency diseases	0
msg	chronic pain	0
english plantains	fatty liver	0
restructured meat	uterine cervical neoplasm	0
cupcake	migraine variant	0
acer negundo	pulmonary inflammation	0
mentha spicatas	crushing skull injuries	0
frozen fruit	crib death	0
oats	postural syncope	0
baker's yeast	low-grade lymphomas	0
white pepper	b-cell chronic lymphocytic leukemia	0
digitalis lanata	oral disease	0
bitter nightshades	human flu	0
horse beans	sleep disorders	0
anacardium occidentale	tonic clonic seizures	0
exotic fruits	nervous system degenerative diseases	0
osmanthus tea	orthostatic headaches	0
syrup	male subfertility	0
pithecellobium	mad cow diseases	0
lemon trees	norwalk-like viruses	0
vaccinium angustifolium	mptp-induced experimental parkinsonism	0
granny smith apples	periorbital headaches	0
food coloring	familial tremor	0
rheum officinale	ovary cancer	0
carthamus tinctorius	hepatic cancer	0
garden radish	cysticercosis	0
avocado	micturition syncopes	0
healthy fruit	renal insufficiencies	0
swordfish	malignant tumor of breast	0
golden glow	bone fracture	0
jalapeno peppers	muscle pain	0
euterpe precatoria	endometrial neoplasm	0
sweet almonds	social anhedonia	0
dinner	vertebrogenic pain syndrome	0
amomum cardamomums	feline lymphoma virus	0
chewing fruit	aphthous ulcer	0
club sodas	prostatic cancer	0
vegetable juices	intraepithelial prostatic neoplasias	0
olive trees	involuntary quiver	0
sesame seeds	mania	0
silybum marianums	limb tremor	0
probiotic	classic galactosemia	0
maize	erectile dysfunction	0
origanum	autosomal dominant parkinsonism	0
contaminated meat	lyme arthritis	0
cassia fistulas	cardiovascular diseases	0
muffin	chronic lymphocytic leukemias	0
actual licorice	cjd (creutzfeldt jakob disease)	0
prunus salicina	cancer of the testes	0
poultry product	endometrial cancer	0
collard	superficial head injury	0
roundup-ready soybeans	bowel diseases	0
pomelo trees	igf-1 deficiency	0
origanum majorana	mottled enamel	0
vitis vinifera	lobar pneumonia	0
spinach	pernicious vomiting of pregnancy	0
oat	sudden infant death	0
dioscorea polystachya	galactokinase deficiencies	0
candy bars	fibroatheroma	0
euterpe	retained surgical item	0
phyllanthus emblica	vulvar cancer	0
french fries	hereditary galactokinase deficiencies	0
popular fruits	diabetic polyneuropathy	0
norovirus food	ciguatera	0
brewing tea	aphthae	0
dandelion	determination of death	0
own vitamin	bovine spongiform encephalitis	0
cooked tomatoes	multiple myelomas	0
cider	oncornavirus	0
fagopyrum esculentum	multiple meningiomas	0
bran flakes	guillain barre syndrome	0
sorrel	pulmonary inflammation	0
potable water	painful menstruations	0
decrease meat	cognitive retention disorder	0
watercress	stokes-adams syncope	0
black coffee	parkinson disease	0
onion	familial creutzfeldt-jakob diseases	0
nuclear power plant	prion-induced disorder	0
citrus	weight reduction	0
human milk	testis cancer	0
pistachio nut tree	overeat	0
elettaria cardamomums	microglandular adenosis	0
sweeten	myalgic encephalomyelitis	0
chewing gums	arterial dysfunction	0
arginine-rich foods	tongue cancer	0
solanum laciniatums	lobar pneumonia	0
justicia adhatoda	small round structured viruses	0
kola nuts	familial dementias	0
açai berries	lymphatic sarcoma	0
cold-steeping tea	manic-depressive psychoses	0
cooking meat	contagious ecthyma	0
seville orange trees	male breast carcinoma	0
green teas	olfactory seizure	0
assai palm berry	kidney failure	0
cooked broccoli	insulin dependent diabetes mellitus 1	0
goiaba	bovine lymphoma	0
punica granatum	sneeze	0
recommend tea	galactokinase deficiency diseases	0
rabbit meat	diabetic mononeuropathy simplex	0
black tea	diabetic neuralgia	0
aquatic food	toxic megacolon	0
food pyramid	diabetic mononeuropathy	0
healthier meat	pregnancy-induced diabetes	0
ficus	fifth phacomatoses	0
high-fructose corn	inflammatory bowel diseases	0
meal times	mental deteriorations	0
pickled foods	rodent ulcers	0
soy milk	diarrhea	0
snack	pill rolling tremor	0
black sapote	liver diseases	0
specific cheeses	sleep wake disorder	0
mango	cancer of the breast	0
ultra-processed foods	study cancer	0
macadamia nuts	basal cell carcinomas	0
fennel	age-related maculopathy	0
offal	cancer of the thyroid	0
zedoary zedoaria	meningioma	0
amorpha	congenital abnormality	0
jalapeno	spinal cord degenerative diseases	0
dietary fats	breast pains	0
avena	itch	0
edible grain	cervix cancers	0
cinnamomum verum	acute inflammatory polyneuropathies	0
drinking tea	aphthous stomatitis	0
euterpe oleracea mart.s	semantic memory disorders	0
food supplementations	rete testis tumor	0
vaccinium bracteatum	bacterial infections	0
carbonated beverages	guillain barre syndrome	0
portulaca	crohn disease	0
hickory tree	congenital myxedema	0
mangifera indicas	lymphosarcoma	0
chinese cinnamons	insomnia disorder	0
monitoring food	peripheral artery diseases	0
wisconsin milk	cardiogenic syncopes	0
pea	htlv-iii	0
kava kavas	neuritic plaque	0
saccharomyces cerevisiae	olfaction disorder	0
aspartame	cardiovascular conditions	0
sausage	cancer of the ovary	0
juiced broccoli	schizoaffective disorders	0
red lentils	splitting pains	0
uncooked foods	cardiac diseases	0
sugar-sweetened beverages	degenerative intervertebral discs	0
hazelnut	resting tremor	0
processed food	spiral fractures	0
piper methysticum	pleomorphic lymphoma	0
licorice root	cluster headache syndrome	0
dangerous plants	male breast enlargement	0
oregano	spondylarthritis ankylopoietica	0
solanum dulcamara	lou gehrig disease	0
flammulina	anxiety disorder	0
foodstuff	thermal hypesthesias	0
lemongrass	familial tremors	0
warm milk	prostatic neoplasms	0
consumer protection scientific committee on food	mental deteriorations	0
berberi	canker sores	0
apple tree	chest pains	0
punica granatums	chronic lymphocytic leukemia	0
multivitamin	transitional meningioma	0
linum	spinal meningiomas	0
vodka	tongue neoplasms	0
hypericum perforatums	minor head injury	0
anise seed	apneas	0
yerba mates	peripheral demyelinating autoimmune disease	0
black currant	ductal carcinomas	0
wheatgrass	autosomal dominant. juvenile parkinson disease	0
pleurotus	disk degradations	0
philadelphia cream cheese	benign essential tremors	0
raspberry	cancer of skin	0
cacao bean	exudative bronchiolitides	0
fennel seeds	primary parkinsonism	0
sugar substitutes	involuntary quiver	0
sour cream	cervical migraine syndromes	0
red yeast rice	hypercholesterolemia	1
little saffron	heart attack	0
banana plant	cardiac death	0
clove	small-cell lymphoma	0
yerba mate	canker sore	0
dried blueberries	johne's disease	0
guibourtia	posterior fossa meningiomas	0
trace mineral	intertrochanteric fractures	0
ketchup	tonsillar neoplasms	0
citrus aurantiums	schizoaffective disorders	0
contaminated foods	chronic pain	0
jelly	temporal region trauma	0
ananas	sharp headaches	0
big food	neoplasm metastasis	0
chinese cassias	reticuloendotheliosis virus	0
dairy eggs	blood cancers	0
gravy	cluster headache syndrome	0
poppy seed	atheroma	0
alcoholic beverages	bovine leukemias	0
chile pepper	fibroid	0
milkshake	acute cerebrovascular accident	0
chinese rhubarb	carcinomatosis	0
prettiest fruit	fibromyalgia fibromyositis syndrome	0
scallion	seasickness	0
brown sugar	fibromyositis fibromyalgia syndrome	0
vinegar	paraosmia	0
spice turmeric	atypical cluster headache	0
cinnamon	postoperative emesis	0
dioscorea	syncopal episodes	0
lunchtime	urinary bladder neoplasms	0
chinese yam	cholera	0
common olive tree	neonatal tremors	0
pimenta diocia	abdominal cramps	0
low meat	headache syndrome	0
tulsi tea	chronic obstructive airway disease	0
lens plant	physical suffering	0
reason food	gut dysfunction	0
black teas	alopecia	0
drinking orange	bacterial vaginitides	0
texturized vegetable proteins	diabetic retinopathy	0
pinto beans	endometriose	0
solanum melongenas	renal cancer	0
mock meats	penis cancer	0
pecan trees	intraventricular meningioma	0
trompillo	leukemia	0
taraxacum	joint diseases	0
pineapple	ph1-negative myeloid leukemia	0
tachigalia	testicular tumors	0
cranberry juice	verruca	0
peppermint	high blood pressure	0
chocolate pudding	reducing cancer	0
dietary sugars	intraorbital meningiomas	0
flax seed	autoimmune condition	0
dinner times	mixed lymphocytic-histiocytic lymphoma	0
yogurt	fibromyoma	0
healthiest nuts	retinitis	0
emblica officinalis	fibrous meningioma	0
leaf lettuce	salmonellosis	0
molasse	severe gh insensitivity	0
cucurbita	ekbom dermatozoic delusions	0
eating broccoli	headache syndromes	0
assai palms	female subfertility	0
cereal grains	breast neoplasm	0
eugenia caryophyllata	ruptured appendicitis	0
poisonous plant	primary brain neoplasm	0
purple cabbage	chronic airflow obstruction	0
amaranth	human immunodeficiency viruses	0
syzygium malaccense	food borne illnesses	0
cocoa powder	crohn disease	0
frying meat	ph1-negative myelogenous leukemias	0
chinese yams	lactose malabsorption	0
decaffeinated tea	muscle spasm	0
acacia tree	anal ulcer	0
raw alfalfa	ankylosing spondylarthritides	0
goji berry plant	postoperative emeses	0
dietary supplement	galactose epimerase deficiencies	0
soy bean curd	allergic reactions	0
soda pop	medical conditions	0
hamburger	diffuse mixed small and large cell lymphoma	0
experience food	lung neoplasm	0
seed	basal cell carcinomas	0
green tea	proliferative bronchiolitides	0
healthiest beverages	periorbital headache	0
baby spinach	burning pains	0
pimpinella anisums	pulmonary thromboembolisms	0
sugar maples	stomach neoplasm	0
red wine	malignant meningiomas	0
cilantro	hemangioblastic meningioma	0
ready-to-eat meals	malignancy	0
big meals	manic-depressive psychoses	0
tumeric	malignant brain neoplasms	0
morning meals	subwakefullness syndrome	0
animal-based vitamin	intracranial meningioma	0
citrus bergamias	crohn disease	0
sushi	gout	0
chile peppers	malignant tumor of breast	0
dasheen	cancer of uterus	0
real chocolate	atheroma	0
egg	chronic daily headache	0
mashed potatoes	muscular rheumatism	0
jam	elevated cholesterol	0
corn oil	memory disorder	0
holy basil	contagious ecthyma	0
white bread	cancer of bladder	0
raw food	acquired immune deficiency syndrome	0
nicotiana	autosomal recesssive juvenile parkinsonism	0
laudable legume	respiratory infections	0
fermented cabbage	sinusitis	0
black sapotes	effort syncope	0
common olive trees	brain malignant neoplasms	0
narrow-leaved plantain	confusion	0
black beans	liver steatosis	0
lentil	spontaneous abortions	0
herb	breast fibrocystic changes	0
dinnertime	endometrium carcinomas	0
eupatorium rebaudianum	thrombosis	0
cassia cinnamon	pustulosis of palms and soles	0
coriandrum	nonorganic insomnia	0
leguminosae	human cancer	0
peanut	food-borne illnesses	0
almond tree	cancer of the tongue	0
kangaroo meat	female sterility	0
oreo	migraine disorders	0
whiting	jakob creutzfeldt disease	0
pimpinella	venereal wart	0
açai berry	gestational diabetes mellitus	0
raisin bran	muscular cramp	0
soybean	bladder tumor	0
teff	small cleaved cell lymphoma	0
vital nutrients	morning sickness	0
dried peas	substance-induced organic mental disorders	0
junk foods	viral hepatitis	0
black pepper	vulva cancer	0
drinking coffee	idiopathic parkinson disease	0
dietary plant proteins	johnes disease	0
fermented foods	joint pains	0
brazil nuts	substance use disorders	0
low fruit	fibromyoma	0
flaxseed	brain neoplasm	0
apium graveolens	lens opacity	0
sunchoke	uterine fibroma	0
ranking foods	endometriose	0
chinese cinnamon	atopic diseases	0
oregano plant	polyarthritide	0
brassica	disk degradations	0
buckwheat	reduced sensation	0
common fruits	hemolytic-uremic syndrome	0
golden raisins	als (amyotrophic lateral sclerosis)	0
anana	ph1 negative myelogenous leukemia	0
black walnut	inflammatory disorder	0
whole foods	common bile duct biliary calculi	0
pomegranate seeds	skin cancer	0
chamomile tea	long sleeper syndromes	0
rutabaga	polyarthritis	0
candy bar	endometrial cancer	0
marjoram plants	migratory pains	0
cola acuminata	male sub-fertility	0
healthiest snack	non-epileptic convulsions	0
specific nuts	cancer of the brain	0
vegetable protein	prediabete	0
wheat	precordial catch	0
miso	gall bladder diseases	0
overpriced vitamin	liver steatoses	0
eupatorium rebaudianums	colonic neoplasms	0
citronella	amyotrophic lateral sclerosis-parkinsonism-dementia complex 1	0
arachis	cardiac sudden death	0
filtered coffee	mastodynia	0
nonfat meal	gnathostomiasis	0
cuminum cyminum	tor-driven diseases	0
lycium	arthritide	0
cantaloupe	brain cancer	0
wheat brans	feline leukemia viruses	0
wort	neurodegenerative disorder	0
mother cells	nonorganic insomnia	0
diospyros digynas	experimental parkinsonisms	0
chili pepper	prediabete	0
fagopyrum sagittatum	porcine endogenous retroviruses	0
chenopodium quinoas	hereditary galactokinase deficiency	0
seven nutrients	deaf-mutism	0
plantago	hypermelanose	0
chipotle	avitaminose	0
avocado fruit	bilateral headache	0
worldwide fruit	creutzfeldt jakob disease	0
vegetable juice	kidney neoplasm	0
moose meat	adolescent obesity	0
true nut	penile cancer	0
haritaki fruit	uterus neoplasm	0
unhealthy food	apnea	0
saffron crocus	reticulum cell sarcoma	0
pudding	cancer of vagina	0
maize oils	texidor twinge	0
whole grain cereal	nervous system degenerative diseases	0
canned food	alopecia	0
dried plums	alzheimer’s disease	0
chewing gum	disk degradation	0
garcinia mangostana	fibrous meningiomas	0
sticker	acute monocytic leukemia	0
alpine strawberry	pharyngitis	0
mandarin orange trees	colorectal carcinomas	0
linum usitatissimums	breast fibrocystic changes	0
shan yao	diabetic complication	0
pomegranate fruit	endometrium carcinomas	0
anti-inflammatory plant	brain neoplasm	0
curcuma zedoaria	muscle pain	0
food company	salmonella infections	0
nut bars	leiomyoma	0
milk protein	spiral fractures	0
hemlock	thyroid carcinoma	0
zea mays	diffuse undifferentiated lymphomas	0
largest meal	spinal cord degenerative diseases	0
plantago arenaria	carcinoma	0
althea officinalis	benign neoplasms	0
syzygium sandwicense	psychogenic parasitosis	0
rooibos tea	animal virus	0
grecian foxgloves	spontaneous abortion	0
avenas	alzheimer’s disease	0
soy beans	chronic pain	0
tempeh	thyroid cancers	0
hemp plants	hydrophobia	0
leek	prediabetic state	0
raw foods	pancreatic neoplasm	0
blackberry	multiple head injury	0
soft drinks	non-epileptic convulsion	0
dietary sucrose	insulin dependent diabetes mellitus	0
peppermint oil	v cjd (variant creutzfeldt jakob disease)	0
new vitamin	cancer of the tonsil	0
lemon balms	trochanteric fractures	0
fresh ginger	motor seizure	0
white potatoes	huntingtons disease	0
crave chocolate	prevent and reverse heart disease	0
edible grains	macular degeneration	0
mushroom	microcephaly	0
hibiscus tea	bladder cancer	0
citrus grandis	elevated cholesterols	0
organic meat	oncogenic virus	0
phyllanthus emblicas	autosomal recessive parkinsonism	0
bottled water	complete hearing loss	0
horsemeat	crohn’s disease	0
english walnuts	influenza in humans	0
liquorice	fusiform aneurysm	0
althaea	tactile hypesthesias	0
hot sauce	limb cramp	0
actual fruit	pancreatitis	0
artificially-flavored corn	phage	0
cucumis melo	retroviridae	0
beetroot	minor head injuries	0
oyster mushrooms	soft tissue sarcoma	0
bread	microglandular adenosis	0
mangifera	schilling-type myeloid leukemia	0
high-fat meal	pneumonitis	0
dried apples	crushing pains	0
sweetening agent	tumorigenese	0
veal	colonic neoplasm	0
high fructose corn syrup	sudden cardiac arrest	0
so-called vegetable	precordial catch	0
healthy food	early onset parkinson disease autosomal recessive	0
dietary fat	autistic disorder	0
healthiest foods	breast tumor	0
bt corn	breast carcinomas	0
poppy	thyroid adenomas	0
no-calorie sweeteners	hyperventilation syncopes	0
coconut oil	orthostasis	0
cocoa powders	chronic cluster headaches	0
no coffee	dementia	0
lycopersicon esculentum	liver steatoses	0
pimenta officinalis	intervertebral disk degeneration	0
deep-fry foods	congenital defects	0
currant	craniocerebral injury	0
soy bean curds	postoperative nausea	0
including cloves	single seizure	0
brown rice	leukemia virus	0
healthiest beverage	lymphocytic lymphomas	0
allium cepa	paraesophageal hiatal hernia	0
greenery	venous thrombosis	0
plant kingdom	transmissible spongiform encephalopathy	0
shiitake mushroom	visual seizures	0
papaya	syndrome	0
lima beans	substance addiction	0
aspalathus linearis	carcinogenic retroviruses	0
rosa	post ictal confusion	0
buttermilk	non hodgkin lymphoma	0
woodland strawberries	bovine lymphoma	0
chard	cellulite	0
java plum trees	rest tremors	0
cappari	preterm birth	0
tepary bean	pancreatic neoplasms	0
nori	preventable cancers	0
citrus fruit	abdominal aortic aneurysms	0
green pepper	postural syncope	0
plantain	gehrig's disease	0
anticancer plant	todds paralysis	0
dietary proteins	chronic lymphoblastic leukemias	0
low vitamin	carsickness	0
erythroxylon	pulmonary neoplasms	0
goji berry	semirhythmic tremor	0
food poisonings	exudative bronchiolitides	0
animal food	diffuse undifferentiated lymphomas	0
commercial milk	senile osteoporoses	0
durum wheats	different cancer	0
chili	brain benign neoplasm	0
tomato sauce	retro-ocular headaches	0
ground flax	convulsive syncope	0
phaseolus vulgari	muscle disease	0
barley	hansen disease	0
citrus aurantiifolias	sleep initiation and maintenance disorders	0
table salt	atrioventricular dissociation	0
clathrotropis	gingivitis	0
origanum vulgare	intraventricular meningioma	0
yoghurt	migratory pain	0
foeniculum	autosomal recessive juvenile parkinsonism	0
bitter orange trees	amyotrophic lateral sclerosis with dementia	0
snack foods	spiral fractures	0
measuring food	rectum cancers	0
added nuts	polyarthralgia	0
kawa kawas	new variant creutzfeldt jakob disease	0
bitter orange tree	vagina neoplasms	0
ilex paraguarienses	protein deficiencies	0
croaker	virus	0
agent orange	myocardial failure	0
fresh basil	lymphosarcoma	0
trigonella foenum-graecum	hypermelanose	0
cleistocalyx	cancer of prostate	0
sockeye salmon	auricular fibrillation	0
apricot trees	pustular psoriasis of palms and soles	0
thymus vulgari	dysosmia	0
carica papaya	anhedonia	0
sweet almond	osteoarthrose	0
fuji apples	cerebral strokes	0
aloe	non alcoholic fatty liver disease	0
crocus sativus	amyloidosis	0
opium poppy	gout	0
eggplant	meningiomatosis	0
olive	brain vascular accidents	0
sweet foods	radiating pain	0
added sweeteners	primary gh resistance	0
cannabis	acquired blindness	0
pleurotus ostreatus	grave’s disease	0
sunflower seeds	macular dystrophy	0
curried tofu	undifferentiated carcinoma	0
macadamia	mania	0
porgy	atrioventricular dissociations	0
pepper	amyotrophic lateral sclerosis-parkinsonism-dementia complex 1	0
pumpkin	temporary amnesias	0
basil	crushing skull injuries	0
caryophyllus	disorientation	0
toxic plants	necrotizing fasciitides	0
fatty meal	cataract	0
herbal teas	myelomatosis	0
wine	high-grade lymphoma	0
cocos nuciferas	diabetic mononeuropathies	0
coconut milk	marie-struempell disease	0
soy cheese	transmissible spongiform encephalopathies	0
lemon balm tea	ekbom psychogenic parasitoses	0
dark chocolate	non-epileptic convulsions	0
not-necessarily-so-healthy foods	cataract	0
seafood	dripped virus	0
neutraceutical	disc degradations	0
coca	amaurose	0
bell peppers	circulatory collapse	0
vaccinium myrtillus	barrett metaplasia	0
fava beans	sudden infant death	0
artificial sweeteners	familial tremors	0
natto	cadaver	0
citrus-based fruits	pleomorphic lymphoma	0
mint	gastric acid reflux	0
thymus vulgaris	parasagittal meningiomas	0
chocolate bars	hepatic failure	0
breakfast times	prostatic hypertrophy	0
kava	congenital defects	0
gui zhi	diffuse lymphomas	0
nettle tea	disc degeneration	0
triticum turgidum	cirrhosis	0
include flaxseed	joint diseases	0
pimiento	low back aches	0
orange juice	osteoarthrose	0
broccoli raab	hot flashes	0
sweet potatoes	myalgia	0
prunus cerasifera	mild neurocognitive disorders	0
blueberry	gall stones	0
vitamin pills	gall bladder disease	0
golden delicious apples	abdominal cramps	0
chlorella	scurvy	0
rye	guillaine-barre syndrome	0
eragrostus	mouth neoplasms	0
black raspberries	dyslipoproteinemia	0
capparis	olfactory groove meningioma	0
garlic	familial atrial fibrillation	0
fake meat	disorientation	0
almond butter	sid	0
citrus aurantiifolia	skin neoplasm	0
cultivated oats	cll lymphoplasmacytoid lymphomas	0
strawberry	premature aging	0
cranberry	polyphagia	0
papaver somniferum	benign essential tremors	0
cacao	headache	0
guacamole	preterm birth	0
triticum turgidum subsp. durum	syncopal vertigos	0
pine nuts	cancer of lung	0
poroporo	rectum cancer	0
diabetic diets	uterine cervical cancers	0
nicotiana tabacum	sore throat	0
flavorer	chronic cluster headache	0
whole grain cereals	atherogenesis	0
fragaria	non-hodgkin lymphoma	0
extracted fruit	fibrose	0
powdered ginger	skin neoplasm	0
secale	endometrial carcinomas	0
processing meat	oncornavirus	0
spicy food	primary fibromyalgias	0
halibut	tonic clonic seizures	0
preserved foods	complete blindness	0
yolk	pituitary dwarfism iis	0
poultry products	epithelioid sarcoma	0
bergamot	papillary meningioma	0
canned fruit	primary gh resistance	0
pummelo tree	venous thrombosis	0
dietary soybean proteins	jacksonian seizure	0
hibiscus sabdariffa	galactosemia	0
pyrus	exanthema	0
vaccinium macrocarpons	decreased cancer	0
ale	alopecia cicatrisatas	0
mirobalanus embilicas	visceral steatoses	0
maraschino cherry	creutzfeldt jakob disease	0
drinking water	posterior fossa meningioma	0
caffeinated coffee	body weights	0
plantago indica	retrovirus	0
healthy foods	hair loss	0
navy beans	dissociative amnesia	0
almond oil	acute inflammatory polyneuropathy	0
calling eggs	ciliary body spasms	0
cicer arietinum	salmonellosis	0
whale meat	adenoviridae	0
ground ginger	manic depressive psychosis	0
consumed chocolate	gerd	0
melissa officinalis	hereditary galactokinase deficiency	0
raphanus	necrotizing fasciitides	0
tangerine trees	guam form of amyotrophic lateral sclerosis	0
lipomul	abdominal obesity	0
frequent meals	involuntary quiver	0
syzygium	terminal ileitis	0
exotic fruit	heatstroke	0
low-salt diet	alopecia	0
organ meats	pulmonary cancers	0
ready-prepared foods	crohns disease	0
pecan tree	cognitive declines	0
cucumber	female subfertility	0
golden delicious	coronary heart disease	0
smoked food	drunkenness	0
pumpkin pie	apoplexy	0
jambolan plum trees	human herpesvirus 4	0
cayenne pepper	pneumonitide	0
placenta	rachitis	0
sweet pepper	colonic cancer	0
beer	ph1 negative myelogenous leukemia	0
texturized vegetable protein	galactokinase deficiency	0
burrito	hysterical amnesias	0
infant formula	migratory pains	0
sweet basils	prion-induced disorders	0
oregano plants	porcine endogenous retroviruses	0
flounder	pulmonary inflammation	0
empty calorie foods	psychophysiological insomnia	0
mangifera indica	anal ulcers	0
citrus reticulatas	myeloma-multiple	0
rubberplant	chronic fatigue disorder	0
chenopodium quinoa	malignant primary brain tumors	0
garcinia mangostanas	intraepithelial prostatic neoplasias	0
higher vegetable	sudden infant death	0
marshmallow	oral cancers	0
green lentils	steatohepatitide	0
olive family	physical sufferings	0
soya milk	parkinsonian disorders	0
sugar maple	neurological condition	0
healthiest vegetable	insulin deficiency	0
lemon tree	endometrium carcinomas	0
cream cheese	cluster headache syndromes	0
poultry	penis neoplasm	0
belladonna	paroxysmal atrial fibrillation	0
persimmon	gut dysfunction	0
carya	cognitive dysfunctions	0
table sugar	neurologic degenerative disease	0
carbonated drinks	spondyloarthritis ankylopoietica	0
soy	stokes-adams syncope	0
plant capsule	sclerosis	0
jambolan plum tree	anxiety disorders	0
porphyra	parkinsonian disorders	0
daily nut	mental deteriorations	0
pineapple juice	myocardial infarcts	0
pancake	creutzfeldt jakob syndrome	0
sweet basil	hepatic neoplasms	0
woodland strawberry	fighting cancer	0
plantago ovata	newborn gynecomastia	0
licorice	fibromyalgia-fibromyositis syndromes	0
honeybush tea	brain malignant neoplasms	0
humulus lupulus	colon cancers	0
illicium verum	burn	0
gala apples	infectious virus	0
citrus reticulata	low back aches	0
pease	heart attack	0
nitrate-rich vegetables	mucous colitis	0
hickory nuts	renal insufficiency	0
plant capsules	brain cysticercosis	0
citrus hystrix	blood cancer	0
prunus dulcis	cardiovascular disease	0
chia seeds	liver diseases	0
seville orange tree	myeloid leukemia	0
vitis	drug use disorders	0
anti-inflammatory foods	infantile autism	0
convenience food	common bile duct gallstones	0
vegetable proteins	exanthema	0
amlas	malaria	0
food additives	drug use disorder	0
taking vitamin	neoplasm	0
frozen cranberries	guillain-barré syndrome	0
noni fruit	reticulum-cell sarcomas	0
humulus	utp hexose-1-phosphate uridylyltransferase deficiency	0
baptisia	continuous tremors	0
algarrobo	saturnine tremors	0
longevity legumes	chronic gum disease	0
raw cranberries	vaginal neoplasm	0
morinda citrifolia	hhv-4	0
vicia faba	macular dystrophies	0
pinto bean	myocardial infarctions	0
family vegetables	acute monocytic leukemias	0
boiled broccoli	alopecia	0
euchresta	tubal abortion	0
high-fiber food	protein deficiencies	0
whole grain	central nervous system degenerative diseases	0
cola nitida	rash	0
conventional food	hiatal hernias	0
fenugreek	vulva neoplasm	0
squid	feline leukemia virus	0
banana	galactosemia 3s	0
legume family	olfactory groove meningioma	0
applesauce	human cancer	0
bacon	retrovirus	0
cannabis indicas	constipation	0
french bean plants	congenital abnormality	0
fiddlehead ferns	acquired immuno deficiency syndrome	0
psyllium	endometrial neoplasm	0
raisin	cysticercosis	0
baby formula	female subfertility	0
lycium chinense	retro ocular headache	0
kidney bean	constrictive bronchiolitides	0
chervil	skin disease	0
cocoa plants	metabolic acidoses	0
nutraceutical	cardiogenic syncopes	0
fruit and vegetable juices	brain cancers	0
iv vitamin	skin neoplasms	0
domestic fowl	thrombose	0
vaccinium bracteatums	mammary dysplasia	0
safflower oils	morning sickness	0
weed	multiple sclerosis	0
chickpea	diabetic neuropathies	0
morning meal	wound botulisms	0
sprout	leukemogenic viruses	0
assai palm berries	temporary amnesia	0
gluten	schizophreniform disorder	0
salmonella food	hemicrania migraine	0
bolete	tumor of rete testis	0
kiwi fruits	lower back pains	0
tv dinners	pseudotumor cerebri	0
soft drink	intracranial central nervous system disorders	0
usda poultry	generalized headaches	0
squash plant	weight gains	0
dietary protein	colon disease	0
saffron	gastroesophageal reflux	0
grilled meat	female sterility	0
healthy snack	human influenza	0
barley coffee	ciliary body spasms	0
hibiscus	cognitive retention disorder	0
salami	primary insomnia	0
pisum sativum	penile neoplasms	0
know nuts	gasser's syndrome	0
eragrostis	inherited human transmissible spongiform encephalopathies	0
bad foods	autosomal recessive juvenile parkinsonism	0
hemp	lung cancer	0
adding blueberries	cervicitis	0
elephant garlic	gossypiboma	0
lens plants	action tremor	0
cannabis sativas	xanthomatous meningiomas	0
shiitake mushrooms	ileocolitis	0
individual candy	carotid sinus syncope	0
berberis	protein deficiency	0
coriandrum sativums	action tremors	0
foenumgraecum	delusional parasitosis	0
kola nut	cerebrovascular strokes	0
sweet orange	convulsive seizure	0
punicaceae	muscle spasm	0
cultivated radish	oxygen deficiency	0
soy bean	early infantile autism	0
uncooked food	cancer of cervix	0
glucose-fructose syrup	hepatic cancer	0
cymbopogon	tumor virus	0
fructose corn	cardiovascular strokes	0
contamination meat	dental plaque	0
different fruits	ph1 negative myeloid leukemia	0
stevia rebaudiana	crohn's disease	0
sea bilberries	diffuse mixed-cell lymphomas	0
origanum onites	orthostatic headache	0
blueberry plant	memory losses	0
red peppers	gale deficiency	0
poultry meat	drop attack	0
ocimum basilicum	sprains and strains	0
dried apricots	early detection of cancer	0
hydroponic basil	rectal cancer	0
theobroma cacao	fibrocystic breast disease	0
ilex paraguariensis	microcephaly	0
food poisoning	zoonotic infectious diseases	0
solanum laciniatum	head pains	0
baby formulas	pill rolling tremor	0
marijuana	cancer of the bladder	0
processed foods	marie struempell disease	0
piper methysticums	fifth phacomatoses	0
apricot	huntingtons disease	0
fast foods	terminal ileitis	0
allspice	granulomatous enteritis	0
vicia fabas	constipation	0
plantago seed	endometriose	0
toxic plant	pulmonary neoplasm	0
hordeum vulgare	bovine leukosis	0
animal-based foods	hepatic neoplasms	0
frozen broccoli	myocardial infarcts	0
juglans nigra	germinoblastic sarcoma	0
cinnamomum cassia	diffuse mixed small and large cell lymphoma	0
raw meat	laron type dwarfism i	0
flax	fusiform aneurysms	0
melissa officinali	multiple myeloma	0
guava	memory deficits	0
kiwi fruit	iritis	0
raphanus sativus	neoplasm	0
specific foods	stokes-adams syncopes	0
cuminum cyminums	somatotropin hypersecretion (acromegaly) syndrome	0
rubus	micturition syncope	0
horse nettles	deep-venous thrombosis	0
processed apples	recurrent low back pain	0
petroselinum crispums	leukemogenic viruses	0
citrus maxima	amnesia-memory losses	0
mustard	bovine lymphosarcomas	0
soy protein	perioral tremors	0
cereal grain	metastasis	0
mentha spicata	bacterial vaginitides	0
mangosteen	amyloid plaque	0
healthy nuts	carotid sinus syncope	0
national pork	plasma cell myeloma	0
retail poultry	plasma cell myelomas	0
topical ginger	uterine fibroids	0
areca nuts	manic depressive psychosis	0
spinacia oleracea	common bile duct gall stones	0
sesame	leiomyoma	0
brassica nigra	kanners syndrome	0
steak	semirhythmic tremor	0
organ	esophageal cancer	0
oatmeal	upper respiratory tract infections	0
vaccinium uliginosum	microcystic meningioma	0
fruit juice	chronic infectious mononucleosis like syndrome	0
gmo soybeans	carcinoma in situ	0
inadequate fruit	ekbom delusory parasitoses	0
isoglucose	cancer of the mouth	0
lettuce	fibrocystic breast disease	0
raw garlic	lymphadenopathy-associated virus	0
berry	gangrene	0
food additive	campylobacter infection	0
black walnuts	diffuse mixed-cell lymphomas	0
grape seeds	hemolytic-uremic syndrome	0
green grapes	small lymphocytic lymphomas	0
dried pomegranate	acute myeloid leukemia	0
incorporates cloves	bladder neoplasm	0
lunch times	brain disorder	0
deli meats	malignant meningioma	0
cured meat	infantile autism	0
maguey	low-grade lymphomas	0
euterpe edulis	fibroatheroma	0
chinese cassia	hiatus hernia	0
cicer	papillomaviridae	0
english walnut	avian leukosis/sarcoma virus	0
hordeum	esophagus cancers	0
bitter nightshade	intracranial neoplasms	0
citrus aurantium	cancer of thyroid	0
ready-to-eat meal	infant botulisms	0
acer saccharum	disk degradation	0
fresh meat	lung inflammation	0
english plantain	deep-venous thrombosis	0
carya illinoenses	constrictive bronchiolitis	0
cycad trees	heart decompensation	0
lamb chops	chronic b-lymphocytic leukemias	0
seltzer water	degenerative arthritides	0
coca cola	broken bone	0
prunis communis	parkinsonism	0
bertholletia	age-related maculopathies	0
corn sugar	penile neoplasms	0
fava bean	acute inflammatory polyneuropathy	0
food allergies	gut dysfunction	0
fagopyrum	acromegaly	0
capsicum annuum	carcinomatose	0
carob	cancer of pancreas	0
food supplement	viral disease	0
seltzer waters	deglutitional syncope	0
sesamum	diffuse mixed-cell lymphoma	0
vaccinium virgatum	plasma-cell myeloma	0
refined olive	cancer of the uterus	0
sweetleaf	cat leukemia virus	0
snacktime	breast adenosis	0
walnut oil	condylomata acuminata	0
marsh mallow	cysticercosis	0
fruit juices	serious disease	0
justicia	chronic headache	0
fresh fruits	familial dementia	0
lactuca sativa	sliding hiatal hernia	0
legume pods	autosomal recessive juvenile parkinson disease	0
trigonella	hypercapnia	0
soy sauce	dental diseases	0
eating food	mixed-cell lymphoma	0
saint johns wort	airsickness	0
mustard oil	cancer of cervix	0
paella	syndrome	0
goji berry plants	epimerase deficiency galactosemias	0
mentha piperita	vaginitis	0
hickory trees	anosmia	0
parsley	abdominal obesity	0
espresso	mastalgia	0
acai berry	myeloid leukemia	0
domestic fowls	inflammatory bowel disease	0
papaver	cancer of the testis	0
common foxglove	atheromatous plaques	0
convenience foods	peripheral arterial diseases	0
gum acacia	situational syncopes	0
phytonutrient-rich food	a v dissociation	0
juglan	cancer of liver	0
ribes nigrum	inflammatory bowel disease	0
mother cell	hemolytic jaundices	0
red onions	increased cancer	0
hot pepper	nonspecific vaginitis	0
bean sprouts	creutzfeldt jakob syndrome	0
kohlrabi	amyloid deposits	0
low-fat diet	horton's syndrome	0
alpine strawberries	manic depressive psychosis	0
brinjal	prostatic intraepithelial neoplasia	0
aspalathus	migraine	0
cheese	reproductive sterility	0
nuclear power plants	nonalcoholic fatty livers	0
eugenia sandwicensis	breast malignant tumor	0
lunch time	foreign object	0
flavourer	utp hexose-1-phosphate uridylyltransferase deficiency	0
indian laburnum	back pain with radiation	0
nicotiana tabacums	dental plaque	0
billion eggs	sphenoid wing meningiomas	0
paprika	dementia	0
eugenia aromatica	central nervous system cysticercosis	0
food companies	tactile amnesias	0
energy drinks	clear cell meningioma	0
good soybeans	ciguatera	0
apricot tree	intracranial meningiomas	0
cruciferous vegetable	familial parkinson disease	0
anise	sleep initiation dysfunctions	0
lemon grasses	female sub fertility	0
dairy yogurt	campylobacter infection	0
brassica napus	human mammary neoplasm	0
plum	chest pain	0
sea bilberry	udpglucose hexose 1 phosphate uridylyltransferase deficiency	0
andean blackberry	ph1-negative myelogenous leukemias	0
soy beverage	retained surgical needles	0
foie gras	common bile duct calculi	0
saint john wort	reticulum-cell sarcomas	0
marjoram plant	pustulosis of palms and soles	0
flax seeds	colorectal neoplasms	0
apple	sudden-onset diabetes mellitus	0
cinnamomum trees	dwarfism	0
adhatoda vasica	substance abuses	0
brussel sprout	penile neoplasms	0
psidium	lyme borreliosis	0
crataegus monogynas	skin diseases	0
myristica fragrans	jakob-creutzfeldt syndrome	0
cherry	age related maculopathy	0
herr	pulmonary diseases	0
camomile	hemangiopericytic meningioma	0
brassica juncea	back pain without radiation	0
sea vegetable	lightheadedness	0
pistil	somatotropin hypersecretion (acromegaly) syndrome	0
preserved food	pyrexia	0
roughage	mixed lymphomas	0
hummus	growth hormone receptor defect	0
indian gooseberry	colorectal neoplasms	0
cider vinegar	juvenile-onset diabetes	0
aubergine	malignant primary brain tumors	0
goji berries	polymyositis ossificans	0
citrus medica	hyperemesis gravidarum	0
afzelia	hansens disease	0
ground beef	deglutitional syncopes	0
syzygium jambolanum	age-related memory disorders	0
mastictree	reducing cancer	0
carduus marianus	sudden infant death syndrome	0
fat milk	burkitt's lymphoma virus	0
da huang	action tremor	0
breakfast time	effort syncopes	0
cocoa	multiple head injuries	0
hypericum	pulmonary inflammations	0
allium sativum	hemicrania migraines	0
unrefined plant	endometrial carcinomas	0
unfiltered coffee	dental disease	0
california avocado	lymphoblastic leukemia	0
nutrient-dense foods	prostate cancer	0
coconut	vulva neoplasm	0
treat	neurodegenerative disorders	0
food supplements	cluster headache syndrome	0
okra	cervix neoplasm	0
kale	graves disease	0
mentha x piperita	vagina neoplasm	0
betel nut	renal failure	0
antioxidant-rich foods	respiratory tract infection	0
group foods	postural syncope	0
althaea officinalis	cluster headache syndromes	0
quinoa	cardiac arrhythmia	0
alcoholic beverage	dizzyness	0
frozen spinach	phlebothrombose	0
plum tree	degenerative neurologic diseases	0
tepary beans	breast fibrocystic changes	0
virgin olive	degenerative arthritis	0
squashe	juvenile parkinsonism	0
nonus	endometrial cancers	0
soda water	intraepithelial neoplasms	0
tomato	thinness	0
curry powder	chronic insomnia	0
star anise	passive tremors	0
mustard seeds	painful menstruation	0
sesame oils	ileocolitis	0
roasted almonds	early onset parkinson disease autosomal recessive	0
triticum vulgare	childhood onset obesity	0
white wine	early awakening	0
pureed apples	acute monocytic leukemia	0
cultivated oat	gustatory seizure	0
thymus plants	thermal hypesthesia	0
cayenne peppers	motor seizure	0
fenugreek seed	bronchiolitis obliterans	0
nightshade	juvenile parkinson disease	0
confection	seizure disorder	0
zingiber officinales	child obesity	0
indian gooseberries	right sided heart failure	0
rice milk	sudden cardiac arrest	0
caper	drunkenness	0
high-fructose maize syrup	crib death	0
marjoram	prostatic intraepithelial neoplasms	0
oolong	brain disease	0
antioxidant foods	pneumonia	0
pepsi	fibrocystic breast disease	0
squash	hansen disease	0
shan yaos	myocardial infarcts	0
stevia	familial juvenile parkinsonism	0
breast milks	premenstrual tension	0
concord grape	wart	0
cookie	biliary calculi	0
raw tomatoes	brain benign neoplasm	0
whortleberry	manic depressive psychosis	0
meal time	recrudescence	0
pimenta diocias	disorientation	0
white rice	female subfertility	0
fruit-shaped marshmallows	fine tremors	0
ocimum sanctum	idiopathic intracranial hypertension	0
pretzel	influenza	0
lemon grass	exanthema	0
brain-invasive pork	higher cancer	0
bibhitaki fruit	ph1-negative myelogenous leukemia	0
tarragon	non-hodgkins lymphoma	0
piper nigrum	cerebrovascular accident	0
plaice	drug habituation	0
mangiferas	severe mental disorders	0
poisonous plants	fibromyalgia fibromyositis syndrome	0
energy drink	western diseases	0
neu5gc-rich food	head trauma	0
soy foods	hay fever	0
plant embryo	insulin resistance	0
zucchini	meningotheliomatous meningiomas	0
diabetic diet	endometrial cancer	0
lemon	wart viruses	0
silybum marianum	basal cell epithelioma	0
celeriac	iritis	0
plant zygote	rectal cancers	0
lucerne	vaginal cancers	0
wheat bran	human papillomavirus viruses hpv	0
rooibo	bacteria-eating virus	0
squash seeds	uterine cervical neoplasm	0
acid-binding vegetables	regional ileitis	0
irritable bowel kiwi fruit	substance dependence	0
dark meat	small lymphocytic lymphoma	0
red meats	mild neurocognitive disorder	1
plant zygotes	somatotropin hypersecretion syndrome (acromegaly)	0
crabapple	chronic obstructive airway disease	0
dried cranberries	pattern baldness	0
avoid peanuts	auriculo-ventricular dissociations	0
peach trees	colonic neoplasms	0
cannabi	histamine cephalgia	0
taraxacum officinale	anoxia	0
tea hibiscus	broken bones	0
drinking milk	esophageal cancers	0
machaerium	mucous colitis	0
grapefruit juice	encephalon diseases	0
food allergy	galactose-1-phosphate uridylyltransferase deficiency	0
four nuts	chronic pains	0
weekly meat	endometrial cancer	0
ribe	neurotic anxiety states	0
bhang	marsh fever	0
illicium anisatums	hiccup	0
hemp plant	brain tumors	0
frying foods	neoplasia	0
radicchio	intractable headaches	0
amygdalus communis	stomatognathic diseases	0
medicago sativa	bechterew disease	0
carbonated waters	nonalcoholic fatty liver disease	0
marihuana	endocrine breast diseases	0
hibiscus cannabinus	disc degenerations	0
carbonated water	type 1 diabetes mellitus	0
pummelo trees	diabetic amyotrophy	0
faba beans	pulmonary neoplasms	0
bread mold	cardiogenic syncopes	0
cabbage	cancer of the skin	0
natural vitamin	chronic daily headaches	0
vaccinium macrocarpon	chicken embryo lethal orphan virus	0
ice creams	osteoarthrosis deformans	0
flesh foods	pyorrhea alveolaris	0
maple	copd	0
romaine	nonorganic insomnia	0
high fructose maize syrup	oncovirus	0
sunfish	abdominal pains	0
green peas	syndrome	0
use sweeteners	uterine cervical neoplasms	0
low-calorie diet	arthritide	0
diospyros digyna	tactile amnesia	0
carbonated drink	age-related osteoporoses	0
jell-o	laron dwarfism	0
wild celeries	retained surgical items	0
peach tree	intention tremors	0
root	somatotropin hypersecretion syndromes (acromegaly)	0
chocolate	hansen's disease	0
raw poultry	kidney failures	0
grapefruit	penile cancer	0
tuna fish	arrhythmia	0
nutmeg	mouth neoplasm	0
acer	human mammary carcinomas	0
corn oils	head traumas	0
ovary	bone neoplasms	0
soy proteins	tactile amnesias	0
cycad	postoperative emeses	0
chamomile oils	impaired sensations	0
citrus bergamia	canker sore	0
breakfast cereal	galactosemia 3s	0
apple trees	galactokinase deficiency disease	0
bellis	cramp	0
dietary supplements	cancer of breast	0
handling food	pruritus	0
kombucha teas	rete testis tumors	0
brazil nut tree	amyloid plaque	0
term vegetable	fibrocystic disease of breast	0
dairy products	meningotheliomatous meningiomas	0
national meat	acute inflammatory polyradiculoneuropathy	0
fries	adenomatous polyps	0
triticum	sciatic neuralgia	0
salsa	pustular psoriasis of palms and soles	0
phaseolus	neuritic plaque	0
rose hips	schizophrenic disorders	0
java plum tree	amnesia-memory losses	0
legume pod	congenital defects	0
stryphnodendron	atrial fibrillation	0
candy	hypercapnia	0
pimpinella anisum	hypoxemia	0
frosting	barrett's esophagus	0
thyme	hiatus hernias	0
dioscorea villosa	spinal meningiomas	0
soy beverages	recurrence	0
cucumis melos	vertex headache	0
herbal tea	osteoarthrosis deformans	0
purple grape	tumorigenesis	0
jalapeno pepper	diffuse undifferentiated lymphomas	0
red pepper	insulin-dependent diabetes mellitus 1	0
persea	fibromyositis-fibromyalgia syndromes	0
atropa belladonnas	vulva cancer	0
food manufacturers	ekbom delusory parasitosis	0
dried food	retained surgical sponges	0
psidium guajavas	poultry viruses	0
emblica officinali	nonorganic insomnia	0
capsicum	papillomaviridae	0
stuff	miscarriage	0
corn syrup	rectal cancer	0
rheum rhaponticum	bladder cancers	0
find pork	leucocythaemia	0
garlic sauce	hiccough	0
regular carrots	malignancy	0
sun-dried raisin	excess cancer	0
caramel	creutzfeldt jakob disease	0
trigonella foenum-graecums	ketosis-prone diabetes mellitus	0
tea plant	muscle cramps	0
mastic tree	polyarthralgia	0
fenugreek seeds	glaucoma	0
snail meat	jakob-creutzfeldt syndrome	0
black rice	food-borne disease	0
international nut	precordial catch	0
butter milk	auditory seizures	0
copaifera	somatotropin hypersecretion syndrome (acromegaly)	0
broth	nonorganic insomnia	0
milk chocolate	landry-guillain-barre syndrome	0
flammulina velutipes	myalgia	0
breakfast	cognitive impairment	0
collard green	amnesia-memory losses	0
zedoary zedoarias	chronic headache	0
tea	atypical diffuse small lymphoid lymphoma	0
whole grains	cattle leukemia virus	0
undercooked meat	memory deficit	0
ganja	amaurose	0
zingiber officinale	chicken viruses	0
cherry plum trees	multiple myositis	0
sea-food	parkinson disease	0
turmeric	todd paralysis	0
orange	dims (disorders of initiating and maintaining sleep)	0
health food	neuralgic migraines	0
milk proteins	post-traumatic osteoporoses	0
sweetening agents	sleep initiation and maintenance disorders	0
chicken meat	generalized spasm	0
coleslaw	clear cell meningiomas	0
dried fruits	male impotence	0
wolfberry	type 1 diabetes mellitus	0
veggie	creutzfeldt jakob syndrome	0
eugenia jambos	uterus neoplasm	0
abelmoschus	causes cancers	0
atropa belladonna	dehydration	0
no meat	pyrexia	0
milk thistles	uterine fibroma	0
prosopi	tongue neoplasm	0
cassia fistula	sleeplessness	0
kiwi	ekbom delusory parasitoses	0
lavandula angustifolia	bovine spongiform encephalitis	0
purple potatoes	dna injuries	0
zinger tea	deafness	0
dried yeast	early onset parkinson disease autosomal recessive	0
soy yogurt	fibroadenoma	0
safflower oil	cancer of the bladder	0
foxglove	pyrose	0
almond trees	microlissencephaly	0
brussels sprouts	muscle sorenesses	0
dress	esophagitide	0
abelmoschus esculentus	malignant melanomas	0
prunus salicinas	plasma cell myeloma	0
thousand foods	endometrial cancer	0
tap water	foreign objects	0
amomum cardamomum	burning pain	0
cooked meats	drug habituation	0
kaffir lime	intraepithelial neoplasms	0
beef	renal insufficiency	0
cruciferous foods	degenerative diseases	0
sesame oil	mild cognitive impairments	0
hickory nut	liver dysfunction	0
peach	colon neoplasm	0
larder	venereal wart	0
morinda	reticuloendotheliosis virus	0
betel nuts	dizzyness	0
green peppers	darkness tremors	0
portulaca oleracae	prostatic adenomas	0
include apples	diabetic retinopathies	0
glycine max	udpglucose hexose 1 phosphate uridylyltransferase deficiency	0
safflower	tongue neoplasms	0
yellow vegetables	autistic disorder	0
celery root	fibromyositis-fibromyalgia syndromes	0
chewed coca	polyarthritide	0
andropogon nardus	skin rash	0
antioxidant food	autism	0
sweet marjoram	prostatic hypertrophy	0
chinook salmon	ache	0
monosodium glutamate	cerebral strokes	0
so-called meat	fissure in ano	0
carbonated beverage	senile tremors	0
coconut water	foreign objects	0
healthiest apple	rna tumor viruses	0
box elders	chicken embryo lethal orphan virus	0
bertholletia excelsa	diarrhea	0
prebiotic	kanner syndrome	0
granny smith	torsion fracture	0
soup	chronic lymphocytic leukemia	0
citrus limon	todd paralysis	0
lavender	bechterew's disease	0
whole wheat	multiple head injury	0
cauliflower	cancer of endometrium	0
baked potato	hyperphagia	0
maize oil	retained surgical instrument	0
eden foods	weight losses	0
anise tea	chronic lymphocytic leukemia	0
citron trees	liver dysfunctions	0
prosopis	breast neoplasms	0
japanese plums	pulmonary inflammations	0
green beans	spinal cord disease	0
flaked coconut	endometrium carcinomas	0
earl grey tea	cognitive decline	0
syzygium cumini	head injuries	0
bok choy	joint pain	0
anchovy	headache disorder	0
banana plants	female infertility	0
shorten	excess cancer	0
swiss chard	cancer of penis	0
curcuma	disorientation	0
infant formulas	chronic b lymphocytic leukemia	0
kava kava	painful diabetic neuropathies	0
dinner time	chromosome 6 linked autosomal recessive parkinsonism	0
tomato juice	pulmonary cancers	0
baby carrots	thyroid diseases	0
soy cheeses	autosomal recessive familial parkinson disease	0
rice	post-ictal confusion	0
common bean plant	oxygen deficiency	0
cured meats	acute inflammatory polyradiculoneuropathy	0
diospyro	familial atrial fibrillation	0
cumin	craniocerebral traumas	0
toronja	rupture	0
eating eggs	cancer of thyroid	0
dripping	morning sickness	0
cooked meat	johne's disease	0
frier	ekbom delusory parasitosis	0