
black sapote	heatstroke	0
piper methysticums	occipital region traumas	0
melissa	auditory seizures	0
iv vitamin	malignant neoplasm of breast	0
dasheen	cancer of the skin	0
anacardium	tonsil cancer	0
piper methysticum	atrioventricular dissociation	0
chewed coca	amyotrophic lateral sclerosis-parkinsonism-dementia complex 1	0
fragaria vesca	pancreatitide	0
cod	well-differentiated lymphocytic lymphomas	0
philadelphia cream cheese	colon cancers	0
turmeric root	gut dysfunction	0
orange tree	precordial catch syndrome	0
soy proteins	prion protein diseases	0
mother cells	small round structured viruses	0
citrus hystrix	lav-htlv-iii	0
lens culinaris	basal cell nevus syndrome	0
illicium verums	barrett metaplasia	0
collard green	bacteria-eating viruses	0
fat milk	bleed	0
belladonna	arthralgia	0
dinner	fibromyalgia-fibromyositis syndromes	0
so-called meat	cancer of uterus	0
brassica juncea	diabetic complications	0
kawa kawa	spondylitis ankylopoietica	0
cinnamomum trees	disorder	0
maize oil	todd's paralysis	0
frying foods	oxygen deficiency	0
food manufacturers	wheat allergy	0
plant capsules	viral disease	0
fat foods	coronary diseases	0
punicaceae	transient blindness	0
canned foods	celiac disease	0
venison	acute inflammatory polyneuropathy	0
grecian foxglove	ductal carcinomas	0
skim milk	liver disease	0
fresh ginger	angiomatous meningioma	0
allium cepa	diabetes related complications	0
daily fruit	paroxysmal atrial fibrillations	0
solanum	gastric cancers	0
tea hibiscus	lung cancer	0
true nut	human papillomavirus virus	0
hot sauce	kidney disease	0
tofu	vaginitis	0
thymus plants	low-grade lymphomas	0
carbonated drink	papillary meningiomas	0
green teas	age related maculopathies	0
cayenne pepper	breast tumor	0
fruit and vegetable juices	foodborne diseases	0
prunus domestica	gale deficiency	0
bellis	delusory parasitosis	0
rosehip	kidney neoplasms	0
texturized soy proteins	huntington’s disease	0
whole grains	udp galactose 4 epimerase deficiency disease	0
chipotle	colon neoplasm	0
broth	rachitide	0
sweet pepper	brain cancer	0
raw garlic	subtrochanteric fractures	0
replenish nutrients	mastitis	0
pimenta diocia	diabetic neuralgias	0
triticum turgidum	hypoxemia	0
vegetable juice	aortic aneurysms	0
citrus	leukovirus	0
white mallow	shock	0
anise seed	muscle spasm	0
secale cereale	tonsil neoplasm	0
peppermint	essential tremor	0
holy basil tea	galactosemia 3	0
mangosteen	high cholesterol level	0
cooked carrots	cancer of the lung	0
avena	persistent tremor	0
herr	gustatory seizure	0
kenaf	androgenic alopecias	0
cinnamomum verum	reticulum-cell sarcoma	0
incorporates cloves	colon neoplasm	0
soy food	oncornavirus	0
horse nettles	different cancer	0
thymus vulgari	multiple head injuries	0
natural vitamin	faint	0
rubberplant	endometrium carcinomas	0
berberi	lactose malabsorption	0
nutmeg	barretts syndrome	0
marihuana	spindle-cell carcinomas	0
deep-fried foods	uterine cervical cancers	0
food and drug administration	breast fibrocystic changes	0
food additives	amyotrophic lateral sclerosis parkinsonism dementia complex 1	0
brussel sprout	dysosmia	0
vaccinium bracteatum	primary gh resistance	0
espresso	paroxysmal atrial fibrillation	0
cucumis melos	spindle cell carcinoma	0
maraschino cherry	hepatic cancer	0
english walnuts	enterocele	0
fruit juices	chronic b-lymphocytic leukemia	0
eupatorium rebaudianums	variant creutzfeldt-jakob disease	0
elettaria	early-onset parkinsonism	0
purslane	essential tremors	0
chicken salad	male impotence	0
yeast rice	cysticercose	0
carbonated mineral water	acne vulgaris	0
malus domestica	stokes-adams syncopes	0
syzygium malaccense	intervertebral disc degenerations	0
pithecellobium	male sterility	0
catfish	contusion	0
ice cream	age related osteoporosis	0
barley	hepatic neoplasms	0
rowanberry	basal cell epithelioma	0
food additive	sliding hiatal hernia	0
eating fruits	clear cell meningioma	0
pleurotus	gluten-sensitive enteropathies	0
alpine strawberry	metastasis	0
lens plant	spiral fractures	0
persimmon	diverticula	0
justicia	psychotic disorders	0
different fruits	pancreas cancers	0
frequent meals	cancer of tongue	0
snacktime	melanoma	0
sticker	disorders of initiating and maintaining sleep	0
use sweeteners	anxiety disorders	0
cicer arietinum	deep venous thromboses	0
glucose-fructose syrup	acquired immunologic deficiency syndrome	0
corn	liver neoplasm	0
vitamin pills	benign intracranial hypertension	0
ocimum basilicums	hortons syndrome	0
nutriceutical	death	0
psidium guajava	numbness	0
vitis vinifera	variant creutzfeldt-jakob disease	0
vital nutrients	galactose-1-phosphate uridyltransferase deficiencies	0
lemon tree	crushing pain	0
red delicious apples	brain cancers	0
plant zygote	necrotizing fasciitides	0
opium poppy	cancer of the mouth	0
coconut milk	visceral steatoses	0
ganja	hemolytic uremic syndrome	0
celery	water borne hepatitis	0
food supplement	galactokinase deficiency diseases	0
raw tomatoes	high-grade lymphoma	0
silybum marianums	reticuloendotheliosis virus	0
marjoram	bone fractures	0
flounder	migraine headache	0
avena sativa	muscle tenderness	0
sustenance	autosomal dominant juvenile parkinson disease	0
dioscorea	saturnine tremor	0
artificial butter	low-grade b-cell malignancy	0
cured meats	thyroid carcinomas	0
solanum dulcamaras	tactile amnesia	0
andean blackberries	prion diseases	0
poultry	esophagitide	0
lucerne	ciguatera poisonings	0
health nuts	galactosemia iiis	0
amomum cardamomum	spindle cell sarcoma	0
healthiest nuts	todds paralysis	0
cannabis indicas	liver failure	0
processed apples	carcinogenic retroviruses	0
radicchio	parodontosis	0
chile peppers	bone neoplasm	0
woodland strawberries	primary brain neoplasms	0
monosodium glutamate	endocrine breast diseases	0
cooked meats	splitting pains	0
health food	crushing skull injury	0
healthier meat	cancer of vulva	0
smoked foods	hypoesthesia	0
split pea	nonalcoholic steatohepatitis	0
crunch berries	prostatic intraepithelial neoplasm	0
energy drinks	coronary heart disease	0
foxglove	bacteria-eating viruses	0
chamomile oil	early detection of cancer	0
so-called vegetable	leukemogenic virus	0
emblica officinali	cancer of the ovary	0
dried apricots	severe congenital microcephalies	0
snack foods	paraesophageal hiatal hernia	0
cappari	hhv-4	0
guava	osteoarthrosis	0
glycyrrhiza glabra	weight reduction	0
pistachio	type c oncoviruses	0
carica papayas	delusory parasitoses	0
different seed	nonhodgkin's lymphoma	0
millet	joint pains	0
cucumber	bacterial infections	0
ale	schizophrenic disorders	0
thymus	age-related maculopathies	0
curcuma	blindness	0
broccoli	rest tremors	0
sockeye salmon	colorectal cancers	0
curcuma zedoarias	eye disease	0
preserved food	central nervous system intracranial disorders	0
own vitamin	diffuse mixed-cell lymphoma	0
eden foods	monocytic leukemia	0
myristica fragran	darkness tremor	0
sun-dried raisin	benign intracranial hypertension	0
sugar substitute	intervertebral disk degeneration	0
fatty foods	malignant meningiomas	0
filtered coffee	foreign body	0
mint tea	penis neoplasms	0
indian corn	contusion	0
agave	cva (cerebrovascular accident)	0
citrus grandis	canker sores	0
bottled water	cephalgia	0
gala apples	manic state	0
food coloring	galactose-1-phosphate uridylyltransferase deficiency	0
dark meat	gestational diabetes mellitus	0
plantago ovata	oral cancers	0
garcinia mangostana	anxiety disorders	0
healthier foods	limb tremors	0
breakfast time	salami brusher's disease	0
oolong tea	lung diseases	0
brazil nuts	acromegaly	0
shiitake mushrooms	hypermelanose	0
kiwi fruit	multiple sclerosis	0
ovary	renal calculi	0
vegetarianism	osteoporosis	0
cucumis sativus	muscle tremor	0
ribe	hypolactasia	0
red onions	diffuse mixed small and large cell lymphoma	0
concord grape	texidor twinge	0
boiled broccoli	microcystic meningiomas	0
collard greens	degenerative neurologic disease	0
pecan tree	breast fibrocystic changes	0
sea bilberries	pill rolling tremors	0
zedoary zedoaria	paraosmia	0
star anises	progressive disorder	0
olive trees	acquired immunodeficiency syndrome virus	0
horse nettle	non-b hepatitis enterically-transmitted non-a	0
almond	esophagitis	0
soy foods	visceral obesities	0
trace mineral	open head injuries	0
maize oils	hypovolemic shock	0
ocimum basilicum	testicular neoplasm	0
club soda	crushing pains	0
extracted fruit	posterior compartment low back pain	0
sugar substitutes	b-cell leukemia	0
cantaloupe	neoplasm metastases	0
glucose fructose syrup	neuritic plaques	0
carrot	prostatic cancer	0
fungus	galactose-1-phosphate uridyl-transferase deficiency disease	0
squash seeds	malignant primary brain neoplasms	0
chinese cinnamon	crushing pain	0
plantago psyllium	male breast cancer	0
shiitake	low backache	0
gum acacia	bladder diseases	0
machaerium	colorectal carcinoma	1
cooking meat	arrythmia	0
fortify milk	norwalk like viruses	0
fava bean	undifferentiated lymphoma	0
weed	sharp headaches	0
dietary proteins	hemangioblastic meningioma	0
rabbit meat	pancreas cancers	0
euterpe edulis	periadenitis mucosa necrotica recurrens	0
pistil	esophageal neoplasms	0
sugary foods	pulmonary cancers	0
incorporate cloves	menstrual disorders	0
mesquite	enzootic bovine leukoses	0
psidium	breast adenosis	0
common olive trees	primary malignant brain tumors	0
baby carrots	heart disease	0
watermelon	senile tremors	0
miso	udpglucose hexose 1 phosphate uridylyltransferase deficiency	0
beetroot	parkinsonian syndromes	0
octopus	neuritic plaque	0
prenatal vitamins	parodontose	0
cocos nucifera	atypical cluster headache	0
shellfish	cervix neoplasms	0
peanut butter	clear cell meningiomas	0
sweetening agents	diabetic autonomic neuropathy	0
soup	ulcerative colitis type inflammatory bowel disease	0
syzygium cumini	posterior compartment low back pain	0
decrease meat	menstrual pains	0
know nuts	diffuse lymphoma	0
cranberry juice	atopic disease	0
phyllanthus emblicas	thermal hypesthesias	0
linum usitatissimum	cancer of the prostate	1
chile pepper	sudden cardiac arrests	0
stem vegetables	bacterial vaginoses	0
olive family	disseminated sclerosis	0
lemongrass	fibroatheromatous plaques	0
infant formulas	human mammary carcinoma	0
japanese plums	ciguatera fish poisoning	0
pyrus	cardiovascular disease	0
rooibos	creutzfeldt jakob syndrome	0
english walnut	anticancer	0
hickory tree	inflammatory demyelinating polyneuropathy	0
hickory trees	mesothelioma	0
rheum tanguticum	osteoporosis	0
turmeric	diabetic neuropathy	0
squash plant	low back pains	0
healthiest fruits	sore throat	0
flavoring	broken bones	0
healthiest apple	ovary cancer	0
eating almonds	intraventricular meningioma	0
safflower	cll lymphoplasmacytoid lymphoma	0
cardamon	cardiogenic syncope	0
mother cell	diffuse lymphoma	0
apple trees	osteoarthrosis	0
mushroom	lymphocytic leukemia	0
chewing gums	confusional states	0
offal	lung inflammations	0
banana plant	gastric acid reflux disease	0
food supplements	drop attack	0
jerusalem artichokes	cancer of the testes	0
high-fructose corn	iritide	0
kava kava	kanner syndrome	0
domestic fowls	experimental parkinson disease	0
papaver	polymyositide	0
frozen spinach	jakob creutzfeldt disease	0
new york coalition for healthy school food	degenerative arthritides	0
soy cheese	steatosis of liver	0
hot pepper	galactosemia	0
cacao	chronic b-lymphocytic leukemias	0
high fructose maize syrup	hepatic failure	0
probiotic	brain vascular accidents	0
wild bananas	autosomal recessive parkinsonism	0
golden glow	age related maculopathy	0
fermented foods	superficial head injuries	0
suggesting apple	action tremors	0
prosopis	psychosis	0
crocus sativus	atypical cluster headaches	0
common bean plants	low-grade lymphomas	0
flammulina velutipes	reticulum-cell sarcoma	0
cycad	recrudescence	0
morinda	tumor	0
kawa kawas	deglutitional syncope	0
glycine max	bowel diseases	0
alfalfa sprouts	uterine cervical neoplasms	0
snack	drug dependence	0
broad beans	atherosclerosis	0
seed	degenerative arthritis	0
spice saffron	hip fractures	0
algarrobo	diffuse well differentiated lymphocytic lymphoma	0
regular carrots	vestibular seizure	0
malabar-nut	back aches	0
java plum tree	penile cancers	0
official vitamin	hypoxemia	0
steak	olfactory groove meningioma	0
citrullus	primary fibromyalgias	0
bread mold	lyme arthritis	0
açai berry	cancer of the vagina	0
apple tree	involuntary quiver	0
honeybush tea	thermal hypesthesias	0
pummelo tree	jaundice	0
dairy yogurt	galactosemia iiis	0
eugenia sandwicensis	hysterical amnesia	0
yerba mate	campylobacter infection	0
burrito	polyp	0
club sodas	global amnesia	0
iceberg lettuce	shock	0
fig	post-traumatic osteoporoses	0
california avocado	postural low back pain	0
plant zygotes	sinusitide	0
prettiest fruit	autoimmune condition	0
billion eggs	lyme disease	0
anticancer plant	diabetes complication	0
laciniate nightshade	gastric neoplasms	0
mustard seeds	small noncleaved cell lymphoma	0
andean blackberry	acquired immunodeficiency syndromes	0
mustard greens	mouth and tooth diseases	0
shan yao	polyradiculoneuritis	0
plantago	sleep wake disorders	0
drinking water	gnathostoma infection	0
citrus fruit	cancer of ovary	0
yerba mates	lung inflammation	0
oryza	chronic obstructive pulmonary disease	0
jalapeno	cephalgia	0
high fructose corn syrup	diarrhea	0
orange juice	diffuse undifferentiated lymphoma	0
chili pepper	gasser syndrome	0
consumer protection scientific committee on food	norwalk-like viruses	0
anti-inflammatory plant	oxygen deficiencies	0
greenery	leukemogenic virus	0
black currant	anoxia	0
coconut water	degenerative neurologic disease	0
pistacia vera	olfactory groove meningioma	0
flammulina	migraine	0
açai berries	endocrine breast diseases	0
healthiest foods	pulmonary neoplasms	0
mashed potatoes	cancer of cervix	0
laudable legume	diabetic autonomic neuropathies	0
dried yeast	sprue	0
acer	mastitis	0
faba bean	postviral fatigue syndromes	0
cinnamon	e-b viruses	0
beta vulgaris	postpartum sterility	0
musa	mild cognitive impairment	0
solanum laciniatums	lyme borreliosis	0
pie	thyroid neoplasms	0
french fries	stroke	0
healthy food	ischemic heart disease	0
horsebean	osteoporose	0
dried foods	well differentiated lymphocytic lymphoma	0
carica papaya	tremor	0
walnut	muscular cramp	0
sandwich	cervical migraine syndrome	0
zucchini	pustular psoriasis of palms and soles	0
chocolate pudding	familial tremor	0
fennel	rodent ulcer	0
weekly meat	hemangioblastic meningioma	0
animal-based foods	renal neoplasms	0
ready prepared foods	bacterial infection	0
arugula	acute monocytic leukemias	0
golden delicious apples	diarrhea	0
junk foods	reactive confusion	0
sausage	chromosome 6-linked autosomal recessive parkinsonism	0
jam	burning pain	0
poultry product	diverticulum	0
ground flax	hypertension	0
mint	cat leukemia viruses	0
poisonous plants	occipital trauma	0
crave chocolate	human papillomavirus virus	0
pasta	virus diseases	0
pear	experimental parkinsonisms	0
cider vinegar	body weights	1
marshmallow	endometrium cancer	0
chamomile oils	neurotic anxiety state	0
citrus aurantiifolias	contagious ecthyma	0
almond milk	ruptured appendicitis	0
healthiest snack	gastric ulcers	0
açaí berries	hepatocellular cancer	0
kava	vestibular seizures	0
gui zhi	male breast carcinoma	0
afzelia	guam disease	0
pomegranate seeds	retained surgical instrument	0
organic milk	anticancer	0
plantain	weight gains	0
ocimum sanctum	paraesophageal hiatal hernias	0
medicago sativa	block cancer	0
eragrostis	urinary bladder diseases	0
tomato sauce	migratory pains	0
unhealthy food	allergy	0
tea leaves	action tremors	0
raw food	schizoaffective disorders	0
garcinia mangostanas	urinary tract infections	0
ultra-processed food	convulsive syncopes	0
lunchtime	dysmenorrhea	0
cocoanut	coronary disease	1
maple	light-headedness	0
mastictree	androgenic alopecia	0
tree nuts	intervertebral disk degenerations	0
coriandrum	guillain-barre syndrome	0
veal	anal ulcer	0
calendula officinalis	encephalon disease	0
confection	lymphadenopathy associated virus	0
avocado	perioral tremor	0
coffee	oncogenic virus	0
saccharomyces cerevisiae	disc degenerations	0
popular fruits	fibrocystic mastopathy	0
nettle tea	oral neoplasm	0
english plantain	endocrine breast diseases	0
unfertilized eggs	degenerative intervertebral disc	0
cooked tomatoes	diabetic mononeuropathy	0
mandarin orange trees	polyp	0
tuna	substance use disorder	0
cymbopogon	precordial catch	0
english plantains	male subfertility	0
seven nutrients	nonhodgkin lymphoma	0
vegetable oil	barretts esophagus	0
lentinus edodes	psychotic disorders	0
sweet marjoram	diabetes-related complications	0
daucus carota	bladder neoplasm	0
seafood	postoperative nausea and vomiting	0
citrus maxima	penile cancers	0
acai berries	hyperthermia	0
sour orange tree	migraine variant	0
barley coffee	senile paranoid dementia	0
carbonated water	acute autoimmune neuropathy	0
durum wheat	baldness	0
wheat	clonic seizures	0
almond oil	intestinal diseases	0
pineapple juice	manic disorder	0
vaccinium myrtillus	bone neoplasm	0
foeniculum vulgares	semirhythmic tremors	0
irritable bowel kiwi fruit	neurodegenerative disease	0
mastic trees	gastric neoplasm	0
granny smith	chronic illnesses	0
green beans	obesity	0
acacia tree	chronic lymphocytic leukemia	0
dried apples	dysfunction	0
common plant	sliding hiatal hernia	0
sugar maples	udpglucose 4-epimerase deficiency disease	0
horse beans	neoplasm metastasis	0
petroselinum crispum	stokes-adams syncope	0
fast foods	somatotropin hypersecretion syndrome (acromegaly)	0
raphanus sativus	human mammary neoplasm	0
cranberry	breast malignant neoplasm	0
narrow-leaved plantain	sleep disorder	0
justicia adhatoda	weight losses	0
willow tree	vaginal neoplasms	0
cauliflower	pharyngitis	0
black teas	arterial fatty streaks	0
triticum durum	cervical cancer	0
tisane	environmental cancer	0
mentha spicatas	inflammatory demyelinating polyneuropathy	0
licorice	contagious ecthyma	0
safflower oil	lou gehrig disease	0
soy bean curd	bechterew disease	0
anchovy	cancer of bone	0
roasted almonds	chronic pain	0
corn syrup	psychogenic parasitosis	0
cacao bean	generalized seizures	0
solanum tuberosum	malignant melanomas	0
baptisia	nephrolith	0
kombucha tea	ache	0
soy bean	serious disease	0
mirobalanus embilicas	vertiginous seizures	0
cola	hansen's disease	0
raw alfalfa	syndrome	0
lard	acute monocytic leukemias	0
chilli pepper	botulism	0
decaffeinated tea	periorbital headache	0
food pyramid	cancer of thyroid	0
sesame oil	bipolar affective psychosis	0
black walnut	lymphatic sarcomas	0
floret	carcinogenesis	0
drinking tea	malignant neoplasm of breast	0
cold-steeping tea	cancer of the mouth	0
illicium	weight losses	0
pumpkin seeds	cough	0
jambolan plum trees	ocular headache	0
acai berry	colorectal carcinoma	0
supper	back ache	0
breakfast	marsh fever	0
organic meat	acute monoblastic leukemias	0
purple cabbage	inflammatory bowel diseases	0
dietary soybean proteins	arterial dysfunction	0
nonfat meal	recurrence	0
porgy	mucous colitides	0
taro	dysosmia	0
currant	post-ictal confusion	0
purine-rich plant	micturition syncope	0
cuminum cyminum	hysterical amnesia	0
retail meat	insulin sensitivity	0
fenugreek seed	pulmonary cancer	0
citrus sinenses	severe mental disorders	0
kangaroo meat	disseminated sclerosis	0
marjoram plant	osteoarthritide	0
crab apples	galactokinase deficiencies	0
black coffee	colonic neoplasms	0
butter	early detection of cancer	0
plantago lanceolata	auto-immune diseases	0
candy bars	kill cancer	0
healthy foods	thermal hypesthesia	0
cinnamomum aromaticum	prediabetic state	0
poenumgraecum	breast dysplasia	0
persea americana	dental disease	0
aloe	saturnine tremors	0
ficus	cardiac failure	0
calendula	mild neurocognitive disorder	0
red tea	chronic diseases	0
biometal	regional ileitis	0
last meal	hansens disease	0
sunchoke	common bile duct calculi	0
soda waters	transient blindness	0
tomato juice	widespread chronic pains	0
camomile	paroxysmal atrial fibrillations	0
ready-to-eat meals	landry-guillain-barre syndrome	0
morning meals	rete testis tumors	0
althaea officinalis	endometrium cancers	0
nuclear power plant	idiopathic parkinson's disease	0
clove	dyslipoproteinemia	0
pimpinella anisums	soft tissue sarcoma	0
sugar water	anticancer	0
nutraceutical	frontal region trauma	0
deep-fry foods	visceral obesities	0
larder	spinal meningiomas	0
grape seeds	bipolar affective psychosis	0
dried pomegranate	deficiency disease	0
dog rose	dna injury	0
cinnamomum zeylanicum	chicken virus	0
american meat	xanthomatous meningiomas	0
lunch times	germinoblastic sarcoma	0
black walnuts	generalized seizures	0
kiwi	udpglucose hexose-1-phosphate uridylyltransferase deficiency	0
little meat	tactile amnesias	0
eggnog	cancer of vulva	0
tap water	seizure	0
origanum majorana	chronic insomnia	0
drink tea	cancer of the liver	0
goji berry plants	saturnine tremors	0
include apples	episodic cluster headaches	0
horsemeat	spasm	0
cassia trees	osteoporose	0
convenience foods	autistic disorder	0
punica granatum	head traumas	0
cilantro	gynecomastia	0
lunch time	hypercapnia	0
rooibos tea	small-cell lymphomas	0
whale meat	ovary cancer	0
mangifera	celiac disease	0
capsicum	premenstrual syndromes	0
tepary bean	cardiogenic syncope	0
brassica napus	penile neoplasm	0
herbal teas	cancer of the colon	0
processed foods	pharyngitide	0
pork	developed cancer	0
petroselinum crispums	cancer of the penis	0
store licorice	male subfertility	0
shorten	flatulence	0
citrus medica	common bile duct biliary calculi	0
salmonella-infected eggs	early onset parkinsonism	0
triticum	subacute spongiform encephalopathy	0
soy milk	human t lymphotropic virus type iii	0
dioscorea villosa	rhabdomyolysis	0
squash	generalized headaches	0
dairy eggs	uterine cancers	0
vodka	global amnesia	0
triticum vulgare	infant obesity	0
cinnamomum cassia	barrett's syndrome	0
cocktail	bovine leukosis	0
phaseolus acutifolius	bladder tumor	0
holy basils	aura	0
carbonated mineral waters	sleep disorders	0
assai palm berries	malignant lymphoma	0
rubus fruticosus	non b hepatitis enterically transmitted non a	0
collard	mild cognitive impairments	0
pepper	arthritide	0
coriandrum sativums	diabetic neuropathies	0
citrus paradisi	intraorbital meningiomas	0
oregano plant	breast cancers	0
tuna fish	pseudocoma	0
trigonella foenum-graecums	kidney failures	0
avenas	human immunodeficiency viruses	0
worldwide fruit	toxic megacolon	0
hypericum	somatotropin hypersecretion syndromes (acromegaly)	0
agent orange	malaria	0
dinner time	norovirus	0
zingiber officinale	hemangioblastic meningioma	0
white tea	aortic aneurysms	0
corylus	insomnia	0
citronella	parkinson disease 2	0
black rice	bruise	0
indian laburnums	non b hepatitis enterically transmitted non a	0
cranberry sauce	cancer-causing viruses	0
largest meal	auto-immune disease	0
include flaxseed	deep vein thromboses	0
no-calorie sweeteners	light-headedness	0
carduus marianus	insulin deficiency	0
milk protein	back pain with radiation	0
food companies	gluten enteropathy	0
cicer	non alcoholic fatty liver disease	0
whole grain cereal	polyphagia	0
unfiltered coffee	infant obesity	0
pickled foods	contagious pustular dermatitides	0
lemon grass	parietal region trauma	0
cardamom	breast cancers	0
dietary fat	esophagitis	1
ilex paraguariensis	anaplastic carcinomas	0
baby formulas	idiopathic polymyositis	0
bitter nightshades	pregnancy pernicious vomiting	0
pea families	udp-galactose-4-epimerase deficiency disease	0
whole grain cereals	olfactory groove meningioma	0
milkshake	temporal region trauma	0
tomato	blood cancers	0
feather meal	prion induced disorder	0
leek	upper respiratory infections	0
whiting	arthrosis	0
abelmoschus	breast adenosis	0
citrus hystrices	severe mental disorders	0
lemon trees	endotoxemia	0
chinese yam	female infertility	0
warm milk	diabetes complication	0
chenopodium quinoas	exudative bronchiolitides	0
humulus lupulus	chronic fatigue-fibromyalgia syndromes	0
buttermilk	thyroid cancer	0
citron trees	pustulosis palmaris et plantaris	0
pumpkin pie	back aches	0
exotic fruits	age related maculopathy	0
liquor	hemicrania	0
plant embryos	marek's disease virus	0
anacardium occidentales	numbness	0
contamination meat	age-related maculopathy	0
veggie	human herpesvirus 4 (gamma)	0
hashish	prediabetic states	0
dessert	itch	0
curcuma longas	acute inflammatory polyradiculoneuropathies	0
rooibo	foodborne disease	0
arachis hypogaea	philadelphia-negative myeloid leukemias	0
scrambled eggs	vulvar cancers	0
isoglucose	airsickness	0
trompillo	jacksonian seizure	0
hawthorn	oral neoplasms	0
roselle	splitting pains	0
holy basil	involuntary quivers	0
grilled meat	polyarthralgia	0
aspalathus linearis	pruritus	0
syrup	sarcopenia	0
real chocolate	malignant meningiomas	0
squash plants	skin disease	0
red rice	cardiac diseases	0
wheat brans	disc degradations	0
tv dinners	male sub fertility	0
brewage	multiple myositides	0
banana	verruca	0
olea	olfactory groove meningioma	0
pumpkin	diabetic polyneuropathies	0
fenugreek seeds	diabetic asymmetric polyneuropathies	0
cucurbita	gluten sensitive enteropathy	0
humulus	human immunodeficiency virus	0
yellow vegetables	weight reductions	0
peach trees	age-related osteoporoses	0
apium graveolens var. dulce	gluten enteropathies	0
dried food	convulsion	0
allspice	sudden-onset diabetes mellitus	0
juglans nigra	craniocerebral trauma	0
oregano	fights cancer	0
white wine	crohn's disease	0
carbonated waters	joint pain	0
no noni	familial tremor	0
edible grains	esophagus cancers	0
areca catechus	nbcc	0
seltzer water	gorlin syndrome	0
frozen broccoli	amnesia-memory losses	0
lipomul	colicky pains	0
new vitamin	cancer of the uterus	0
plant aril	common cancers	0
taking vitamin	goiter	0
solanum melongenas	starvation	0
table salt	prostatic adenoma	0
fresh basil	migratory pain	0
sweet orange	ovarian neoplasm	0
sweetleaf	diabetes mellitus complication	0
cured meat	corpse	0
stuff	tongue neoplasms	0
empty calorie foods	benign prostatic hyperplasia	0
spore	amyloidosis	0
longevity legumes	varice	0
white potatoes	colon disease	0
french bean plant	grippe	0
common olive tree	b cell leukemia	0
pizza	verruca	0
fruit-shaped marshmallows	parkinson disease 2	0
amlas	liver injury	0
sea-food	small non-cleaved-cell lymphomas	0
ranking foods	deep-venous thromboses	0
raw meat	tactile amnesia	0
nut bars	single seizures	0
rosa	male sub fertility	0
exotic fruit	chronic fatigue disorders	0
assai palm	kidney cancers	0
sesame	darkness tremor	0
digitalis purpurea	tying disease	0
cultivated radish	sclerosis	0
lentil	malignant lymphomas	0
whipped cream	hemicrania migraine	0
oryza sativa	breast cystic diseases	0
osmanthus	lung neoplasms	0
curried tofu	migraine disorder	0
carrot juice	memory losses	0
reason food	saturnine tremor	0
papaya	chronic fatigue disorders	0
hypericum perforatum	deaf mutism	0
maize syrup	lymphocytic leukemia	0
sunfish	syncopal vertigos	0
raisin	salmonella infections	0
secale	anaplastic carcinoma	0
aquatic food	sick headaches	0
drinking coffee	pancreatitis	0
adding blueberries	disk degradation	0
solanum melongena	menstrual pain	0
plant embryo	upper respiratory tract infections	0
apple juice	ischemic heart disease	0
leaf lettuce	delusory parasitoses	0
lens culinari	type c oncoviruses	0
garbanzo	passive tremors	0
red lentils	gallbladder disease	0
ceratonia	parkinsonism	0
cabbage	arthrosis	0
dried fruits	testis cancers	0
agaricaceae	renal failure	0
abelmoschus esculentus	human papillomavirus viruses	0
alcohol	kill cancer	0
emphasize plant	vulvar neoplasm	0
chanterelle	ph1-negative myeloid leukemia	0
saint johnswort	hot flashes	0
hibiscus tea	sleep initiation and maintenance disorders	0
faba beans	gehrig disease	0
red meats	recurrence	1
seltzer waters	newborn gynecomastia	0
pease	manic-depressive psychoses	0
zingiber officinales	infectious mononucleosis virus	0
hemp plant	atrophy	0
antioxidant-rich food	food hypersensitivities	0
saint john wort	virus disease	0
triticum aestivum	nafld	0
neu5gc-rich food	myelogenous leukemia	0
turkey meat	hypoascorbemia	0
processing meat	atherosclerosis	0
ketchup	endometriose	0
illicium anisatums	schizoaffective disorders	0
solanum laciniatum	intracranial neoplasms	0
bolete	cerebrovascular accidents	0
buckwheat	regional enteritis	0
prunus armeniaca	widespread chronic pains	0
crabapple	creutzfeldt-jakob syndrome	0
low-sodium diet	guillain-barré syndrome	0
paprika	malignant primary brain tumors	0
eugenia caryophyllata	milk sugar intolerance	0
plant-based nutrients	mad cow diseases	0
sparkling waters	cancer of the skin	0
norus	colonic cancer	0
crocus	hansen's disease	0
organ	long sleeper syndrome	0
soda pops	torsion fractures	0
alpine strawberries	senile tremors	0
herb	parkinson's disease	0
peppermint oil	mouth and tooth diseases	0
beverage	gustatory seizure	0
food supplementations	premenstrual tensions	0
candy	sleep initiation dysfunction	0
rose	weight reductions	0
frosting	back aches	0
pretzel	auricular fibrillations	0
dried peas	cerebral stroke	0
frozen cranberries	fibromyalgia-fibromyositis syndromes	0
caffeinated coffee	drug dependence	0
allium sativum	ovarian cancers	0
deli meat	congenital defects	0
foodstuff	secondary insomnia	0
wheat bran	ketosis prone diabetes mellitus	0
high-fat meal	low-grade lymphomas	0
sour cream	cancer of the prostate	0
potato chips	zoonotic infection	0
plantago seed	hip fractures	0
citrus-based fruits	basal cell epitheliomas	0
sweet almond	schilling-type myeloid leukemia	0
cumin	deficiency disease	0
apple	vaginal neoplasms	0
aspalathus	ankylosing spondyloarthritides	0
cupcake	acute inflammatory demyelinating polyneuropathy	0
actual fruit	cognitive dysfunction	0
fructose corn	blindness	0
cassia cinnamon	carcinogenic retroviruses	0
common foxglove	breast carcinoma	0
sea vegetables	low back aches	0
chinook salmon	ciliary body spasms	0
cannabis sativa	paratuberculose	0
morinda citrifolias	bechterews disease	0
garlic sauce	muscular rheumatism	0
purple grape	prostatic hyperplasia	0
eggplant	jakob-creutzfeldt disease	0
fermented cabbage	visual seizure	0
beet greens	mad cow disease	0
corn oil	ciliary body spasms	0
milk proteins	age related bone loss	0
bitter nightshade	kanners syndrome	0
citrus reticulata	foodborne diseases	0
dietary plant protein	minor head injuries	0
cayenne peppers	blood cancers	0
fed beef	tactile hypesthesia	0
lemon grasses	hypovolemic shock	0
elephant garlic	urinary bladder neoplasms	0
virgin olive	cancer of thyroid	0
norovirus food	gluten-sensitive enteropathies	0
capsicum annuum	treat cancer	0
infant formula	small cell lymphoma	0
oat	idiopathic intracranial hypertension	0
bacon	vagina neoplasm	0
milk chocolate	cranial pains	0
atropa belladonna	dermatozoic delusion	0
rye bread	auto-immune diseases	0
oreo	hereditary galactokinase deficiency	0
carthamus tinctorius	norwalk like viruses	0
potassium-rich foods	non-epileptic convulsions	0
persea	well differentiated lymphocytic lymphoma	0
syzygium sandwicense	b12 deficiency	0
measuring food	amaurose	0
pleurotus ostreatus	laron type dwarfism i	0
wild celeries	fibrocystic mastopathy	0
target vitamin	thyroid cancer	0
curcuma zedoaria	parkinson disease 2	0
rye	ciguatera fish poisonings	0
prunis communis	ekbom psychogenic parasitoses	0
soda pop	cancer of colon	0
pudding	substance abuse	0
unrefined plant	inflammatory disease	0
ginger	vagina neoplasms	0
spearmint	vagina cancers	0
triticum turgidum subsp. durum	wound botulism	0
powdered sugar	gorlin goltz syndrome	0
grecian foxgloves	fatigue	0
flaked coconut	hansen's disease	0
fagopyrum tataricum	graves disease	0
lettuce	human papilloma viruses	0
fresh fruits	galactose-1-phosphate uridyltransferase deficiency	0
bran flakes	bladder tumors	0
eating broccoli	head traumas	0
zedoary zedoarias	guillain barre syndrome	0
brassica nigra	penile cancer	0
plant-based foods	small cell lymphoma	0
amaranth	acute autoimmune neuropathies	0
salmonella food	fibrocystic breast disease	0
callerya	neonatal tremors	0
pepsi	campylobacter infections	0
sweet foods	pituitary dwarfism iis	0
cream cheese	adolescent obesity	0
entree	lav-htlv-iii	0
jelly	lead poisonings	0
caramel	familial creutzfeldt-jakob disease	0
syzygium	retinitis	0
stryphnodendron	low back pains	0
flaxseed	rachitis	0
applesauce	sleep initiation dysfunction	0
undercooked meat	primary parkinsonism	0
rice milk	vagina neoplasms	0
ceylon cinnamon	type i diabetes mellitus	0
prosopi	tactile hypesthesias	0
cycad trees	cancer of the kidney	0
sweeten	cervical migraine syndromes	0
muffin	endometrial neoplasms	0
lima beans	bowel diseases	0
citrus reticulatas	brain cancer	0
lavender	wart	0
chai tea	chronic gum disease	0
colocasia	prion induced disorder	0
spinach	disorder	0
pistacia lentiscus	ankylosing spondyloarthritis	0
da huang	inflammatory polyneuropathy acutes	0
low vitamin	autoimmune disorders	0
black pepper	recrudescence	0
fagopyrum esculentum	landry guillain barre syndrome	0
sea vegetable	dyspepsia	0
hemp	diabetic mononeuropathy	0
hordeum	gorlin syndrome	0
family vegetables	mucous colitides	0
grouper	heat stroke	0
euterpe oleracea mart.s	common bile duct biliary calculi	0
chlorella	fibromyositis-fibromyalgia syndrome	0
meal time	artery disease	1
ephedras	lymphocytic lymphomas	0
earl grey tea	increased cancer	0
cherry	light-headedness	0
contaminated foods	degenerative neurologic disease	0
maple syrup	vulvar cancer	0
sour orange trees	asymmetric diabetic proximal motor neuropathy	0
potable water	wound botulisms	0
fryer	salmonella infections	0
snack food	mild cognitive impairment	0
alcoholic beverage	urinary bladder cancer	0
radish	colon cancer	0
regular olive	senile paranoid dementias	0
tumeric	hereditary galactokinase deficiency	0
chicken	bovine spongiform encephalopathy	0
high-fiber food	ramsay hunt paralysis syndrome	0
spinacia oleracea	bladder neoplasm	0
fenugreek	secondary fibromyalgia	0
sea bilberry	ankylosing spondylarthritis	0
assai palm berry	birth defect	0
cooked meat	colorectal tumor	0
cuminum cyminums	plegia	0
shan yaos	aortic aneurysm	0
dangerous plants	acquired blindness	0
overpriced vitamin	dysosmia	0
assai palms	fibroatheromatous plaque	0
black beans	degenerative diseases	0
red pepper	childhood obesity	0
mentha	cysticercose	0
citrus fruits	bovine lymphomas	0
bertholletia excelsa	endocrine breast disease	0
drinking orange	deformity	0
roughage	post-traumatic osteoporoses	0
topical ginger	brain disorder	0
century plants	episodic cluster headache	0
peach	wound botulisms	0
big apples	bovine lymphomas	0
mussel	cerebrovascular strokes	0
spicy food	galactokinase deficiencies	0
scallion	vertebrogenic pain syndrome	0
refined olive	galactosemia 3s	0
crab apple	broken bones	0
eugenia cumini	emesis	0
nettle	galk deficiencies	0
goji berries	age-related osteoporosis	0
chewing gum	disk degradation	0
blueberry plants	b cell leukemia	0
red peppers	multiple head injuries	0
chinese yams	mastalgia	0
color	human t-cell leukemia virus type iii	0
pea	gastric acid reflux	0
nut butters	galactokinase deficiencies	0
licorice root	ciguatera fish poisonings	0
adhatoda vasica	stomach neoplasm	0
cuminum	physical anhedonias	0
french bean plants	microglandular adenosis	0
soy beverages	birth weights	0
natto	autosomal dominant parkinsonism	0
canned fruit	galactose-1-phosphate uridyl-transferase deficiency disease	0
rubus	arthritis	0
phyllanthus emblica	small lymphocytic lymphoma	0
soy cheeses	nonalcoholic fatty liver disease	0
althaea	inhibit cancer	0
cheese	low backache	0
flowering shrub	anosmia	0
dietary plant proteins	penile neoplasms	0
portulaca oleracea	circulatory failure	0
dragon fruit	severe mental disorder	0
portulaca oleracae	memory loss	0
wine	parodontosis	0
rose berries	mammary cancers	0
cucumis melo	somatotropin hypersecretion syndromes (acromegaly)	0
chinese cassias	autosomal recessive juvenile parkinson disease	0
ready-prepared food	steatosis of liver	0
crowberry	small lymphocytic lymphomas	0
teff	senile plaques	0
peanut	utp hexose 1 phosphate uridylyltransferase deficiency	0
treat	secretory meningiomas	0
snail meat	comatose	0
calling eggs	ruptured appendicitis	0
bitter orange tree	sub-fertility	0
wild celery	paralysis agitans	0
antioxidant vitamin	remittent fever	0
fennel seeds	persistent tremors	0
cocoa powders	parietal region traumas	0
swordfish	benign essential tremors	0
whortleberry	infertility	0
okra	arthrosis	0
mentha spicata	cancer of the uterus	0
soy beverage	drug use disorders	0
majorana hortensis	cancer viruses	0
garden radish	symmetric diabetic proximal motor neuropathy	0
edible grain	generalized spasm	0
citrus medicas	rectum neoplasms	0
oregano plants	throat cancer	0
wisconsin milk	male sub-fertility	0
kavas	pustulosis of palms and soles	0
nuclear power plants	nafld	0
carya illinoensis	fibrositis	0
oolong	human papillomavirus virus	0
apricot	endometrial neoplasm	0
experience food	skin neoplasm	0
pistacia	norovirus	0
find pork	impotence	0
parsley	bilateral headaches	0
salsa	abdominal migraine	0
barberry	feline leukemia viruses	0
bamboo shoots	small noncleaved-cell lymphoma	0
sweet potatoes	lower back pains	0
spaghetti	anaplastic carcinomas	0
cow's milk	spatial memory disorder	0
pomegranate fruit	headache syndrome	0
citrus bergamia	fibrositide	0
contaminated meat	uveitis	0
tachigalia	adenosis of breast	0
flax seeds	social anxiety disorder	0
porphyra	dermatosis	0
mandarin orange tree	post-ictal confusion	0
woodland strawberry	atherogenesis	1
cultivated oat	cancer of tongue	0
hickory nuts	cardiac sudden death	0
citrus aurantiums	crushing pains	0
citrus grandi	bone neoplasm	0
canned food	undifferentiated carcinoma	0
bean sprouts	muscular cramp	0
plant arils	biliary calculi	0
molasse	bse (bovine spongiform encephalopathy)	0
table sugar	inflammatory polyneuropathy acute	0
flax	diabetic autonomic neuropathy	0
osmanthus tea	pharyngitide	0
antioxidant foods	abdominal aortic aneurysm	0
cashew	b-cell chronic lymphocytic leukemia	0
dietary sucrose	chronic insomnia	0
emphasizes vegetables	uterine neoplasm	0
nicotiana tabacums	chronic illness	0
soy protein	colonic cancers	0
bilberry	pseudopelade	0
green onions	muscular rheumatism	0
blueberry plant	breast malignant tumors	0
usda poultry	sliding hiatal hernias	0
coriander	circulatory failure	0
bergamot	minor head injury	0
fabaceae	acquired immunodeficiency syndrome virus	0
tepary beans	benign brain neoplasm	0
cocoa powder	ulcerative colitis	0
shiitake mushroom	human herpesvirus 4 (gamma)	0
eating food	brain disorder	0
oxen meat	high-grade lymphoma	0
artificial sweeteners	goiter	0
antioxidant food	non-b hepatitis enterically-transmitted non-a	0
poppy seeds	senile tremor	0
brown rice	schizophrenic disorders	0
cookie	enzootic bovine leukoses	0
red delicious	resting tremor	0
brinjal	primary fibromyalgia	0
goji berry plant	gallbladder diseases	0
steamer	angioblastic meningiomas	0
granny smith apples	inflammatory bowel disease 1	0
bitter orange trees	chicken embryo lethal orphan virus	0
reindeer meat	cancer of the uterus	0
restructured meat	presyncope	0
dress	asymmetric diabetic proximal motor neuropathy	0
lycium	condylomata acuminata	0
jalapeno pepper	respiratory tract infections	0
cocos nuciferas	pancreas cancer	0
golden raisins	endothelial dysfunction	0
fagopyrum	recurrence	0
elettaria cardamomum	vulva neoplasm	0
cannabis indica	diffuse small cleaved cell lymphoma	0
flavourer	postural syncopes	0
pomelo tree	diffuse mixed-cell lymphomas	0
daily nut	benign neoplasm	0
lemon verbena	cervical neoplasms	0
laciniate nightshades	diffuse lymphoma	0
saffron	hypercapnia	0
soy	migratory pain	1
kava kavas	spiral fracture	0
raisin bran	heart failure	0
meal	sudden infant death syndrome	0
raw poultry	airsickness	0
amomum cardamomums	post-traumatic osteoporoses	0
cicer arietinums	ph1-negative myeloid leukemia	0
pithecolobium	cognitive retention disorder	0
lavandula angustifolia	endometriose	0
dressing	acute autoimmune neuropathy	0
legume pod	block cancer	0
rosemary	splitting pains	0
chinese rhubarb	female sterility	0
syzygium jambos	malignant epithelial tumors	0
clathrotropis	beriberi	0
soft drink	brain malignant neoplasm	0
black raspberries	polymyositide	0
swiss chard	membranous cataract	0
pecan	malignant meningioma	0
beef	chronic headaches	0
msg	cat leukemia viruses	0
apium graveolens	fibrosis	0
elettaria cardamomums	ekbom dermatozoic delusion	0
pummelo trees	uterus neoplasm	0
sweet basils	postoperative emesis	0
cocoa butter	thyroid adenomas	0
blueberry	et-nanbh	0
ready soybeans	prostatic hypertrophy	0
pancake	neurological condition	0
endive	graves disease	0
recommend tea	endometrium cancers	0
stevia rebaudianas	tonsil cancers	0
serve	oncogenese	0
fake meat	lou gehrig disease	0
vegetable proteins	confusional states	0
milk thistle	oncogenese	0
olive oil	nonalcoholic fatty livers	0
citrus x paradisi	diarrhea	0
dried blueberries	mental deteriorations	0
emblica officinalis	spinal meningiomas	0
cherry plum trees	small and large cleaved-cell lymphoma	0
almond tree	sinusitis	0
seville orange tree	preterm birth	0
ground ginger	tonic-clonic seizure	0
portulaca oleraceas	pneumonitide	0
added sweeteners	pancreas neoplasm	0
study lavender	adenovirus	0
nitrate-rich vegetables	zoonosis	0
beta vulgari	campylobacter infections	0
ocimum tenuiflorum	sprain	0
healthy fruit	lav-htlv-iii	0
cassia	sphenoid wing meningiomas	0
quinoa	utp hexose-1-phosphate uridylyltransferase deficiency	0
bertholletia excelsas	human papillomavirus virus	0
indian laburnum	diabetic amyotrophies	0
rise	liver steatoses	1
fried foods	malignant epithelial neoplasm	0
althea officinalis	anemia	0
java plum trees	gehrig disease	0
fagopyrum sagittatum	pill rolling tremors	0
kiwi fruits	temporary amnesias	0
zea	pancreatic neoplasm	0
happy meal	skin diseases	0
acer saccharum	arrhythmia	0
soy bean curds	baldness	0
artificial sweetener	ischemic heart diseases	0
mackerel	prion-induced disorder	1
chamomile tea	primary brain neoplasms	0
purple potatoes	congenital hypothyroidism	0
trigonella foenum graecum	subacute spongiform encephalopathies	0
portulaca	disorientation	0
retail poultry	non-hodgkin lymphoma	0
solanum lycopersicum	deafness	0
star anise	herpesvirus	0
carya	drug hypersensitivities	0
safflower oils	disseminated sclerosis	0
vaccinium macrocarpon	regional ileitides	0
bad foods	cancer of the bladder	0
prunus salicinas	generalized seizure	0
allium porrum	gastric neoplasms	0
cannabi	morning sickness	0
coca cola	varicose veins	0
amla	nutritional disease	0
preserved foods	nephrolith	0
healthiest beverages	mixed cell lymphoma	0
aspartame	sciatic neuralgias	0
component spices	gastro-esophageal reflux	0
restrict food	open head injury	0
celery root	inherited human transmissible spongiform encephalopathies	0
syzygium jambolanum	pattern baldness	0
ginger ale	motion sickness	0
kohlrabi	alactasia	0
acer negundo	philadelphia-negative myeloid leukemia	0
amygdalus communis	social phobia	0
raw foods	senile tremors	0
intoxicant	circulatory failure	0
orange	ovarian neoplasms	0
chenopodium quinoa	colicky pains	0
thymus vulgaris	anemia	0
individual food	dermatozoic delusion	0
asparagus	impotence	0
kaffir lime	age-related maculopathy	0
carbonated beverage	johne's disease	0
brain-invasive pork	multiple myeloma	0
conventional food	myocardial failure	0
cider	hydrophobia	0
sell meat	paraesophageal hiatal hernias	0
dinner times	penis cancer	0
noncaloric sweetener	malignant tumor of urinary bladder	0
bok choy	male sub-fertility	0
gluten-free diet	parkinsonism dementia complex of guam amyotrophic lateral sclerosis	0
sesame oils	intervertebral disk degenerations	0
cereal grain	urinary bladder cancer	0
prunus persica	small noncleaved-cell lymphoma	0
actual licorice	stomach ulcer	0
citrus sinensis	periodontal diseases	0
soy yogurt	severe gh insensitivity	0
proteus mirabilis	chronic b-cell leukemias	0
sour fruit	high-grade lymphomas	0
big food	biliary calculi	0
hemlock	bovine leukemia	0
herbal tea	paraesophageal hiatal hernias	0
dandelion	glaucoma	0
smoked food	carcinoma in situ	0
healthy snack	chronic airflow obstructions	0
banana plants	colitide	0
celebration meal	heart block	0
fries	substance use disorders	0
pimpinella	generalized headaches	0
watercress	headache disorder	0
pistachio nut trees	human t lymphotropic virus type iii	0
kidney beans	adolescent obesity	0
olive tree	benign prostatic hypertrophy	0
breakfast times	endometrial neoplasms	0
placenta	utp-hexose-1-phosphate uridylyltransferase deficiency disease	0
anise	social anhedonia	0
hop	sleeplessness	0
soybean proteins	pregnancy-induced diabetes	0
plantago arenaria	zoonosis	0
decaf	thyroid adenoma	0
chili peppers	benign essential tremor	0
rheum officinale	disc degradation	0
frying meat	colon cancer	0
nightshade	acidose	0
concord grapes	cjd (creutzfeldt jakob disease)	0
carbonated drinks	circulatory collapse	0
caryophyllus aromaticus	fatty liver disease	0
jelly beans	migraine headaches	0
dietary supplement	plasma-cell myelomas	0
domestic fowl	premenstrual syndromes	0
baked potato	lyme borreliosis	0
monkfish	physical anhedonia	0
psidium guajavas	undifferentiated carcinomas	0
dried fruit	sick headaches	0
lycopersicon esculentum	liver dysfunction	0
moose meat	single seizure	0
hazelnut	abdominal pains	0
dried apple	crib death	0
food poisonings	anhedonia	0
orange trees	mouth cancers	0
carbonated beverages	pulmonary cancer	0
processed meats	parkinsonism dementia complex of guam amyotrophic lateral sclerosis	0
stevia	epithelial cancers	0
glycyrrhiza	familial parkinson disease	0
betel nut	peripheral autoimmune demyelinating disease	0
delonix	alopecia cicatrisata	0
strawberry	prostatic neoplasms	0
good soybeans	galactosemia	0
aubergine	iritide	0
olea europaea	diabetic neuralgias	0
spice turmeric	chronic obstructive airway disease	0
sorrel	macular dystrophies	0
breakfast cereals	foodborne botulism	0
mustard plant	mixed cell lymphoma	0
cocoa plant	arthrosis	0
kidney bean	norwalk like viruses	0
kombucha teas	malignant brain neoplasm	0
red meat	microglandular adenoses	0
four nuts	gall bladder diseases	0
crataegus	tumor virus	0
national meat	vaginal discharges	0
dairy product	ductal carcinoma	0
euterpe	gallstone	0
butternut squash	cancer of prostate	0
yoghurt	non-epileptic convulsions	0
dietary sugars	amyotrophic lateral sclerosis parkinsonism dementia complex 1	0
stevia rebaudiana	low-grade lymphomas	0
vitamin	bronchiolitis	0
toxic plants	prostate neoplasms	0
plum	gluten enteropathies	0
mealtime	dementia	0
cherry plum tree	uterine cervical neoplasm	0
hemp plants	fibromyalgia-fibromyositis syndrome	0
rutabaga	recurrent low back pain	0
toronja	limb tremors	0
white pepper	arterial fatty streak	0
pimenta	plasmodium infection	0
black tea	mammalgia	0
marsh mallow	xanthomatous meningiomas	0
trace minerals	presyncope	0
healthiest vegetable	cancer of vulva	0
chocolate bars	philadelphia-negative myeloid leukemias	0
drinking milk	rodent ulcer	0
poisonous plant	paroxysmal atrial fibrillation	0
texturized soy protein	brain disorder	0
little saffron	status migrainosus	0
hot peppers	cardiac arrhythmias	0
rubus glaucus	ankylosing spondyloarthritis	0
hickory nut	chronic lymphoblastic leukemias	0
bibhitaki fruit	splitting pain	0
digitalis lanata	kidney neoplasms	0
sunflower seeds	gastric neoplasm	0
soft drinks	sliding hiatal hernias	0
baking chocolate	mastodynia	0
not-necessarily-so-healthy foods	secretory meningioma	0
turnip	male impotence	0
lemon balm	breast fibrocystic change	0
grapefruit	monocytic leukemia	0
split peas	premenstrual tensions	0
navy beans	mild cognitive impairments	0
dripping	continuous tremor	0
horse bean	soft tissue sarcoma	0
eugenia jambolana	angioblastic meningioma	0
guacamole	migraine variant	0
suggesting fruit	chronic gum disease	0
areca nuts	fibrous meningiomas	0
trigonella foenum-graecum	neonatal tremor	0
sesamum	disk degenerations	0
fuji apples	atheroma	0
indian gooseberries	genital wart	0
density foods	cancer of stomach	0
nonus	pancreatitis	0
betel nuts	small-cell lymphoma	0
rheum	degenerative intervertebral disks	0
goji berry	iritis	0
dog rose berries	breast malignant neoplasms	0
aloe vera	post-traumatic osteoporosis	0
toxic plant	male impotence	0
mustard	coma	0
anti-inflammatory foods	proteinuria	0
sweet almonds	nevoid basal cell carcinoma syndrome	0
linseed	familial guillain-barre syndrome	0
kola nut	pyrose	0
organ meats	milk sugar intolerance	0
rhubarb	igf-1 deficiency	0
dioscorea batatas	prion-associated disorders	0
pine nuts	coronary diseases	0
marjoram plants	arthritide	0
hordeum vulgare	olfaction disorders	0
common foxgloves	high-grade lymphomas	0
zea mays	cognitive dysfunction	0
pomelo trees	hiatal hernia	0
avoid peanuts	retinitis	0
malabar nut	back pain without radiation	0
capparis	memory losses	0
rice	polyradiculoneuritis	0
areca catechu	t viruses	0
ready-to-eat meal	liver dysfunction	0
higher vegetable	cancer of endometrium	0
artificially-flavored corn	prostate disease	0
morel	pulmonary cancers	0
origanum vulgare	head traumas	0
frier	cervix cancer	0
salt-free diet	breast malignant tumor	0
drug administration united states food	congestive heart failure	1
cereal	hyperventilation syncopes	0
euchresta	skin cancer	0
plant capsule	substance use disorder	0
peach tree	male breast neoplasms	0
wild radish	ekbom delusory parasitoses	0
inadequate fruit	zoonotic disease	0
hypericum perforatums	urinary bladder diseases	0
fava beans	low-grade b-cell malignancy	0
dairy products	migratory pain	0
prunus amygdalus	johne disease	0
added nuts	esophagus cancers	0
carya illinoenses	gnathostomiase	0
andira	sterility	0
euterpe oleracea	histamine cephalgia	0
butter milk	diabetic mononeuropathy simplices	0
oats	inherited human transmissible spongiform encephalopathies	0
sushi	gluten enteropathies	0
vaccinium corymbosum	kidney insufficiency	0
potato	experimental parkinsonisms	0
egg	diffuse small cleaved cell lymphoma	0
soya milk	prostatic hypertrophy	0
mentha x piperita	bipolar disorder	0
roundup-ready soybeans	leukovirus	0
cortland	chronic cluster headaches	0
ephedra	cancer of the testes	0
black currants	udpglucose 4-epimerase deficiency disease	0
ready-prepared foods	diabetes mellitus complications	0
fiddlehead ferns	atheroma	0
processed meat	guillain barre syndrome	0
acaí berries	coronary disease	0
almond trees	bone fractures	0
saffron crocus	dwarfism	0
cannabis sativas	lou gehrig disease	0
colophospermum	lou-gehrigs disease	0
low fruit	birth defects	0
eugenia jambos	behavior disorders	0
wort	prostate neoplasm	0
salad	familial creutzfeldt jakob disease	0
red cabbage	cancer of penis	0
coconut	sinusitis	0
raphanus raphanistrum	neurodegenerative disorders	0
tobacco	thyroid disease	0
plum tree	premature aging	0
atropa belladonnas	lou gehrig's disease	0
sardine	obesity in adolescence	0
triticum spelta	non-hodgkin lymphoma	0
milk	varicose veins	0
poppy	pattern baldness	0
hamburger	short sleep phenotypes	0
raw cranberries	ekbom dermatozoic delusions	0
wolfberry	common cancer	0
brown sugar	rectal cancers	0
betel	groundnut hypersensitivity	0
melissa officinali	cat leukemia virus	0
ground beef	bacterial vaginitides	0
eating eggs	celiac sprue	0
solanum dulcamara	eczema	0
coca	infectious diseases	0
pisum sativum	burkitt's lymphoma virus	0
teosinte	nafld	0
root	brain neoplasm	0
phaseolus	high grade lymphoma	0
deli meats	status migrainosus	0
berberis	carcinogenic retroviruses	0
handling meat	blindness	0
silybum marianum	pediatric cancers	0
romaine lettuce	ciliary neuralgia	0
commercial milk	fibrous meningiomas	0
blackberry	gnathostoma infection	0
goiaba	breast dysplasia	0
lycium barbarum	cancer of tonsil	0
century plant	nonhodgkin lymphoma	0
crataegus monogyna	pulmonary cancers	0
margarine	schizophreniform disorders	0
cooking oil	gastric neoplasm	0
syzygium aromaticum	amnestic state	0
prebiotic	heat strokes	0
red wine	episodic cluster headache	0
cruciferous foods	pancreatitis	0
nori	benign meningioma	0
white rice	varice	0
chinese cassia	inflammatory disease	0
sprout	fine tremors	0
national pork	gasser syndrome	0
bertholletia	coronary heart diseases	0
organic food	posterior fossa meningiomas	0
arachis	bovine leukemia virus	0
saint johns wort	ciguatera poisonings	0
curcuma longa	rectal cancers	0
high-phytate foods	pneumonitide	0
flower	substance use disorder	0
citrus limon	small-cell lymphomas	0
marsh mallows	lung disorders	0
diabetic diet	utp-hexose-1-phosphate uridylyltransferase deficiency disease	0
brussels sprouts	tonic seizure	0
plaice	cancer of the rectum	0
healthy nuts	mink encephalopathy virus	0
mustard plants	muscle cramps	0
areca	parkinson disease	0
taraxacum	confusional states	0
carob	utp hexose 1 phosphate uridylyltransferase deficiency disease	0
sparkling water	infectious mononucleosis viruses	0
olive	coronary heart disease	1
maize	carotid sinus syncope	0
pomegranate	orf	0
diospyro	neurotic anxiety states	0
pimenta officinalis	diffuse well differentiated lymphocytic lymphoma	0
low meat	thyroid adenoma	0
taraxacum officinale	vulva cancer	0
illicium anisatum	colonic neoplasms	0
hydroponic basil	oncovirinae	0
high-fructose maize syrup	cephalalgia	0
sauerkraut	horton's syndrome	0
baby spinach	galactosemia	0
whole grain	colorectal carcinomas	1
silken tofu	secondary fibromyalgias	0
linum	sciatic neuralgias	0
dioscorea polystachya	irritable bowel syndromes	0
breast milk	semantic memory disorder	0
tarragon	todd paralysis	0
corn sugar	nonhodgkins lymphoma	0
sugar	sneeze	0
whole foods	johnes disease	0
cocoa plants	galactose-1-phosphate uridylyltransferase deficiency	0
jambolan plum tree	gall bladder diseases	0
pimpinella anisum	tumor viruses	0
bean	amyotrophic lateral sclerosis parkinsonism dementia complex 1	0
uncooked food	bacterial vaginitides	0
lemon balm tea	gluten enteropathies	0
mentha piperita	impotence	0
diospyros digynas	paraesophageal hernias	0
zinger tea	benign brain neoplasms	0
celeriac	benign brain neoplasms	0
breast milks	iron overload	0
organic plants	cancer of endometrium	0
specific nuts	arterial dysfunction	0
adhatoda	bovine leukosis	0
lycium chinense	weight reductions	0
juglans regia	cancer of the endometrium	0
specific foods	short sleeper syndromes	0
term vegetable	fibrosis	0
mirobalanus embilica	galt deficiency	0
sweet marjorams	cancer of the ovary	0
andropogon nardus	stomach cancers	0
calendula officinali	condylomata acuminata	0
morinda citrifolia	lymphatic sarcomas	0
liquorice	prostatic intraepithelial neoplasms	0
frozen fruit	hypoesthesia	0
chickpea	kidney cancer	0
raw broccoli	creutzfeldt jacob disease	0
dried cranberries	gastric neoplasm	0
food poisoning	medical conditions	0
pecan trees	sore throat	0
vegetable protein	venereal warts	0
juiced broccoli	infarction	0
cannabis	severe congenital microcephalies	0
yolk	intracranial central nervous system disorders	0
sweet basil	high-grade lymphomas	0
dark chocolate	subfertility	0
green peas	cancer of the prostate	0
plantago indica	vitamin deficiencies	0
nicotiana	breast cancer	0
anacardium occidentale	aphthous stomatitides	0
soybean	sliding hiatal hernias	0
tangerine trees	uterine fibroid	0
tangerine tree	stomach cancer	0
ilex paraguarienses	arrythmia	0
cassia fistulas	myeloma multiple	0
vaccinium ashei	cardiac dysrhythmia	0
milk thistles	occipital traumas	0
grapefruit juice	amyloidose	0
bagel	cervix cancer	0
kola nuts	arterial fatty streaks	0
crataegus monogynas	vertiginous seizure	0
juglan	allergic diseases	0
durum wheats	paroxysmal atrial fibrillation	0
handling food	high grade lymphoma	0
wild yam	cardiovascular diseases	0
chilli peppers	thyroid diseases	0
beet	cervicitis	0
tulsi tea	manic depressive psychosis	0
coriandrum sativum	fibrosis	0
rheum rhaponticum	terminal ileitis	0
oyster mushrooms	convulsive syncope	0
eating nuts	rash	0
macadamia	drug hypersensitivities	0
sweetening agent	breast cystic diseases	0
gooseberry	primary parkinsonism	0
lamb chops	coronary disease	0
ribes nigrum	carcinomatose	0
vicia fabas	cancer of the lung	0
sweetened cereal	back pain without radiation	0
romaine	delusional parasitoses	0
soy beans	gustatory seizures	0
box elders	degenerative neurologic diseases	0
walnut oil	diabetic amyotrophy	0
green grapes	paraesophageal hiatal hernia	0
punica granatums	endometrial carcinomas	0
pistachio nut tree	galactosemia iiis	0
green pepper	fine tremor	0
trigonella	inflammatory polyneuropathy acutes	0
malus	cognitive retention disorders	0
cymbopogon nardus	rupture	0
amorpha	diabetic autonomic neuropathies	0
origanum	barretts esophagus	0
lens plants	postoperative emeses	0
powdered ginger	hemolytic jaundice	0
cruciferous vegetable	fifth phacomatosis	0
fast food	gossypiboma	0
diabetic diets	heart block	0
curry powder	back pains	0
fatty meal	atherosclerosis	0
alcoholic beverages	barrett syndrome	0
cola nitida	subfertility	0
apricot trees	bacteria-eating viruses	0
maguey	b-cell leukemia	0
filbert	kidney failure	0
psyllium	inappropriate growth hormone secretion syndrome (acromegaly)	0
sesame seeds	central nervous system degenerative diseases	0
alfalfa	burning pain	0
sugar-sweetened beverages	eye disease	0
no coffee	malignant brain neoplasms	0
individual candy	polyarthralgia	0
boiled eggs	amnesia-memory losses	0
petroselinum	creutzfeldt-jakob syndrome	0
wheatgrass	cjd (creutzfeldt jakob disease)	0
ice creams	fibroatheromatous plaques	0
caryophyllus	utp hexose 1 phosphate uridylyltransferase deficiency	0
include fennel	fibrositide	0
vinegar	autism	0
sweetener	vertiginous seizures	0
euterpe precatoria	proliferative bronchiolitis	0
citrus aurantium	cardiovascular diseases	0
basil	diabetic neuralgias	0
pimiento	brain diseases	0
dietary fats	udp galactose 4 epimerase deficiency disease	0
leguminosae	penile cancers	0
prunus cerasifera	new variant creutzfeldt jakob disease	0
lactuca sativa	plasma cell myeloma	0
cassia tree	diffuse well differentiated lymphocytic lymphoma	0
macadamia nut	cervix cancers	0
green tea	male infertility	0
piper nigrum	liver steatosis	0
new candy	sliding esophageal hernia	0
eat flax	arterial dysfunction	0
bell pepper	fighting cancer	0
beer	nephrolith	0
garlic	fissure in ano	0
cayenne	physical anhedonias	0
dried plums	gastric neoplasm	0
dietary fiber	sleep wake disorder	0
citron tree	hepatic failure	0
organic foods	postoperative nausea	0
apium graveolens var. rapaceum	heart block	0
soymilk	galactosemia iiis	0
digitalis	atherosclerose	0
brewing tea	remittent fever	0
poultry products	multiple myeloma	0
healthiest beverage	toxic megacolon	0
acid-binding vegetables	atopic diseases	0
salami	ketosis prone diabetes mellitus	0
lavandula	short sleeper syndrome	0
alfalfa sprout	chronic fatigue-fibromyalgia syndromes	0
acer saccharums	soft tissue sarcoma	0
hibiscus	uterine fibromas	0
foeniculum vulgare	dental disease	0
rubus idaeus	heart block	0
antioxidant fruits	chronic obstructive pulmonary disease	0
chard	nbcc	0
no meat	tonsillar cancers	0
pea family	vaginal cancer	0
thousand foods	dyspepsia	0
junk food	hair loss	0
fresh meat	diabetes-related complication	0
phaseolus vulgaris	gum disease	0
pureed apples	burn	0
including cloves	intraventricular meningioma	0
thyme	feline leukemia virus	0
big meals	salmonella infection	0
eugenia aromatica	primary parkinsonism	0
dietary protein	necrotizing fascitides	0
morning meal	diffuse small cleaved cell lymphoma	0
food allergies	vulvar cancer	0
grape juice	darkness tremors	0
dietary fibers	guillain barre syndrome	0
saint john's wort	bone cancer	0
croaker	gynecomastia	0
yam	age related bone loss	0
phaseolus vulgari	rebound insomnia	0
green peppers	memory deficit	0
candy bar	inflammation	0
macadamia nuts	malignant tumor of urinary bladder	0
soy sauce	osteoarthritide	0
narrow-leaved plantains	prion diseases	0
nicotiana tabacum	meningiomatose	0
mayo	coronary diseases	0
sea food	lead poisonings	0
japanese plum	miscarriage	0
poroporo	manic disorder	0
bell peppers	enzootic bovine leukosis	0
nutrient-dense foods	delusional parasitosis	0
seville orange trees	vulva neoplasms	0
eat chocolate	cancer of the tonsil	0
coleslaw	galactokinase deficiency disease	0
citrus bergamias	breast cancers	0
noni fruit	genital warts	0
eating meat	near-death experience	0
poultry meat	metabolic acidoses	0
horsenettle	dyspepsia	0
almond butter	social phobias	0
uncooked foods	cancer of the tongue	0
nut	orthostatic headache	0
grape	tick bites	0
mangifera indica	diffuse mixed small and large cell lymphoma	0
vaccinium angustifolium	lens opacity	0
foeniculum	gale deficiency	0
nutritional yeast	spiral fracture	0
bean sprout	head injury	0
kale	uterine fibroid	0
healthy snacks	autosomal recessive juvenile parkinson disease	0
prunus salicina	human papillomavirus virus	0
pimenta diocias	b-cell leukemia	0
meal times	lactose intolerance	0
anise tea	common cancers	0
caper	uterus neoplasm	0
foie gras	esophageal reflux	0
group foods	food hypersensitivity	0
vitis	fine tremor	0
prunus dulcis	kidney neoplasms	0
trace element	endometrium carcinomas	0
blossom	chronic lymphocytic leukemias	0
soda water	social anxiety disorders	0
ultra-processed foods	galactose 1 phosphate uridyl transferase deficiency disease	0
persea americanas	norwalk-like viruses	0
white mallows	irritable bowel syndrome	0
diospyros digyna	brain disorders	0
wild yams	pancreatitide	0
pinto bean	chronic illness	0
theobroma cacao	salami brusher's disease	0
plant kingdom	muscle tremor	0
citrus aurantiifolia	cardiac death	0
low-salt diet	treat cancer	0
baker's yeast	philadelphia negative myeloid leukemia	0
gmo soybeans	eye diseases	0
favorite meals	prion induced disorder	0
brazil nut tree	study cancer	0
broccoli raab	anal fissure	0
whole wheat	splitting pains	0
soy bean proteins	central nervous system intracranial disorders	0
shoot	early infantile autism	0
arginine-rich foods	tubal abortion	0
infects apples	fibroid tumors	0
cooked broccoli	chronic headaches	0
hibiscus sabdariffa	occipital traumas	0
ground meat	neurocysticercosis	0
pineapple	broken bone	0
chamomile	blood clot	0
honey	carcinomatosis	0
chervil	peripheral artery disease	0
squid	gerd	0
copaifera	breast fibrocystic disease	0
rose hips	chronic airflow obstruction	0
green lentils	right-sided heart failure	0
solanum tuberosums	wart viruses	0
cynara scolymus	age related osteoporosis	0
coco	heart disease	1
sweet peppers	substance induced organic mental disorders	0
mango	seizure	0
pickled vegetables	cardiovascular conditions	0
nut bar	mastodynia	0
common fruits	chronic disease	0
processed food	deficiency disease	0
vaccinium virgatum	smell disorders	0
melissa officinalis	acute inflammatory polyradiculoneuropathies	0
foenumgraecum	bilateral headaches	0
bread	non-hodgkins lymphoma	0
mastic tree	gallstone	0
leafy vegetables	intermittent tremors	0
golden delicious	age-related osteoporoses	0
popcorn	diarrhea	0
eragrostus	stomatognathic diseases	0
trace elements	vaginal discharges	0
pinto beans	mixed lymphocytic-histiocytic lymphoma	0
vaccinium uliginosum	trochanteric fractures	0
indian gooseberry	jacksonian seizure	0
neutraceutical	aids virus	0
jalapeno peppers	carsickness	0
legume pods	polyarthritide	0
molasses	disc degradations	0
raspberry	kanner's syndrome	0
chicken meat	tussive syncopes	0
cereal grains	acute strokes	1
pimenta officinali	migraine variant	0
food allergy	brain tumor	0
common bean plant	ovarian cancers	0
cassia fistula	premature birth	0
mock meats	skin rash	0
chestnut	tonic-clonic seizures	0
bt corn	lymphatic sarcomas	0
flavorer	preterm birth	0
halibut	pregnancy pernicious vomiting	0
low-fat diet	hansen disease	0
fragaria	high cholesterol level	0
vaccinium bracteatums	paraesophageal hiatal hernias	0
marijuana	convulsion	0
ananas	cancer of the rectum	0
coconut oil	experimental lung inflammations	0
cola acuminata	water stress	0
tea plant	liver steatoses	0
lemon	breast tumor	0
tempeh	thyroid disorders	0
phytonutrient-rich food	strains and sprains	0
brewed coffee	erectile dysfunction	0
antioxidant-rich foods	ph1 negative myelogenous leukemia	0
erythroxylon	neurocysticercosis	0
onion	diffuse mixed-cell lymphoma	0
acer negundos	neoplasia	0
corn oils	diffuse lymphoma	0
apricot tree	fibrous meningiomas	0
human milk	polyradiculoneuritide	0
food company	osteoarthritide	0
food colors	low back pain	0
jasmine tea	gallbladder diseases	0
baby formula	eczematous dermatitis	0
carica	substance addiction	0
myristica fragrans	subtrochanteric fractures	0
cleistocalyx	penile neoplasm	0
monitoring food	urinary tract infection	0
fruit juice	post traumatic osteoporosis	0
artichoke	bse (bovine spongiform encephalopathy)	0
flax seed	faint	0
drink	gehrigs disease	0
opium poppies	mesothelioma	0
energy drink	brain benign neoplasms	0
açaí berry	exanthema	0
legume family	diabetic retinopathies	0
consumed chocolate	hepatic neoplasm	0
texturized vegetable protein	breast cystic disease	0
low-calorie diet	sore throats	0
multivitamin	parkinsonism	0
sugar maple	diabetic amyotrophy	0
animal-based vitamin	galactosemia iiis	0
raphanus	legal blindness	0
hummus	retained surgical instruments	0
tea	dysfunction	1
international nut	oncogenic viruses	0
drink milk	recurrence	0
hibiscus cannabinus	chronic airflow obstructions	0
dioscorea opposita	atypical chronic myeloid leukemia	0
brassica	autistic disorders	0
oatmeal	horton's syndrome	0
specific cheeses	endometriosis	0
illicium verum	galactose 1 phosphate uridyl transferase deficiency disease	0
mangifera indicas	cerebral strokes	0
haritaki fruit	central nervous system cysticercosis	0
white bread	lobar pneumonia	0
purple rice	reticulum-cell sarcomas	0
poppy seed	confusional state	0
curry	acromegaly	0
oyster mushroom	galactose-1-phosphate uridyltransferase deficiencies	0
squashe	epithelioid sarcomas	0
plum trees	disc degenerations	0
white meat	retrovirus	0
dinnertime	brain cysticercosis	0
flesh foods	prostatic hyperplasia	0
animal food	cirrhosis	0
yogurt	small non cleaved cell lymphoma	0
red yeast rice	papillary meningiomas	0
chinese food	drug dependence	0
chili	colonic neoplasms	0
chia seeds	generalized spasm	0
texturized vegetable proteins	dental plaque	0
narrow leaved plantain	pseudotumor cerebri	0
dietary supplements	philadelphia-negative myeloid leukemias	0
papaver somniferum	unilateral headache	0
vegetable juices	disk degenerations	0
cultivated oats	relapse	0
lime	diabetes complications	0
guibourtia	muscular spasm	0
eugenia malaccensis	auricular fibrillations	0
mangiferas	juvenile parkinson disease	0
eupatorium rebaudianum	fetal iodine deficiency disorder	0
avocado fruit	psychophysiological insomnia	0
chocolate	brain disorder	0
linum usitatissimums	parkinsonism	0
black sapotes	vagina neoplasm	0
origanum onites	chronic disease	0
cocoa	myelomatose	0
olive oils	premature aging	0
kawa	seizure disorder	0
arecas	infectious mononucleosis virus	0
colorful foods	malignant tumor of breast	0
gluten	ache	1
nut butter	mental disorder	0
gravy	toxico infectious botulism	0
vaccinium macrocarpons	a-v dissociations	0
anana	brain diseases	0
convenience food	mental disorders	0
berry	copd	1
chewing fruit	anaplastic carcinoma	0
jell-o	age related osteoporosis	0
paella	lymphadenopathy-associated viruses	0
vicia faba	pharyngitide	0
thymus plant	human immunodeficiency virus	0
lemon balms	lassitude	0
mustard oil	intestinal diseases	0
brew	wheat hypersensitivities	0
breakfast cereal	sensory seizure	0
bhang	hepatocellular cancers	0
dietary supplementations	insulin dependent diabetes mellitus 1	0
chinese cinnamons	paraesophageal hiatal hernia	0