
green peas	deep-venous thromboses	0
lemon grass	histamine cephalgias	0
morinda citrifolias	human mammary neoplasms	0
suggesting fruit	mixed lymphocytic histiocytic lymphoma	0
currant	hepatitis e	0
milk chocolate	eye disease	0
black tea	deep vein thrombosis	0
undercooked meat	fibroid uterus	0
fenugreek seeds	insulin-dependent diabetes mellitus	0
mesquite	rna tumor viruses	0
capsicum annuum	action tremor	0
coriander	thermal hypesthesias	0
concord grapes	ovarian cancer	0
soy	infectious mononucleosis virus	0
fuji apples	rabies	0
dangerous plants	genital warts	0
golden delicious	lead poisonings	0
linum usitatissimums	alactasia	0
lamb chops	multiple myositides	0
cruciferous vegetable	familial creutzfeldt-jakob diseases	0
pease	hemangioblastic meningioma	0
durum wheat	todd paralysis	0
warm milk	darkness tremors	0
stevia rebaudiana	norwalk-like viruses	0
crabapple	renal insufficiency	0
scallion	cjd (creutzfeldt-jakob disease)	0
erythroxylon	osteoporose	0
raw tomatoes	alopecia cicatrisatas	0
chinese cassias	barretts esophagus	0
petroselinum	chronic lymphocytic leukemia	0
pepsi	bone cancer	0
curry	reactive confusion	0
aspartame	cephalalgia	1
exotic fruit	motion sickness	0
cocktail	eczematous dermatitis	0
ketchup	mucous colitis	0
contamination meat	chronic cystic mastitis	0
vegetable juices	forehead traumas	0
hypericum perforatums	gluten enteropathies	0
alfalfa sprout	drunkenness	0
chili peppers	cephalgia	0
spice turmeric	angioblastic meningiomas	0
holy basil	familial creutzfeldt-jakob diseases	0
cranberry sauce	ph1-negative myeloid leukemias	0
plant arils	cerebral convexity meningiomas	0
indian gooseberry	udp-galactose-4-epimerase deficiency	0
fava beans	acquired deafness	0
consumer protection scientific committee on food	abdominal obesities	0
baking chocolate	disc degeneration	0
olive family	cancer of prostate	0
wheat	tussive syncopes	0
thymus	gluten sensitive enteropathy	0
cooking oil	short sleep phenotypes	0
edible grain	macular dystrophy	0
daucus carota	cognitive retention disorders	0
entree	serious disease	0
frying foods	amyotrophic lateral sclerosis with dementia	0
raw alfalfa	tonic-clonic seizures	0
purple rice	genital wart	0
french bean plant	breast disease	0
paprika	prelingual deafness	0
cinnamomum trees	cancer of the testis	0
ceratonia	somatotropin hypersecretion syndromes (acromegaly)	0
higher vegetable	toxic megacolon	0
cucumis sativus	endometrium cancer	0
prunus domestica	retrovirus	0
acai berries	undifferentiated carcinomas	0
hickory nut	disc degenerations	0
wisconsin milk	periorbital headaches	0
no-calorie sweeteners	prostatic neoplasm	0
fake meat	mptp induced experimental parkinsonism	0
bell pepper	arrythmia	0
sea bilberry	inflammatory polyneuropathy acutes	0
brewage	central nervous system cysticercosis	0
potato	endometrial neoplasms	0
hickory tree	vaginal neoplasms	0
hamburger	landry guillain barre syndrome	0
leguminosae	gastro-esophageal reflux	1
rubberplant	acute inflammatory polyneuropathies	0
celery	chronic fatigue fibromyalgia syndrome	0
dried food	rabies	0
curry powder	aids virus	0
papaya	plasmodium infection	0
squash plant	meningiomatose	0
daily nut	intractable headache	0
ribes nigrum	cancer of vulva	0
cold-steeping tea	recurrent brain tumors	0
kavas	atrial fibrillation	0
persea	benign neoplasm	1
dioscorea polystachya	wound botulisms	0
burrito	leukovirus	0
empty calorie foods	bilateral sciatica	0
grecian foxglove	colonic cancers	0
tomato sauce	chromosome 6 linked autosomal recessive parkinsonism	0
acacia tree	cancer of the thyroid	0
oatmeal	social anhedonia	0
baby formulas	zoonotic diseases	0
eugenia cumini	contusion	0
silybum marianum	backache	0
white rice	malignant primary brain tumors	0
soy beverage	experimental parkinson disease	0
whole wheat	senile tremor	0
emblica officinali	ovarian cancer	0
raw broccoli	gastroesophageal reflux	0
chewed coca	inflammatory polyneuropathy acute	0
laciniate nightshade	carcinoma in situ	0
arginine-rich foods	burn	0
pistacia lentiscus	mammary cancer	0
kawa	relapse	0
marihuana	carcinoma	0
meal time	excess cancer	0
nicotiana tabacums	nonalcoholic fatty liver disease	0
big food	multiple sclerosis	0
grapefruit juice	cancer of the tongue	0
green peppers	senile tremors	0
agave	fatty liver disease	0
sweet almond	sleep wake disorders	0
dietary supplementations	physical suffering	1
illicium verums	landry guillain barre syndrome	0
norus	laron syndrome	0
marsh mallows	rectum cancers	0
sweet marjoram	periorbital headaches	0
bitter orange trees	inflammatory demyelinating polyneuropathy	0
lentil	verruca	0
mentha x piperita	bowel diseases	1
hot sauce	parasagittal meningioma	0
lactuca sativa	involuntary quivers	0
seltzer water	autosomal recessive juvenile parkinsonism	0
texturized vegetable protein	endometrial carcinomas	0
crocus	generalized spasms	0
bread	todd paralysis	0
grecian foxgloves	body weights	0
fruit and vegetable juices	cancer of brain	0
andean blackberry	landry guillain barre syndrome	0
official vitamin	esophageal neoplasm	0
prunus cerasifera	atrial fibrillation	0
brain-invasive pork	tactile hypesthesia	0
lemon	cognitive retention disorders	0
high fructose maize syrup	udp-galactose-4-epimerase deficiencies	0
cider	parasagittal meningiomas	0
aspalathus linearis	regional ileitis	0
amaranth	prion diseases	0
high-fructose maize syrup	pancreatic neoplasms	0
almond milk	leucocythemia	0
black walnuts	transitional meningiomas	0
trigonella foenum graecum	bone fractures	0
portulaca oleracae	microglandular adenoses	0
eugenia aromatica	intraventricular meningiomas	0
bellis	neurologic degenerative disease	0
peach tree	myeloma-multiple	0
sour fruit	acute infectious polyneuritis	0
pork	early awakening	0
maize oil	galactokinase deficiency	0
plantago	galactose-1-phosphate uridyltransferase deficiency	0
natto	perforated appendicitis	0
thymus vulgaris	recurrent brain tumor	0
collard green	tongue cancer	0
avena sativa	neuritic plaques	0
nut butter	polyradiculoneuropathy	0
dried apples	ciliary body spasm	0
citrus bergamias	psammomatous meningioma	0
cocos nuciferas	common bile duct gall stones	0
red delicious apples	physical anhedonias	0
chenopodium quinoas	liver neoplasms	0
mussel	higher cancer	0
frozen broccoli	benign neoplasm	1
myristica fragran	cephalodynia	0
ground beef	breast cancers	0
fenugreek	sprains and strains	0
woodland strawberry	coarse tremor	0
vinegar	endometrium carcinoma	0
sour cream	galactosemia iii	0
four nuts	hemangioblastic meningiomas	0
antioxidant vitamin	premature aging	0
density foods	galactosemia 2	0
thousand foods	pancreatic neoplasm	0
white pepper	malignant melanoma	0
exotic fruits	schizophreniform disorders	0
nettle tea	uterine neoplasm	0
nutrient-dense foods	nonalcoholic steatohepatitis	0
zucchini	angiomatous meningioma	0
goji berry	insulin-dependent diabetes mellitus 1	0
majorana hortensis	cephalalgia	0
pea	sick headache	0
eugenia caryophyllata	substance use disorder	0
food additives	foreign object	0
high-fiber food	primary brain tumors	0
garlic	thermal hypesthesia	0
yerba mates	syncopal vertigo	0
cilantro	contusion	0
hazelnut	spontaneous abortion	0
marjoram plant	burkitt herpesvirus	0
lucerne	cerebrovascular apoplexy	0
prettiest fruit	substance abuse	0
health nuts	malignant melanomas	0
plum trees	blood cancers	0
sweetening agent	small lymphocytic lymphomas	0
nutmeg	degenerative neurologic disorder	0
chinook salmon	environmental cancer	0
kenaf	tick bites	0
carbonated mineral water	hormonal dysfunction	0
preserved foods	ankylosing spondylarthritis	0
lettuce	symmetric diabetic proximal motor neuropathy	0
fiddlehead ferns	ciliary neuralgias	0
iceberg lettuce	suppuration	0
jelly beans	mixed small and large cell lymphoma	0
citrus grandis	mucous colitides	0
mandarin orange trees	acute inflammatory demyelinating polyradiculoneuropathy	0
term vegetable	pill rolling tremors	0
sugar maples	atypical diffuse small lymphoid lymphoma	0
breakfast	bladder neoplasm	0
breast milk	corpse	0
citrus paradisi	a-v dissociations	0
dried apple	appendicitis	0
rheum	bowel disease	0
wort	reducing cancer	0
jalapeno	chronic diseases	0
lens culinaris	small cell lymphoma	0
weekly meat	social phobias	0
lemon verbena	acute monocytic leukemia	0
canned fruit	craniocerebral traumas	0
anti-inflammatory foods	early onset parkinsonism	0
fragaria vesca	low-grade b-cell malignancy	0
white potatoes	fibromyalgia-fibromyositis syndrome	0
edible grains	cancer of esophagus	0
garbanzo	zoonotic disease	0
hemp	degenerative neurologic disorder	0
cuminum cyminums	diabetic polyneuropathies	0
dessert	diabetic complications	0
ready-prepared food	unhealthy conditions	0
orange	pancreatitide	0
healthiest beverage	pharyngitide	0
big apples	high blood pressure	0
sparkling waters	polyradiculoneuritis	0
study lavender	back ache	0
ovary	sick headache	0
corn oil	cancer of bladder	0
pecan tree	auricular fibrillation	0
colophospermum	bleed	0
chicken meat	hemicrania migraines	0
cooked tomatoes	rectum neoplasm	0
saint johns wort	allergic diseases	0
snack foods	broken bone	0
chanterelle	benign meningiomas	0
vegetable juice	communicable disease	0
wheat bran	pregnancy induced diabetes	0
coriandrum sativums	pernicious vomiting of pregnancy	0
poenumgraecum	pregnancy pernicious vomiting	0
persimmon	male pattern alopecia	0
allspice	inhibit cancer	0
so-called vegetable	secretory meningiomas	0
cassia	cancer of the prostate	0
horse nettle	lung neoplasms	0
cuminum	acquired immunodeficiency syndrome	0
cultivated radish	orf	0
star anise	substance induced organic mental disorders	0
purple potatoes	schizoaffective disorders	0
prosopi	varicose veins	0
saffron	cardiovascular strokes	0
sorrel	oxygen deficiency	0
caper	pyrose	0
crataegus monogynas	preventable cancers	0
linseed	common cold	0
artichoke	massive tremor	0
anise seed	dissociative amnesias	0
sea food	ekbom delusional parasitosis	0
origanum onites	confusion	0
mangiferas	sea sickness	0
curcuma	intestinal diseases	0
juiced broccoli	ache	0
liquorice	severe mental disorders	0
healthier foods	basal cell epitheliomas	0
sprout	postoperative nausea	0
cocoanut	oncovirinae	0
food coloring	benign brain neoplasms	0
shorten	degenerative neurologic diseases	0
silken tofu	ramsay hunt paralysis syndrome	0
including cloves	abdominal obesities	0
milk thistles	colon cancer	0
portulaca oleracea	bacteria-eating viruses	0
fresh meat	breast fibrocystic disease	0
animal food	atrial fibrillation	0
herbal teas	recurrence	0
pumpkin seeds	galactokinase deficiency	0
bitter orange tree	central nervous system degenerative diseases	0
poultry products	well differentiated lymphocytic lymphoma	0
chewing gum	massive tremor	0
phaseolus	landry guillain barre syndrome	0
mackerel	bovine spongiform encephalopathy	0
vegetable proteins	testis neoplasm	0
pickled vegetables	pustulosis of palms and soles	0
red cabbage	porcine endogenous retroviruses	0
chewing gums	parodontose	0
ananas	prion diseases	0
moose meat	fatigue	0
horse bean	throat cancer	0
bagel	obesity virus	0
kidney bean	malignant primary brain tumors	0
brassica juncea	prion induced disorder	0
zinger tea	pancreatic neoplasms	0
box elders	vaginitis	0
sweetleaf	disk degradations	0
fragaria	vaginal neoplasms	0
cicer arietinums	necrotizing fasciitides	0
sweet peppers	mental disorder	0
fresh ginger	bilateral headache	0
psidium guajava	low back pains	0
cucumis melos	vitamin deficiency	0
jambolan plum tree	dyspepsia	0
processed meats	rectal tumors	1
candy	plasmodium infections	0
cinnamomum aromaticum	passive tremors	0
rowanberry	male breast tumor	0
dietary fibers	drug allergies	0
regular olive	insulin dependent diabetes mellitus	0
aspalathus	bladder tumor	0
squash	sciatic neuralgia	0
plant embryo	galactosemia 3s	0
high-fructose corn	presyncope	0
acer saccharums	mouth and tooth diseases	0
cassia fistula	ph1-negative myelogenous leukemias	0
handling meat	reticulum-cell sarcomas	0
handling food	sciatic neuralgias	0
nicotiana tabacum	wound botulism	0
rubus fruticosus	disrupted in b-cell malignancy	0
agaricaceae	plasmodium infections	0
breakfast times	fibroid tumor	0
flower	cancer of brain	0
syzygium sandwicense	rest tremor	0
dairy eggs	sneeze	0
trigonella foenum-graecums	hypoxemia	0
guava	cancer of breast	0
individual food	non-b hepatitis epidemic non-a	0
taraxacum	e-b viruses	0
recommend tea	zoonotic disease	0
pomegranate fruit	chronic daily headache	0
unrefined plant	rectum neoplasms	0
pepper	sliding hiatal hernia	0
spinacia oleracea	muscle spasms	0
vaccinium macrocarpons	hemangioblastic meningioma	0
molasses	e b virus	0
jam	vulva cancers	0
rosemary	carcinogenese	0
dietary proteins	chronic cluster headache	0
plantago psyllium	cerebral convexity meningioma	0
cocoa plants	stomach ulcer	0
milk	visual seizures	0
drink tea	dairy product intolerance	0
betel nut	chronic b-lymphocytic leukemias	0
alpine strawberry	psychogenic parasitoses	0
jasmine tea	breast disease	0
monkfish	drug abuse	0
triticum turgidum	human influenzas	0
trigonella	mild cognitive impairments	0
fermented foods	carcinomatose	0
snack	gustatory seizure	0
abelmoschus	amyotrophic lateral sclerosis-parkinsonism-dementia complex 1	0
restructured meat	thyroid adenomas	0
alcoholic beverage	chronic lymphocytic leukemias	0
brinjal	cat leukemia viruses	0
filbert	senile paranoid dementias	0
toxic plants	fusiform aneurysm	0
brew	mad cow diseases	0
pretzel	skin cancer	0
gum acacia	unilateral headaches	0
citrus fruits	seasickness	0
french fries	jakob creutzfeldt disease	0
prunus amygdalus	semirhythmic tremors	0
phaseolus vulgaris	degenerative neurologic disease	0
nutraceutical	lewy body parkinson disease	0
breakfast cereal	erectile dysfunction	0
mustard seeds	chronic infectious mononucleosis like syndrome	0
ephedra	short sleeper syndromes	0
dried cranberries	ocular headache	0
alcohol	gallbladder diseases	0
marshmallow	appendicitis	0
poisonous plant	physical anhedonias	0
tomato juice	biliary calculi	0
use sweeteners	lassitude	0
black sapote	somatotropin (acromegaly) hypersecretion syndrome	0
cocoa powders	bovine spongiform encephalitis	0
plant capsule	indigestion	1
no noni	guillain barre syndrome	0
citrus reticulatas	nonhodgkin's lymphoma	0
cultivated oats	colon neoplasms	1
soup	human papillomavirus viruses hpv	0
include flaxseed	senile paranoid dementia	0
low-calorie diet	udp-galactose-4-epimerase deficiencies	0
sesame oil	hair losses	0
chipotle	cancer of the kidney	0
gmo soybeans	determination of death	0
phyllanthus emblica	familial tremors	0
seltzer waters	wheat allergy	0
swiss chard	germinoblastic sarcomas	0
bean sprout	esophageal cancers	0
sugar water	olfaction disorder	0
international nut	urinary bladder cancer	0
areca nuts	lou gehrig's disease	0
macadamia	aphthous ulcers	0
saint johnswort	prion-induced disorder	0
legume family	spatial memory disorder	0
tofu	high blood pressure	0
catfish	phlebothrombose	0
artificially-flavored corn	age-related macular degenerations	0
lime	familial parkinson disease	0
peach	massive tremors	0
zea mays	skin diseases	0
areca catechus	breast adenosis	0
açaí berry	endotoxemia	0
artificial butter	hemangiopericytic meningiomas	0
low fruit	myeloma multiple	0
apricot tree	diabetes mellitus complications	0
soy bean curd	type c oncoviruses	0
wheatgrass	acute autoimmune neuropathy	0
sweetening agents	icterus	0
flax seed	elevated cholesterols	0
kiwi fruits	ph1-negative myelogenous leukemias	0
beer	fights cancer	0
black currant	primary insomnia	0
ultra-processed food	testis cancers	0
sweetener	insulin dependent diabetes mellitus	0
convenience food	myeloma multiple	0
soda pop	hansen's disease	0
sweet pepper	intertrochanteric fractures	0
romaine	recurrent brain tumors	0
hop	ovary neoplasm	0
shan yaos	germinoblastic sarcomas	0
sweet basil	coarse tremors	0
pistacia vera	philadelphia negative myeloid leukemia	0
dried pomegranate	primary fibromyalgia	0
cassia cinnamon	short sleeper syndrome	0
gluten	neuralgic migraine	0
chinese yams	congenital abnormalities	0
açai berries	congenital abnormality	0
pinto bean	olfactory seizures	0
include fennel	preterm births	0
berry	parodontosis	1
fabaceae	lewy body parkinson disease	0
antioxidant-rich foods	penile cancer	0
ice cream	rete testis tumor	0
eating food	galactose-1-phosphate uridylyltransferase deficiency	0
wolfberry	ductal carcinoma	0
cymbopogon	cerebral convexity meningiomas	0
beet greens	heatstroke	0
cashew	dysfunction	0
muffin	galactosemia iii	0
soy bean	sliding hiatal hernia	0
hibiscus cannabinus	e-b viruses	0
green lentils	neurodegenerative diseases	0
tea leaves	acquired deafness	0
teosinte	human herpesvirus 4 (gamma)	0
pimpinella	smell disorder	0
happy meal	ekbom dermatozoic delusions	0
lycopersicon esculentum	cancer of endometrium	0
cacao	severe congenital microcephaly	0
broccoli	esophagus neoplasm	0
cannabis indicas	urinary bladder neoplasms	0
carbonated water	psammomatous meningioma	0
food supplement	bronchiolitide	0
dragon fruit	oncovirus	0
food poisonings	postoperative vomiting	0
black currants	dna injury	0
aloe	cirrhosis	0
brussels sprouts	social anxiety disorder	0
illicium anisatums	mania	0
diospyros digyna	odontogenic keratocysts multiple basal cell nevi	0
new vitamin	paroxysmal atrial fibrillations	0
lunchtime	olfaction disorder	0
spearmint	renal insufficiency	0
healthiest fruits	nonalcoholic steatohepatitides	0
macadamia nut	cancer of mouth	0
guacamole	essential tremor	0
crataegus	dysmenorrhea	0
corylus	hair losses	0
salad	type c oncovirus	0
sauerkraut	cancer of testis	0
pimenta officinali	darkness tremors	0
tea hibiscus	acute stroke	0
curcuma longa	lung neoplasms	0
whole grain	gastro-esophageal reflux	0
foeniculum	kidney cancer	0
cassia fistulas	blood cancer	0
rheum officinale	muscle sorenesses	0
sunchoke	drug allergies	0
pyrus	cramp	0
healthiest vegetable	drug hypersensitivity	0
hordeum	small lymphocytic lymphomas	0
unhealthy food	parkinsons disease	0
sunfish	hip fractures	0
apium graveolens var. dulce	undifferentiated lymphoma	0
retail meat	abdominal aortic aneurysm	0
shiitake mushrooms	pustulosis palmaris et plantaris	0
clove	intraepithelial prostatic neoplasia	0
kola nut	ankylosing spondyloarthritis	0
hibiscus tea	age related memory disorders	0
proteus mirabilis	gnathostoma infections	0
food and drug administration	motor seizures	0
dripping	dwarfism	0
red lentils	myelopathy	0
salt-free diet	spondylarthritis ankylopoietica	0
trace mineral	high cholesterol level	0
pureed apples	gastric ulcers	0
apium graveolens var. rapaceum	dental disease	0
drinking coffee	bewilderment	0
organ	human immunodeficiency virus	0
psidium	galt deficiencies	0
avena	substance abuse	0
sesamum	preventable cancers	0
ready soybeans	hemolytic jaundices	0
beet	galactose epimerase deficiencies	0
adhatoda	mixed small and large cell lymphoma	0
dried yeast	cerebral strokes	0
nutriceutical	intervertebral disc degeneration	0
dog rose berries	inflammatory bowel diseases	0
shiitake mushroom	determination of death	0
coleslaw	female sub-fertility	0
eupatorium rebaudianums	different cancer	0
chicken salad	bilateral sciatica	0
osmanthus tea	deep vein thrombosis	0
lycium chinense	transmissible dementia	0
ocimum tenuiflorum	human cancer	0
seafood	insomnia disorders	0
quinoa	sleep initiation and maintenance disorders	0
curcuma zedoaria	mouth cancer	0
powdered ginger	semirhythmic tremor	0
anise	amnestic states	0
pineapple juice	childhood onset obesity	0
belladonna	familial dementias	0
whole grains	retrovirus	0
vitis vinifera	drop attacks	0
aubergine	head traumas	0
plant zygotes	anthrax	0
potable water	anthrax	0
glucose fructose syrup	renal calculus	0
fungus	epstein-barr virus	0
table salt	migraine variants	0
turmeric	spinal cord disease	0
tangerine tree	polyarthritide	0
vaccinium bracteatum	bacterial vaginitis	0
molasse	polyarthritide	0
cinnamomum cassia	type c oncoviruses	0
neu5gc-rich food	paludism	0
offal	sterility	0
irritable bowel kiwi fruit	prostatic neoplasm	0
melissa officinali	crib death	0
calling eggs	ramsay hunt paralysis syndrome	0
euchresta	pus	0
ribe	hay fever	0
arugula	action tremors	0
hickory nuts	leukemogenic viruses	0
inadequate fruit	inhibit cancer	0
boiled eggs	lung neoplasms	0
junk food	water borne hepatitis	0
carbonated drink	nonalcoholic fatty livers	1
oryza	muscle disease	0
skim milk	diffuse mixed-cell lymphomas	0
green grapes	physical suffering	0
milk protein	malignant brain neoplasms	0
beef	skin disease	0
japanese plums	sharp headaches	0
illicium anisatum	age-related maculopathies	0
barberry	continuous tremor	0
dietary soybean proteins	parodontose	0
prunus persica	rete testis tumor	0
common fruits	dripped virus	0
bacon	benign intracranial hypertension	0
anchovy	chronic insomnia	0
fries	lymphosarcoma	0
parsley	retained surgical tools	0
red onions	common cancer	0
bad foods	high cholesterol levels	0
poultry meat	deep venous thrombosis	0
raw garlic	colitis gravis	0
mustard oil	serious disease	0
sour orange tree	aids virus	0
processed food	tumor	1
cultivated oat	creutzfeldt jakob syndrome	0
pizza	prostate neoplasms	0
amomum cardamomum	inflammatory polyneuropathy acute	0
tangerine trees	parkinson disease	0
hemlock	birth weight	0
alfalfa sprouts	crushing skull injury	0
purple grape	esophageal neoplasms	0
eragrostis	myocardial infarctions	0
antioxidant fruits	genital warts	0
plant-based foods	pancreatic neoplasm	1
solanum laciniatum	histamine cephalgias	0
plant zygote	preinvasive carcinoma	0
animal-based foods	sphenoid wing meningioma	0
sugary foods	thermal hypesthesias	0
frequent meals	cancer of brain	0
peanut	brain disease	0
caramel	prion-induced disorders	0
cardamon	human mammary carcinoma	0
pecan	parodontose	0
egg	growth hormone receptor deficiency	0
linum	leukovirus	0
healthier meat	foodborne botulism	0
coriandrum	spondylitis ankylopoietica	0
raw cranberries	rachitis	0
black raspberries	vitamin deficiency	0
fatty foods	oncogenese	0
morinda	ankylosing spondyloarthritis	0
cassia trees	food-borne illnesses	0
drug administration united states food	schizophrenic disorders	0
pimenta officinalis	small round-structured viruses	0
laudable legume	non-hodgkin's lymphoma	0
ginger	somatotropin hypersecretion (acromegaly) syndromes	0
century plant	colorectal carcinomas	0
assai palm berries	myocardial ischemia	0
largest meal	gastroenteritide	0
swordfish	orf	0
weed	gluten-sensitive enteropathy	0
regular carrots	vitamin deficiencies	0
brown rice	multiple myositis	0
club soda	hepatic neoplasm	0
actual licorice	oncogenese	0
fennel seeds	autosomal recessive juvenile parkinson disease 2	0
margarine	cancer of the ovary	0
mock meats	alactasia	0
black beans	sudden cardiac arrest	0
fructose corn	small cleaved cell lymphoma	0
anacardium occidentales	thyroid carcinoma	0
overpriced vitamin	diabetic retinopathies	0
zingiber officinale	diffuse small cleaved-cell lymphoma	0
bitter nightshade	familial tremor	0
little saffron	dysmenorrhea	0
salami	irritable colon	0
chile peppers	undifferentiated lymphoma	0
chenopodium quinoa	bovine lymphosarcoma	0
incorporate cloves	stomach neoplasms	0
poppy	prion diseases	0
english plantains	psammomatous meningiomas	0
mango	amnesia memory loss	0
sweet basils	multiple head injuries	0
processed apples	parkinsonian syndromes	0
ocimum sanctum	pseudotumor cerebri	0
squash plants	rash	0
frosting	transmissible spongiform encephalopathies	0
zingiber officinales	malignant epithelial neoplasm	0
lemon tree	inherited human transmissible spongiform encephalopathies	0
malabar nut	reproductive sterility	0
breakfast cereals	dizzyness	0
american meat	malignant melanomas	0
butter milk	transmissible dementias	0
solanum dulcamara	vaginitis	0
anti-inflammatory plant	prostatic intraepithelial neoplasias	0
split pea	disorders of initiating and maintaining sleep	0
citrus sinensis	migratory pain	0
daily fruit	cough	0
individual candy	fatty liver disease	0
white tea	cephalalgia	0
triticum durum	chronic pain	0
chocolate bars	obesity virus	0
fortify milk	osteoporosis	0
multivitamin	liver cancers	0
citrus reticulata	bilateral sciatica	0
betel nuts	utp-hexose-1-phosphate uridylyltransferase deficiency disease	0
kangaroo meat	zoonotic infectious diseases	0
pistacia	avitaminose	0
sparkling water	galactose-1-phosphate uridyl-transferase deficiency disease	0
pummelo trees	uterine cancers	0
white bread	primary fibromyalgias	0
juglans nigra	generalized headache	0
soymilk	multiple myositis	0
rose	cll lymphoplasmacytoid lymphoma	0
cherry plum tree	mouth cancers	0
flax	heart decompensation	0
triticum spelta	pregnancy pernicious vomiting	0
decaf	diverticula	0
anacardium occidentale	somatotropin hypersecretion syndromes (acromegaly)	0
brassica nigra	thyroid carcinomas	0
spicy food	prostatic hypertrophy	0
iv vitamin	benign prostatic hyperplasia	0
energy drink	craniocerebral injuries	0
afzelia	virus diseases	0
carica	head pain	0
cream cheese	tongue cancers	0
goji berry plants	pregnancy induced diabetes	0
marijuana	steatohepatitis	0
salmonella food	auriculo-ventricular dissociations	0
althea officinalis	non b hepatitis enterically transmitted non a	0
foeniculum vulgare	nephrolith	0
carya illinoensis	prostatitis	0
chilli peppers	fusiform aneurysms	0
sweet almonds	painful menstruations	0
drinking water	colorectal carcinoma	0
yogurt	spindle cell carcinoma	0
pecan trees	diffuse mixed-cell lymphomas	0
rice milk	testis neoplasm	0
rye	manic state	0
know nuts	small non cleaved cell lymphoma	0
white meat	hyperpigmentation	0
so-called meat	insomnia disorder	0
lycium barbarum	pancreatitis	0
opium poppies	kidney cancers	0
kombucha teas	testicular neoplasms	0
veal	sudden infant death	0
cortland	hypospadia	0
plum tree	dizzyness	0
lycium	ekbom psychogenic parasitosis	0
california avocado	post-traumatic osteoporosis	0
lavandula angustifolia	ovary cancers	0
jelly	pediatric cancers	0
eggplant	age-related bone loss	0
fruit juice	hemicrania migraines	0
cycad trees	necrotizing fascitides	0
fermented cabbage	bladder tumor	0
soybean	recurrence	0
pineapple	complications of diabetes mellitus	0
gooseberry	impaired sensations	0
phaseolus vulgari	cerebrovascular stroke	0
eating broccoli	syndrome	0
blackberry	gasser syndrome	0
squash seeds	renal calculus	0
coconut water	age related osteoporosis	0
ranking foods	high cholesterol level	0
safflower	vitamin deficiency	0
shan yao	apnea	0
roselle	bovine lymphoma	0
lens plant	wart	0
pistachio nut tree	foreign object	0
sustenance	arterial dysfunction	0
texturized soy proteins	histamine cephalgias	0
brewed coffee	prion induced disorder	0
poisonous plants	stomach ulcers	0
chinese yam	multiple meningiomas	0
fagopyrum tataricum	human herpesvirus 4 (gamma)	0
açai berry	peanut hypersensitivity	0
carya illinoenses	royal free disease	0
juglan	foodborne botulism	0
dioscorea opposita	salmonella infections	0
cucurbita	galactose 1 phosphate uridyl transferase deficiency disease	0
beta vulgari	barrett metaplasia	0
brown sugar	ache	0
legume pods	saturnine tremor	0
flax seeds	developed cancer	0
rise	chronic diseases	0
deli meat	idiopathic intracranial hypertension	0
nut bars	contagious pustular dermatitis	0
watermelon	pancreatic neoplasms	0
zedoary zedoarias	osteoarthritis	1
cauliflower	hiatal hernias	0
dinner time	cancer of the tongue	0
horsenettle	olfaction disorder	0
specific nuts	peripheral autoimmune demyelinating disease	0
coconut milk	parkinsonian disorders	0
drink milk	parkinsonism	0
toxic plant	iritis	0
soy food	bilateral sciaticas	0
mayo	muscle pain	0
espresso	human immunodeficiency virus	0
food company	soft tissue sarcomas	0
cookie	male breast tumors	0
safflower oil	iodine deficiency	0
golden glow	water stress	0
lemon balms	acute confusional migraine	0
smoked foods	minor head injuries	0
include apples	human immunodeficiency virus	0
meal times	amnestic state	0
pomelo trees	johne's disease	0
vaccinium myrtillus	sleep related neurogenic tachypnea	0
leaf lettuce	occipital region traumas	0
pomegranate	aphthous stomatitis	0
sweet foods	lead poisoning	0
cola nitida	kidney insufficiency	0
wild radish	grave’s disease	0
baby carrots	deep venous thrombosis	0
mother cells	long sleeper syndromes	0
tea	virus	1
faba bean	bechterews disease	0
flavourer	sore throat	0
colocasia	anticancer	0
vegetable oil	spinal cord disease	0
orange trees	chronic b-lymphocytic leukemia	0
machaerium	tick bite	0
mint tea	todd paralysis	0
plant aril	acute monoblastic leukemia	1
soda waters	infantile obesity	0
betel	renal neoplasm	0
safflower oils	varicose veins	0
soy proteins	adolescent obesity	0
trigonella foenum-graecum	infarction	0
mustard plants	retained surgical needle	0
psyllium	urinary bladder neoplasms	0
andean blackberries	physical sufferings	0
feather meal	abdominal migraine	0
cynara scolymus	experimental lung inflammation	0
citrus hystrices	malignant epithelial neoplasm	1
althaea	human t lymphotropic virus type iii	0
chili	ischemia	0
glycyrrhiza glabra	new variant creutzfeldt jakob disease	0
prunus armeniaca	creutzfeldt-jakob disease	0
sea vegetables	cancer of the ovary	0
dietary supplement	obesity	1
malus	endotoxemia	0
vaccinium virgatum	androgenetic alopecia	0
mangifera indica	intracranial central nervous system disorders	0
whole grain cereal	carcinoma of endometrium	0
sell meat	colon neoplasms	0
roundup-ready soybeans	uterus neoplasms	0
bt corn	scurvy	0
infant formula	dental disease	0
solanum laciniatums	meningiomatosis	0
phaseolus acutifolius	food hypersensitivity	0
ground flax	post-traumatic osteoporoses	0
indian corn	pulmonary embolism	0
pine nuts	galactosemia 3	0
black pepper	ischemic heart disease	0
fast foods	ebv	0
vicia fabas	venous thrombosis	0
prebiotic	bone cancer	0
nitrate-rich vegetables	fibroadenoma	0
intoxicant	painful menstruation	0
citrus aurantiums	congenital abnormalities	0
cod	wheat allergy	0
pomelo tree	benign meningiomas	0
sushi	vulvar neoplasms	0
wild celeries	breast fibrocystic disease	0
msg	senile osteoporosis	0
foenumgraecum	cancer of the thyroid	0
plantago arenaria	cancer of the ovary	0
scrambled eggs	prostatic intraepithelial neoplasias	0
club sodas	esophagus neoplasms	0
clathrotropis	cattle leukemia virus	0
halibut	open head injuries	0
citrus fruit	male breast neoplasms	0
cinnamon	cardiac failure	0
syzygium jambos	malignancy	0
fagopyrum esculentum	social anhedonia	0
copaifera	inappropriate growth hormone secretion syndrome (acromegaly)	0
acer	igf-1 deficiency	0
haritaki fruit	fifth phacomatosis	0
buttermilk	superficial head injury	0
lard	thrombus	0
ganja	visceral steatoses	0
eugenia jambos	kidney calculi	0
maple syrup	intention tremors	0
contaminated meat	degenerative neurologic disorders	0
vaccinium macrocarpon	high-grade lymphomas	0
chamomile oil	mad cow disease	0
grape seeds	abdominal pains	0
almond	pulmonary inflammations	0
garcinia mangostana	oral neoplasm	0
chinese cassia	chronic lymphoblastic leukemia	0
tree nuts	lichen rubra planus	0
coffee	lymphadenopathy-associated virus	0
radish	cancer of the testes	0
domestic fowl	bladder tumors	0
lemon balm tea	uterus cancer	0
kava kavas	necrotizing fascitides	0
piper nigrum	kidney cancer	0
sunflower seeds	grippe	0
hickory trees	cancer of the liver	0
origanum	muscle disease	0
pasta	dyslipidemia	0
elettaria cardamomum	endometriosis	0
horsebean	malignant brain neoplasm	0
eating almonds	exanthem	0
citrus bergamia	galactokinase deficiency	0
noncaloric sweetener	study cancer	0
macadamia nuts	remittent fever	0
vaccinium ashei	fibrositide	0
flavorer	coarse tremor	0
dress	rna tumor viruses	0
foie gras	long sleeper syndromes	0
narrow leaved plantain	postural syncopes	0
antioxidant-rich food	sneezing	0
probiotic	aura	0
plum	malignant epithelial tumor	0
chestnut	multiple sclerosis	0
chai tea	et-nanbh	0
areca	crohn’s disease	0
soy milk	gorlin syndrome	0
peppermint oil	multiple meningioma	0
kiwi fruit	chromosome 6 linked autosomal recessive parkinsonism	0
worldwide fruit	psammomatous meningioma	0
pear	cancer of kidney	0
vegetable protein	cancer of thyroid	0
callerya	liver dysfunctions	0
plantago lanceolata	medical conditions	0
chamomile oils	bleed	0
white mallow	kanner's syndrome	0
eden foods	cystic disease of breast	0
grape juice	stomach ulcer	0
illicium verum	ph1-negative myeloid leukemias	0
capparis	hepatic cancers	0
andropogon nardus	drunkenness	0
vaccinium bracteatums	allergic reaction	0
conventional food	inappropriate growth hormone secretion syndrome (acromegaly)	0
dietary plant protein	tonic seizure	0
citrus limon	oncogenic viruses	0
ground ginger	gorlin-goltz syndrome	0
goji berry plant	sliding hiatal hernias	0
drinking milk	lichen rubra planus	0
ilex paraguarienses	back pain without radiation	0
morinda citrifolia	uveitide	0
treat	mouth cancer	0
high fructose corn syrup	head injury	0
almond tree	foreign objects	0
mustard	gustatory seizure	0
curcuma longas	increase cancer	0
healthiest snack	hepatic neoplasm	0
kombucha tea	osteoarthrosis deformans	0
emphasizes vegetables	polyradiculoneuritis	0
tarragon	et-nanbh	0
elettaria cardamomums	persistent atrial fibrillations	0
nicotiana	jaundice	0
longevity legumes	neonatal tremors	0
vegetarianism	venereal warts	0
food allergies	growth hormone insensitivity syndrome	0
eugenia malaccensis	preterm birth	0
star anises	heatstroke	0
low vitamin	deformity	0
hibiscus sabdariffa	steatohepatitide	0
apricot	age related bone loss	0
garlic sauce	epileptic seizures	0
emblica officinalis	impaired sensations	0
carrot	cephalgia	0
cayenne peppers	wound botulisms	0
infects apples	gastroenteritis	0
artificial sweeteners	diffuse mixed cell lymphoma	0
processing meat	dizzyness	0
fagopyrum sagittatum	pneumonitis	0
mustard greens	type 1 diabetes mellitus	0
mentha	endometriose	0
avoid peanuts	cholera	0
rubus idaeus	esophagus cancers	0
java plum trees	crohn’s disease	0
kaffir lime	sleep related neurogenic tachypnea	0
solanum dulcamaras	landry-guillain-barre syndrome	0
carob	brain vascular accidents	0
cured meat	tonic clonic seizures	0
healthiest nuts	coma	0
acer saccharum	acute fulminating multiple sclerosis	0
brussel sprout	autosomal dominant. juvenile parkinson disease	0
find pork	cancer of the rectum	0
shiitake	spontaneous abortions	0
kiwi	generalized seizure	0
vaccinium corymbosum	aura	0
mandarin orange tree	oral neoplasms	0
tulsi tea	syncopal vertigo	0
peppermint	mixed lymphocytic histiocytic lymphoma	0
hemp plants	colorectal cancer	0
grape	hyperventilation syncopes	0
cuminum cyminum	body weights	0
cooking meat	tonsil neoplasms	0
diospyros digynas	ovary neoplasms	0
chicken	infectious virus	0
citrus-based fruits	zoonotic infectious disease	0
pudding	multiple head injuries	0
common bean plant	ekbom psychogenic parasitosis	0
pie	prelingual deafness	0
cleistocalyx	eczema	0
faba beans	aura	0
lemongrass	cysticercose	0
sweeten	charcot disease	0
specific cheeses	nevoid basal cell carcinoma syndrome	0
oats	prostatic intraepithelial neoplasia	0
soy foods	sleep-related neurogenic tachypnea	0
secale	foreign body	0
amla	joint diseases	0
fat foods	brains cancer	0
citrus x paradisi	galactosemia 3s	0
tumeric	environmental cancer	0
triticum	pulmonary inflammations	0
fat milk	oral cancer	0
processed foods	hepatocellular cancer	0
okra	blindness	0
bok choy	autosomal recessive juvenile parkinsonism	0
morning meals	endemic cretinism	0
lavandula	atherosclerotic plaque	0
venison	guillaine barre syndrome	0
tea plant	human mammary carcinomas	0
indian laburnums	heart diseases	0
tepary bean	lens opacity	0
holy basils	cancer of the kidney	0
rheum tanguticum	generalized headaches	0
split peas	retroviridae	0
added nuts	schilling-type myeloid leukemia	0
ready-prepared foods	diabetic neuralgia	0
refined olive	monoblastic leukemia	0
soybean proteins	fatty liver disease	0
applesauce	cancer of the stomach	0
artificial sweetener	substance-induced organic mental disorders	0
organic meat	itch	0
carica papaya	epithelioma	0
tv dinners	insulin-dependent diabetes mellitus 1	0
reindeer meat	leucocythaemia	0
frying meat	thyroid diseases	0
hemp plant	hemangiopericytic meningioma	0
citrus grandi	male breast neoplasms	0
anacardium	benign neoplasm	0
placenta	cancer of skin	0
leek	visceral steatoses	0
smoked food	lung cancer	0
stevia rebaudianas	basal cell epithelioma	0
purple cabbage	huntington’s disease	0
plantago ovata	pancreatic cancers	0
isoglucose	hypermelanose	0
assai palm	cephalalgia	0
purslane	degenerative neurologic disease	0
blueberry plants	hyperpigmentation	0
radicchio	fibrosis	0
fennel	episodic cluster headache	0
hibiscus	familial parkinson disease	0
lipomul	acute monocytic leukemias	0
saffron crocus	gastric neoplasms	0
baby spinach	papillary meningiomas	0
vital nutrients	gut dysfunction	0
portulaca	ocular headache	0
poroporo	penile neoplasm	0
rubus	diabetic amyotrophies	0
extracted fruit	dysosmia	0
flowering shrub	throbbing headache	0
raphanus raphanistrum	pseudopelade	0
flammulina	breast carcinomas	0
foeniculum vulgares	ramsay hunt paralysis syndrome	0
common plant	resting tremors	0
pea family	non epileptic convulsion	0
hot peppers	brain cysticercosis	0
kawa kawa	melanoma	0
avocado fruit	chronic headache	0
floret	icterus	0
dietary sugars	spindle cell carcinoma	0
oat	craniocerebral injuries	0
red pepper	food-borne disease	0
thymus plants	lymphadenopathy-associated virus	0
healthy food	basal cell nevus syndrome	0
cannabi	celiac disease	0
green beans	paroxysmal atrial fibrillation	0
convenience foods	acute inflammatory polyneuropathies	0
norovirus food	premenstrual tensions	0
cereal grains	androgenic alopecias	0
capsicum	hypoesthesia	0
plant-based nutrients	intraorbital meningioma	0
porphyra	brain cancer	0
althaea officinalis	disk degradation	0
dressing	odontogenic keratocysts multiple basal cell nevi	0
sour orange trees	gehrig disease	0
croaker	mixed cell lymphoma	0
baptisia	endometrial carcinoma	0
dietary fiber	neurocysticercosis	0
berberis	diabetes complication	0
oregano plant	hysterical amnesia	0
rose hips	malignant melanoma	0
tap water	olfactory seizures	0
maraschino cherry	cancer of bladder	0
apple trees	colon neoplasms	1
cooked meats	cancer of the rectum	0
milkshake	breast malignant tumor	0
mirobalanus embilicas	dyschezia	0
narrow-leaved plantain	acromegaly	0
ocimum basilicums	higher cancer	0
medicago sativa	tonic seizure	0
hawthorn	faint	0
orange tree	chronic obstructive lung disease	0
digitalis	stokes adams syncope	0
healthy snacks	anosmia	0
sardine	pulmonary disease	0
cannabis	androgenic alopecia	0
eating nuts	condylomata acuminata	0
trompillo	chronic daily headaches	0
golden delicious apples	cognitive impairment	0
pimenta	prostatic neoplasm	0
organic foods	liver steatosis	0
whole grain cereals	phage	0
preserved food	genital wart	0
soy protein	food hypersensitivities	0
rheum rhaponticum	disc degradation	0
origanum vulgare	lung disease	0
beverage	leucocythaemia	0
solanum melongenas	familial atrial fibrillations	0
pumpkin	breast neoplasm	1
cymbopogon nardus	galactosemia	0
justicia adhatoda	fibrocystic changes of breast	0
common olive tree	lobar pneumonia	0
justicia	vaginal discharges	0
rooibos tea	liver injury	0
gluten-free diet	kahler disease	0
rutabaga	burkitt herpesvirus	0
vitis	cirrhosis	0
cayenne pepper	hypospadia	0
raisin	hypospadia	0
cabbage	retained surgical needle	0
crab apple	diabetic neuropathies	0
sausage	ovarian neoplasm	0
fast food	pregnancy induced diabetes	0
brewing tea	feline leukemia viruses	0
pleurotus	oral cancer	0
ultra-processed foods	galactosemia 2s	0
nonus	endometrium cancers	0
chia seeds	primary brain tumor	0
oyster mushrooms	neoplasm metastases	0
sugar maple	amentia	0
soy sauce	bacterial vaginosis	0
dioscorea batatas	fibrocystic mastopathy	0
horse nettles	hysterical amnesia	0
asparagus	vulva cancer	0
butter	arterial fatty streaks	0
added sweeteners	nephrolith	0
coca	migraine headaches	0
dietary plant proteins	guam form of amyotrophic lateral sclerosis	0
mother cell	lyme arthritis	0
sesame oils	headache disorder	0
plaice	irritable bowel syndrome	0
calendula officinali	recrudescence	0
drinking orange	headache disorder	0
deep-fried foods	disseminated sclerosis	0
wild yam	cerebrovascular accidents	0
carthamus tinctorius	malignant brain neoplasm	0
oreo	mammary dysplasia	0
sweet marjorams	spindle cell sarcoma	0
frier	persistent tremor	0
sesame seeds	lou gehrig disease	0
spice saffron	cancer of vulva	0
glucose-fructose syrup	pattern baldness	0
red rice	small noncleaved-cell lymphoma	0
barley coffee	galactosemia 2s	0
millet	mucous colitis	0
shoot	feline leukemia viruses	0
cocos nucifera	visceral steatoses	0
rabbit meat	preinvasive carcinoma	0
diospyro	cervicitis	0
euterpe oleracea mart.s	nasal cavity cancer	0
plantago seed	apoplexy	0
herb	chest pains	0
squid	urinary bladder cancer	0
salsa	sinusitide	0
butternut squash	gnathostoma infection	0
sandwich	familial guillain-barre syndrome	0
arachis	memory losses	0
adhatoda vasica	acquired blindness	0
vaccinium uliginosum	thinness	0
favorite meals	bovine leukemia virus	0
no meat	condylomata acuminata	0
plantain	b-cell chronic lymphocytic leukemia	0
humulus	chronic illnesses	0
dioscorea villosa	rheumatoid spondylitis	0
flounder	somatotropin hypersecretion syndromes (acromegaly)	0
flaked coconut	jakob creutzfeldt syndrome	0
beta vulgaris	parkinsonian diseases	0
cider vinegar	recurrent low back pain	0
petroselinum crispums	barretts syndrome	0
crocus sativus	uterine neoplasms	0
taking vitamin	fibrous meningioma	0
broccoli raab	orthostasis	0
red delicious	chronic b-lymphocytic leukemia	0
banana plant	spinal cord degenerative diseases	0
carbonated waters	delusory parasitosis	0
mashed potatoes	memory loss	0
raw poultry	drug use disorder	0
apple juice	breast fibrocystic changes	0
maple	auricular fibrillations	0
dinner times	bipolar depression	0
low-sodium diet	vulvar neoplasms	0
jerusalem artichokes	wound botulism	0
little meat	udpglucose hexose 1 phosphate uridylyltransferase deficiency	0
not-necessarily-so-healthy foods	sudden infant death	0
organic plants	enzootic bovine leukoses	0
prunus salicina	alactasia	0
cassia tree	a-v dissociation	0
rye bread	bovine leukoses	0
corn syrup	spindle-cell carcinomas	0
neutraceutical	ekbom psychogenic parasitoses	0
licorice	cll lymphoplasmacytoid lymphomas	0
persea americanas	recurrent brain tumor	0
euterpe edulis	breast pains	0
yoghurt	deep-venous thromboses	0
dietary sucrose	gasser's syndrome	0
saint john wort	weight gains	0
opium poppy	pleomorphic lymphomas	0
whipped cream	congestive heart failure	0
pimiento	enterocele	0
prenatal vitamins	weight gain	0
jalapeno pepper	backache	0
rubus glaucus	fibromyalgia-fibromyositis syndrome	0
seed	manic depressive psychoses	0
yam	drop attacks	0
walnut	headache disorders	0
oyster mushroom	complete blindness	0
cucumis melo	episodic cluster headache	0
apricot trees	hypertension	0
fryer	galactokinase deficiency disease	0
bean sprouts	rectal tumors	0
spinach	autosomal dominant parkinsonism	0
emphasize plant	alzheimer’s disease	0
glycine max	hydrophobia	0
black teas	cancer of the thyroid	0
healthy snack	fibromyositis-fibromyalgia syndrome	0
snack food	ponv	0
red wine	posterior compartment low back pain	0
healthiest foods	thrombose	0
fig	skin disease	0
vaccinium angustifolium	norwalk like viruses	0
cannabis sativas	renal cancers	0
chard	recurrent low back pain	0
atropa belladonna	psychogenic parasitoses	0
hydroponic basil	gastric cancer	0
holy basil tea	breast cancers	0
texturized soy protein	hepatic neoplasms	0
fruit juices	carotid sinus syncopes	0
broth	ciliary neuralgias	0
black walnut	wart viruses	0
flavoring	minor head injury	0
psidium guajavas	thyroid carcinoma	0
melissa	non hodgkin lymphoma	0
golden raisins	regional enteritis	0
white mallows	fine tremors	0
dried peas	reversing chronic disease	0
olea	breast dysplasia	0
leafy vegetables	lou-gehrigs disease	0
salmonella-infected eggs	non hodgkin's lymphoma	0
nut bar	lung disorders	0
saccharomyces cerevisiae	cerebral convexity meningioma	0
raw food	cervical migraine syndromes	0
solanum melongena	epithelioid sarcomas	0
nuclear power plant	bacterial infection	0
cocoa plant	hemorrhoid	0
pimpinella anisums	sudden cardiac death	0
acer negundos	neurodegenerative disorder	0
coca cola	severe gh insensitivity	0
chocolate	cancer of cervix	0
ale	galactokinase deficiency	0
soft drink	chronic daily headache	0
poppy seeds	exanthem	0
cinnamomum zeylanicum	food hypersensitivity	0
soft drinks	back pain with radiation	0
different seed	premenstrual tensions	0
kola nuts	intermediate-grade lymphoma	0
english walnuts	post-traumatic osteoporoses	0
veggie	ciguatera fish poisoning	0
persea americana	arterial fatty streaks	0
food colors	diverticulum	0
citrus sinenses	cadaver	0
plant kingdom	nonalcoholic fatty liver disease	0
cupcake	galactose-1-phosphate uridyltransferase deficiencies	0
drinking tea	epithelial cancers	0
acid-binding vegetables	inner ear cancer	0
cereal	male pattern alopecia	0
dinnertime	graves disease	0
food companies	familial juvenile parkinsonism	0
lemon balm	involutional osteoporosis	0
acai berry	marie-struempell disease	0
buckwheat	arthrosis	0
zedoary zedoaria	eczema	0
junk foods	acidose	0
prunus salicinas	suppuration	0
curried tofu	human t lymphotropic virus type iii	0
whole foods	tactile amnesias	0
oxen meat	pruritis	0
amorpha	polymyositide	0
eggnog	food-borne diseases	0
punicaceae	encephalon disease	0
carbonated drinks	fibrocystic disease of breast	0
marjoram plants	vulva cancer	0
turmeric root	irritable colon	0
seville orange tree	malignant melanomas	0
national meat	gastric ulcer	0
euterpe oleracea	well differentiated lymphocytic lymphoma	0
allium cepa	peanut allergy	0
black sapotes	penile neoplasms	0
pithecolobium	malignant tumor of breast	1
real chocolate	myalgic encephalomyelitis	0
woodland strawberries	myelogenous leukemia	0
papaver somniferum	gallbladder diseases	0
almond trees	lav-htlv-iii	0
tempeh	apneas	0
common foxgloves	cancer of the breast	0
pithecellobium	stomach neoplasm	0
euterpe precatoria	back ache	0
amygdalus communis	disorientation	0
root	back pains	1
amlas	crushing pain	0
chickpea	barrett's syndrome	0
decaffeinated tea	myelomatosis	0
dioscorea	well differentiated lymphocytic lymphoma	0
red tea	male pattern baldness	0
rooibos	male breast cancer	0
navy beans	ph1-negative myeloid leukemia	0
boiled broccoli	germinoblastoma	0
canned foods	diffuse mixed small and large cell lymphoma	0
cured meats	eczema	0
silybum marianums	atherosclerose	0
cereal grain	papillomaviridae	0
black rice	high cholesterol levels	0
herr	parkinsons disease	0
red peppers	basal cell epithelioma	0
olive oil	coma	0
cannabis indica	ankylosing spondyloarthritis	0
agent orange	congenital abnormality	0
punica granatums	galactokinase deficiencies	0
red meat	sleep-related neurogenic tachypnea	0
phyllanthus emblicas	age related maculopathies	0
prunis communis	thyroid adenoma	0
ready-to-eat meal	memory disorder	0
fagopyrum	acne vulgaris	0
secale cereale	et-nanbh	0
stuff	testis cancer	0
elephant garlic	disk degradation	0
goiaba	benign meningiomas	0
poultry product	open head injuries	0
beetroot	bladder tumor	0
cocoa powder	infectious mononucleosis virus	0
laciniate nightshades	abdominal obesities	0
almond butter	sleeplessness	0
almond oil	dyspepsia	0
mastic tree	lymphoma	0
broad beans	central nervous system degenerative diseases	0
foodstuff	sleep initiation dysfunctions	0
cocoa	undifferentiated carcinoma	0
flammulina velutipes	mucous colitis	0
reason food	male sub fertility	0
fried foods	cluster headache	0
food manufacturers	burning pain	0
powdered sugar	juvenile-onset diabetes	0
plant embryos	anxiety disorder	0
rosehip	primary brain tumor	0
mirobalanus embilica	juvenile parkinson disease	0
musa	disorder	0
component spices	oncogenese	0
barley	idiopathic polymyositis	0
plant capsules	saturnine tremors	0
petroselinum crispum	monocular blindness	0
phytonutrient-rich food	acne vulgaris	0
ocimum basilicum	paralysis	0
foxglove	granulomatous enteritis	0
canned food	cervical cancer	0
chocolate pudding	hiccup	0
areca catechu	cerebral stroke	0
healthiest beverages	leukemia	0
maize	manic depressive psychoses	0
color	age related macular degeneration	0
aloe vera	familial atrial fibrillation	0
syzygium malaccense	diarrhea	0
alfalfa	cadaver	0
dietary fats	kidney neoplasm	0
jambolan plum trees	dementia praecox	0
kale	primary malignant brain neoplasms	0
pinto beans	type i diabetes mellitus	0
grilled meat	central nervous system intracranial disorders	0
citrus aurantium	virus disease	0
soy bean curds	cognitive impairments	1
cannabis sativa	autosomal dominant juvenile parkinsonism	0
anana	orthostatic headaches	0
chilli pepper	toxico-infectious botulism	0
vitamin	b-cell chronic lymphocytic leukemia	0
ilex paraguariensis	diabetic autonomic neuropathy	0
myristica fragrans	tonic seizures	0
poultry	multiple head injury	0
pomegranate seeds	blood clot	0
filtered coffee	common bile duct gallstones	0
bolete	neuralgic migraines	0
humulus lupulus	mastitis	0
olive tree	female sub-fertility	0
natural vitamin	deglutitional syncopes	0
aquatic food	gastric cancers	0
collard	als (amyotrophic lateral sclerosis)	0
acaí berries	myocardial ischemia	0
frozen cranberries	intraepithelial neoplasms	0
saint john's wort	spindle cell sarcoma	0
green teas	age-related maculopathies	0
miso	respiratory tract cancer	0
cantaloupe	cardiac death	0
blueberry	colonic inertia	0
larder	sliding hiatal hernias	0
citrullus	bronchiolitis obliterans	0
sea bilberries	sleep related neurogenic tachypnea	0
citronella	insulin deficiency	0
food poisoning	idiopathic polymyositides	0
carduus marianus	esophagitide	0
morning meal	diabetic mononeuropathy	0
wild yams	uterus cancers	0
citrus aurantiifolias	hypercholesteremia	0
oolong	ischemic heart disease	0
crunch berries	pharyngitide	0
diabetic diet	cardiac sudden death	0
osmanthus	severe mental disorder	0
kawa kawas	cardiovascular disease	0
nightshade	global amnesia	0
food supplements	lung disorders	0
eugenia sandwicensis	lyme arthritis	0
wild celery	colonic neoplasm	0
maize syrup	deglutitional syncope	0
tepary beans	foodborne botulisms	0
marsh mallow	t virus	0
prunus dulcis	oral neoplasm	0
mentha piperita	salmonella infection	0
eating meat	complications of diabetes mellitus	0
berberi	vaginal discharges	0
last meal	liver diseases	0
green tea	guam form amyotrophic lateral sclerosis	0
tomato	substance induced organic mental disorders	0
apium graveolens	gingivitide	0
black coffee	malignancy	0
morel	galk deficiency	0
brazil nuts	canker sore	0
baked potato	ekbom delusory parasitoses	0
green pepper	mild cognitive impairment	0
no coffee	malignant primary brain neoplasms	0
contaminated foods	neurologic degenerative conditions	0
theobroma cacao	jakob-creutzfeldt syndrome	0
yellow vegetables	avitaminose	0
nori	toxico-infectious botulism	0
healthy fruit	chronic illnesses	0
prosopis	unilateral headaches	0
milk thistle	physical anhedonia	0
andira	chronic fatigue disorder	0
pickled foods	zoonotic diseases	0
chili pepper	thyroid adenomas	0
legume pod	myocardial failure	0
atropa belladonnas	clear cell meningioma	0
healthy nuts	age-related memory disorder	0
organic food	secondary insomnia	0
corn sugar	burn	0
serve	macular dystrophy	0
snail meat	reticuloendotheliosis viruses	0
coconut	microglandular adenoses	0
açaí berries	menstrual pains	0
raphanus	hyperphagia	0
food pyramid	utp-hexose-1-phosphate uridylyltransferase deficiency disease	0
store licorice	pulmonary thromboembolisms	0
carbonated beverage	muscle tenderness	0
sugar-sweetened beverages	classic galactosemias	0
pimenta diocia	brain benign neoplasm	0
bamboo shoots	muscle pain	0
pea families	cow disease	0
specific foods	acute cerebrovascular accidents	0
acer negundo	vestibular seizure	0
crave chocolate	male breast neoplasm	0
sun-dried raisin	new variant creutzfeldt jakob disease	0
mastic trees	delusory parasitoses	0
true nut	colon disease	0
chervil	passive tremor	0
poppy seed	burning pains	0
bertholletia excelsas	high-grade lymphomas	0
dog rose	chronic fatigue syndromes	0
plantago indica	angioblastic meningioma	0
common foxglove	migraine disorder	0
dried foods	upper respiratory tract infections	0
basil	zoonotic infectious disease	0
thyme	erectile dysfunction	0
carica papayas	hansen disease	0
goji berries	global amnesias	0
vitamin pills	colitide	0
ficus	different cancer	0
milk proteins	hypercapnia	0
ephedras	spinal cord disorders	0
steamer	diabetic amyotrophies	0
coco	feline leukemia virus	0
steak	hair losses	0
greenery	cardiac dysrhythmia	0
eat flax	skin cancer	0
paella	low back aches	0
herbal tea	diabetic autonomic neuropathies	0
measuring food	endocrine breast disease	0
baby formula	vaginal cancers	0
bibhitaki fruit	increased cancer	0
seven nutrients	paratuberculosis	0
caryophyllus aromaticus	malignant tumor of urinary bladder	0
gala apples	pleomorphic lymphomas	0
whiting	mammalgia	0
rice	appendicitis	0
cycad	physical suffering	0
low-salt diet	ph1-negative myelogenous leukemia	0
illicium	malaria	0
fresh fruits	muscle disease	0
dietary fat	mixed lymphocytic-histiocytic lymphomas	0
chinese rhubarb	leucocythemia	0
melissa officinalis	anal ulcers	0
mangosteen	common cancers	0
trace minerals	diabetic autonomic neuropathies	0
celeriac	fights cancer	0
citrus medicas	experimental lung inflammations	0
banana plants	vaginal discharge	0
rosa	anxiety disorder	0
consumed chocolate	rectum neoplasm	0
yerba mate	remittent fever	0
baker's yeast	torsion fractures	0
juglans regia	jaundice	0
cacao bean	liver dysfunctions	0
romaine lettuce	b-cell chronic lymphocytic leukemia	0
popular fruits	postoperative nausea	0
carbonated mineral waters	gastroesophageal reflux disease	0
tuna fish	motion sickness	0
soy cheeses	aphthae	0
celery root	experimental parkinson diseases	0
triticum vulgare	acquired immunodeficiency syndromes	0
meal	heart block	0
mangifera	male breast neoplasm	0
turkey meat	brain diseases	0
abelmoschus esculentus	vertiginous seizures	0
earl grey tea	gehrig's disease	0
replenish nutrients	ulcerative colitis type inflammatory bowel disease	0
flesh foods	common colds	0
olive oils	weight loss	0
kidney beans	galactose 1 phosphate uridyltransferase deficiency	0
citron trees	parkinson disease 2	0
digitalis lanata	diabetic mononeuropathy	0
suggesting apple	sleep initiation dysfunction	0
fruit-shaped marshmallows	kidney disease	0
marjoram	severe mental disorder	0
roughage	basal cell epitheliomas	0
dried apricots	papillary meningiomas	0
spore	torsion fracture	0
da huang	fibroatheromatous plaques	0
avenas	multiple myositides	0
bertholletia excelsa	intraventricular meningioma	0
different fruits	abdominal aortic aneurysms	0
raisin bran	epithelial cancers	0
raphanus sativus	pregnancy pernicious vomiting	0
bread mold	congenital hypothyroidism	0
walnut oil	diabetes-related complication	0
biometal	premenstrual syndromes	0
ceylon cinnamon	gerd	0
fed beef	cancer of uterus	0
citron tree	substance-related disorders	0
java plum tree	cranial pains	0
pimenta diocias	muscular spasms	0
banana	carcinogenic retroviruses	0
ready prepared foods	oral neoplasms	0
guibourtia	basal cell carcinomas	0
restrict food	plasma-cell myeloma	0
lemon trees	motion sickness	0
granny smith apples	spontaneous abortion	0
eupatorium rebaudianum	transmissible dementias	0
incorporates cloves	pituitary dwarfism iis	0
maguey	acute fulminating multiple sclerosis	0
chamomile tea	pneumonitis	0
unfiltered coffee	barrett epithelium	0
blossom	peanut allergy	0
garden radish	rectum neoplasms	0
rhubarb	mastitis	0
portulaca oleraceas	bovine lymphoma	0
punica granatum	early infantile autism	0
hypericum perforatum	nausea	0
sugar substitutes	long sleeper syndrome	0
eugenia jambolana	develop cancer	0
soy cheese	prostatic intraepithelial neoplasm	0
food supplementations	hypoascorbemia	0
drink	forehead traumas	0
watercress	hypospadia	0
dried fruit	thyroid diseases	0
oryza sativa	temporary amnesia	0
stryphnodendron	basal cell nevus syndrome	0
carrot juice	variant creutzfeldt jakob disease	0
purine-rich plant	brain neoplasm	0
mentha spicata	oral cancer	0
hypericum	chest pains	0
sugar	spatial memory disorders	0
organic milk	lou-gehrigs disease	0
taro	sleep initiation dysfunctions	0
cucumber	kidney disease	0
durum wheats	anthrax	0
solanum tuberosum	nerve tremor	0
sticker	udpglucose hexose-1-phosphate uridylyltransferase deficiency	0
curcuma zedoarias	regional ileitides	0
spaghetti	e-b virus	0
pisum sativum	carcinomatose	0
honeybush tea	primary fibromyalgia	0
wheat brans	thyroid neoplasm	0
actual fruit	neonatal tremor	0
dasheen	substance use disorder	0
pistachio	cataract	0
arecas	pancreatic cancers	0
brassica	intraepithelial prostatic neoplasias	0
yolk	encephalon disease	0
raspberry	thermal hypesthesia	0
french bean plants	feline lymphoma virus	0
cola acuminata	renal calculi	0
kava	memory losses	0
granny smith	substance abuse	0
carya	alactasia	0
healthiest apple	disc degeneration	0
apple	amyotrophic lateral sclerosis motor neuron disease	0
english plantain	toxic megacolon	0
calendula officinalis	myelomatosis	0
citrus medica	multiple myelomas	0
oregano plants	horton syndrome	0
cinnamomum verum	appendicitis	0
chinese cinnamons	weight loss	0
bran flakes	lung disorders	0
nettle	cervical migraine syndromes	0
monosodium glutamate	ciguatera fish poisonings	0
horsemeat	water borne hepatitis	0
new candy	intraorbital meningioma	0
white wine	overeat	0
new york coalition for healthy school food	weight losses	0
sea vegetable	juvenile parkinsonism	0
lima beans	postpartum sterility	0
triticum aestivum	rebound insomnia	0
fatty meal	male breast carcinoma	0
frozen fruit	respiratory tract infections	0
confection	fibroadenoma	0
citrus maxima	newborn gynecomastia	0
chamomile	secretory meningioma	0
cicer arietinum	vertex headache	0
own vitamin	retained surgical tool	0
big meals	saturnine tremor	0
amomum cardamomums	rest tremor	0
mint	acute inflammatory polyneuropathies	0
licorice root	aphthous ulcers	0
liquor	bovine lymphosarcoma	0
piper methysticum	galk deficiency	0
philadelphia cream cheese	paraosmia	0
target vitamin	experimental parkinson disease	0
sweet orange	hansens disease	0
cruciferous foods	death	0
hot pepper	muscle disease	0
sesame	physical anhedonia	0
squashe	lens opacity	0
crataegus monogyna	congenital defects	0
celebration meal	familial creutzfeldt jakob disease	0
pleurotus ostreatus	fatty liver	0
solanum lycopersicum	cervical neoplasms	0
common olive trees	pancreatic cancer	0
zea	neurologic degenerative condition	0
energy drinks	torsion fracture	0
diabetic diets	progressive disorder	0
cranberry	colon neoplasms	0
coriandrum sativum	pneumonitide	0
sweetened cereal	cll lymphoplasmacytoid lymphomas	0
cocoa butter	micturition syncopes	0
healthy foods	prediabete	0
eat chocolate	leiomyoma	0
wild bananas	wheat allergy	0
noni fruit	bladder cancer	0
cumin	prion disease	0
dark meat	premenstrual tensions	0
indian laburnum	ovary neoplasm	0
gravy	membranous cataracts	0
roasted almonds	periorbital headaches	0
thymus vulgari	forehead trauma	0
japanese plum	body weight	1
corn	cancer of pancreas	0
red yeast rice	galactose-1-phosphate uridylyltransferase deficiency	0
syzygium jambolanum	mental deterioration	0
kava kava	lichen ruber planus	0
candy bar	mesothelioma	0
olea europaea	intracranial meningioma	0
tisane	limb tremor	0
cheese	rhabdomyolys	0
experience food	prion protein disease	0
collard greens	diffuse lymphocytic lymphoma	0
gui zhi	plasma cell myelomas	0
malabar-nut	acute coryza	0
bilberry	mixed lymphoma	0
linum usitatissimum	urticarias	0
glycyrrhiza	upper respiratory infections	0
topical ginger	diabetes-related complication	0
avocado	widespread chronic pain	0
tobacco	prion protein diseases	0
citrus hystrix	vagina neoplasm	0
cicer	parkinsonian syndrome	0
cooked carrots	asymmetric diabetic proximal motor neuropathy	0
narrow-leaved plantains	e b virus	0
maize oils	liver neoplasms	0
cooked meat	transmissible spongiform encephalopathies	0
group foods	cancer of the thyroid	0
stem vegetables	visceral steatoses	0
seville orange trees	sleep initiation dysfunctions	0
hummus	joint disease	0
ice creams	inflammatory demyelinating polyneuropathy	0
lentinus edodes	prion-induced disorder	0
dietary supplements	autoimmune condition	0
grouper	acute inflammatory polyradiculoneuropathies	0
low meat	uterine neoplasm	0
delonix	anxiety disorders	0
orange juice	cranial pain	0
lens culinari	guam form of amyotrophic lateral sclerosis	0
ready-to-eat meals	motor seizures	0
willow tree	vulvar cancers	0
usda poultry	e b virus	0
caffeinated coffee	varicose veins	0
food allergy	lymphatic sarcoma	0
table sugar	liver cancer	0
mangifera indicas	cancer of the bone	0
common bean plants	hyperventilation syncopes	0
yeast rice	weight reduction	0
oregano	acute fulminating multiple sclerosis	0
whortleberry	ekbom psychogenic parasitosis	0
soy yogurt	galt deficiencies	0
soy beans	itch	0
solanum	extreme hearing loss	0
antioxidant food	prostatic intraepithelial neoplasm	0
algarrobo	female subfertility	0
vicia faba	marie struempell disease	0
supper	neurologic degenerative condition	0
mustard plant	dementia	0
syzygium cumini	iron overload	0
century plants	pyrosis	0
mealtime	chronic obstructive pulmonary disease	0
jell-o	dyslipoproteinemia	0
human milk	confusion	0
peanut butter	atopic diseases	0
chinese cinnamon	virus disease	0
eragrostus	hip fractures	0
good soybeans	muscle pain	0
raw foods	gassers syndrome	0
peach trees	delusory parasitoses	0
sweet potatoes	neuritic plaques	0
chewing fruit	uterine cancers	0
strawberry	sudden infant death	0
teff	goiter	0
virgin olive	juvenile parkinsonism	0
bitter nightshades	pustulosis palmaris et plantaris	0
euterpe	amnestic state	0
national pork	dermatozoic delusion	0
assai palm berry	cadaver	0
turnip	gastric cancers	0
alcoholic beverages	sleep disorder	0
cranberry juice	complications of diabetes mellitus	0
soda pops	chronic fatigue syndrome	0
elettaria	infectious disease	0
pistil	venereal wart	0
decrease meat	germinoblastic sarcoma	0
coconut oil	memory loss	0
tuna	laron syndrome	0
deli meats	diabetic autonomic neuropathies	0
animal-based vitamin	paraesophageal hernias	0
soy bean proteins	epithelioid sarcomas	0
lemon grasses	lung inflammation	0
allium sativum	bone fracture	0
endive	male sub fertility	0
fresh basil	intervertebral disk degeneration	0
potassium-rich foods	malignant brain neoplasm	0
jalapeno peppers	deep vein thromboses	0
pimpinella anisum	blood cancers	0
raw meat	subacute spongiform encephalopathies	0
eating eggs	bone neoplasm	0
wine	soft tissue sarcoma	0
nut	aphthous ulcers	0
solanum tuberosums	left-sided heart failure	0
citrus aurantiifolia	amyloid deposits	0
lavender	mucous colitis	0
domestic fowls	bleed	0
indian gooseberries	involuntary quivers	0
deep-fry foods	avitaminose	0
papaver	psoriasis	0
kohlrabi	arthrose	0
soya milk	adenoviridae	0
pummelo tree	malignant epithelial neoplasms	1
pumpkin pie	female subfertility	0
tachigalia	symptom cluster	1
dandelion	fine tremor	0
arachis hypogaea	human mammary carcinomas	0
vodka	eye diseases	0
unfertilized eggs	esophageal neoplasms	0
thymus plant	esophagitide	0
snacktime	reduced sensations	0
anise tea	cjd (creutzfeldt-jakob disease)	0
cayenne	ekbom delusional parasitosis	0
dried plums	leucocythaemia	0
high-fat meal	low backaches	0
nutritional yeast	prostatic adenomas	0
caryophyllus	bipolar disorder	0
mastictree	anticancer	0
bhang	water stress	0
syzygium aromaticum	manic states	0
cow's milk	lou gehrig's disease	0
toronja	pulmonary cancers	0
antioxidant foods	nonalcoholic fatty liver disease	0
rose berries	perforated appendicitis	0
hashish	long sleeper syndrome	0
malus domestica	groundnut hypersensitivity	0
chlorella	preventing cancer	0
cooked broccoli	cll lymphoplasmacytoid lymphomas	0
colorful foods	ovarian neoplasm	0
olive trees	tick bites	0
bean	familial diffuse gastric cancer	0
origanum majorana	colon cancer	0
sea-food	paludism	0
uncooked foods	intermittent tremors	0
pistachio nut trees	testis cancer	0
anticancer plant	galactose 1 phosphate uridyl transferase deficiency disease	0
lunch times	sciatic neuralgias	0
piper methysticums	adolescent gynecomastia	0
syrup	necrotizing fasciitis	0
concord grape	osteoarthrose	0
english walnut	infantile obesity	0
cherry plum trees	plasma cell myelomas	0
popcorn	feline leukemia virus	0
whale meat	secondary fibromyalgias	0
dark chocolate	small and large cleaved-cell lymphoma	0
monitoring food	contagious ecthyma	0
bergamot	syndrome	0
pancake	somatotropin hypersecretion syndrome (acromegaly)	0
cardamom	paraesophageal hernia	0
apple tree	acute strokes	0
dried fruits	bone fracture	0
dietary protein	lactose intolerance	0
allium porrum	increased cancer	0
uncooked food	fights cancer	0
brazil nut tree	genital wart	0
stevia	chronic lymphoblastic leukemias	0
organ meats	allergic diseases	0
processed meat	urticaria	0
oolong tea	painful menstruation	0
shellfish	deaf mutism	0
rooibo	alopecia	0
family vegetables	substance induced organic mental disorders	0
bottled water	acute monocytic leukemias	0
blueberry plant	unilateral headache	0
health food	hepatic cancer	0
frozen spinach	cancer of the testes	0
honey	somatotropin (acromegaly) hypersecretion syndromes	0
sockeye salmon	colonic inertia	0
lens plants	generalized seizure	0
chinese food	hepatic neoplasms	0
garcinia mangostanas	small lymphocytic lymphoma	0
fava bean	food hypersensitivity	0
ground meat	reducing cancer	0
commercial milk	diabetic autonomic neuropathy	0
citrus	cryptogenic epilepsies	0
nut butters	semantic memory disorder	0
alpine strawberries	esophagus neoplasm	1
octopus	cancer of colon	0
mentha spicatas	gehrig disease	0
potato chips	respiratory tract cancer	0
lunch time	colic	0
adding blueberries	congestive heart failure	0
high-phytate foods	food hypersensitivity	0
dinner	auto-immune diseases	0
cola	dyschezia	0
breakfast time	cancer of the prostate	0
dairy yogurt	colon neoplasms	0
crowberry	colorectal tumors	0
mushroom	tying disease	0
digitalis purpurea	olfactory seizure	0
taraxacum officinale	memory deficits	0
camomile	male sub-fertility	0
calendula	auriculo-ventricular dissociations	0
nonfat meal	atypical cluster headaches	0
syzygium	peanut allergy	0
triticum turgidum subsp. durum	gasser's syndrome	0
corn oils	prostate neoplasms	0
cappari	polymyositis ossificans	0
chile pepper	retained surgical instruments	0
dairy products	splitting pain	0
candy bars	skin rash	0
olive	neurodegenerative disease	0
nuclear power plants	mixed small and large cell lymphoma	0
flaxseed	spongiform encephalopathies	0
sugar substitute	bovine lymphosarcomas	0
green onions	peripheral artery diseases	0
trace element	pruritus	0
onion	acne	0
bertholletia	bses (bovine spongiform encephalopathy)	0
porgy	mammalgia	0
cherry	idiopathic parkinson disease	0
soda water	cardiovascular strokes	0
brassica napus	manic state	0
infant formulas	diabetic asymmetric polyneuropathies	0
retail poultry	age-related macular degeneration	0
texturized vegetable proteins	uterus cancers	0
red meats	sleep wake disorder	0
grapefruit	single seizure	0
eating fruits	mixed lymphoma	0
food additive	esophagus cancers	0
hordeum vulgare	low back pain	0
breast milks	mild cognitive impairments	0
trace elements	infectious mononucleosis virus	0
billion eggs	manic disorders	0
soy beverages	rna tumor viruses	0
fenugreek seed	thrombose	0
horse beans	diffuse lymphocytic lymphoma	0
crab apples	rebound insomnia	0
low-fat diet	mixed lymphomas	0
assai palms	vulvar neoplasm	0
carbonated beverages	muscle sorenesses	0
ginger ale	kidney diseases	0
dairy product	limb tremor	0
dried blueberries	drug dependence	0
bell peppers	skin diseases	0