
meal	gustatory seizures	0
prosopis	breast malignant tumors	0
chinese yams	neurodegenerative disease	0
whiting	prostatic hypertrophy	0
carya illinoenses	ovarian cancer	0
solanum tuberosum	insulin deficiency	0
split peas	deep-vein thromboses	0
healthier foods	viral infections	0
family vegetables	hypesthesia	0
dangerous plants	gorlin goltz syndrome	0
veggie	monocytic leukemia	0
avocado	v-cjd (variant-creutzfeldt-jakob disease)	0
vaccinium macrocarpon	semirhythmic tremors	0
saint johnswort	breast pains	0
milk	uterine cervical cancers	0
sparkling water	alopecia	0
breast milk	tonic clonic seizures	0
eating eggs	diabetes mellitus complication	0
citrus grandi	fibromyoma	0
white bread	paraesophageal hernias	0
citrus aurantiifolia	substance addiction	0
zingiber officinale	rna tumor virus	0
avena	pulmonary neoplasm	0
abelmoschus	comatose	0
vodka	static tremor	0
sugary foods	liver dysfunction	0
cappari	influenza	0
chocolate pudding	endotoxemia	0
regular carrots	fibroatheroma	0
curcuma zedoaria	sciatic neuralgia	0
emblica officinali	auto-immune disease	0
poultry product	osteoarthrosis deformans	0
infects apples	premenstrual syndrome	0
preserved foods	diabetic amyotrophy	0
green lentils	halitose	0
white mallow	pulmonary cancer	0
sparkling waters	fifth phacomatosis	0
decaf	uterine fibroids	0
soy cheeses	pyrosis	0
jell-o	manic state	0
antioxidant foods	intermittent tremor	0
cilantro	small round-structured viruses	0
monkfish	myocardial ischemias	0
durum wheats	cerebrovascular accident	0
allspice	tumor of rete testis	0
phaseolus acutifolius	acute cerebrovascular accidents	0
salami	cellulite	0
baby formula	congenital abnormalities	0
acai berries	autistic disorder	0
jalapeno pepper	pneumonitis	0
raw poultry	essential tremor	0
frozen broccoli	status migrainosus	0
burrito	lymphatic sarcoma	0
mustard seeds	persistent atrial fibrillations	0
elephant garlic	cot death	0
coconut milk	htlv-iii	0
sesamum	male breast tumor	0
supper	marie-struempell disease	0
sushi	migratory pain	0
carbonated drinks	wheat allergies	0
holy basils	fibroid uterus	0
purple grape	transmissible dementias	0
sweet orange	vaginal cancers	0
arecas	respiratory tract infection	0
lactuca sativa	hepatitis e	0
added nuts	sleep disorders	0
digitalis	spontaneous abortion	0
chili pepper	broken bones	0
cold-steeping tea	transitional meningiomas	0
alpine strawberries	spinal cord degenerative diseases	0
poppy seed	breast cystic disease	0
milk thistle	foreign objects	0
pistil	johne's disease	0
turnip	birth weights	0
ground flax	deep venous thromboses	0
agent orange	prostatic adenoma	0
calendula	pancreatic neoplasms	0
nut bar	vulvar cancers	0
solanum	acute inflammatory polyradiculoneuropathies	0
syzygium jambolanum	neurological condition	0
store licorice	small non-cleaved-cell lymphomas	0
true nut	juvenile parkinsonism	0
watermelon	basal cell carcinoma	0
so-called vegetable	common bile duct gallstones	0
ilex paraguariensis	nausea	0
sticker	cot deaths	0
food coloring	epilepsy	0
squash seeds	prostatic neoplasms	0
daily nut	cystic disease of breast	0
wild celeries	monocular blindness	0
dinner time	non-alcoholic fatty liver disease	0
fuji apples	sick headaches	0
plum	constipation	0
shiitake mushroom	gluten-sensitive enteropathies	0
chile pepper	premenstrual tension	0
bran flakes	epimerase deficiency galactosemia	0
mackerel	inappropriate growth hormone secretion syndrome (acromegaly)	0
quinoa	non hodgkins lymphoma	0
different seed	vaginal cancers	0
citrus hystrices	colon disease	0
halibut	barrett epithelium	0
wheatgrass	eczematous dermatitides	0
mangiferas	complete blindness	0
euterpe	malignant epithelial tumor	0
flavorer	udp-galactose-4-epimerase deficiency disease	0
mustard plant	anal ulcer	0
lucerne	galk deficiencies	0
cicer	malignant tumor of urinary bladder	0
oatmeal	spinal cord degenerative diseases	0
sugar maple	insomnia	0
isoglucose	ekbom dermatozoic delusion	0
thymus vulgaris	common bile duct gallstones	0
callerya	colorectal neoplasms	0
pummelo tree	cancer of the esophagus	0
ocimum sanctum	abdominal migraine	0
kavas	adolescent obesity	0
mentha spicatas	airsickness	0
sweet pepper	clear cell meningioma	0
octopus	breast cystic disease	0
anacardium	experimental parkinson diseases	0
lens plant	foreign bodies	0
mesquite	central nervous system cysticercosis	0
arugula	juvenile onset diabetes mellitus	0
decrease meat	allergy	0
rye bread	venous thrombosis	0
walnut	oral cancers	0
opium poppy	symptom clusters	0
lunchtime	chronic lymphatic leukemia	0
cuminum cyminums	bse (bovine spongiform encephalopathy)	0
contaminated meat	posterior fossa meningiomas	0
soy bean curd	ovary neoplasms	0
vegetable juice	galt deficiency	0
crataegus monogyna	kidney insufficiency	0
mustard	airsickness	0
english plantain	sleep-related neurogenic tachypnea	0
acer saccharums	prostatic intraepithelial neoplasms	0
broth	severe congenital microcephaly	0
juglan	galactosemia 3s	0
offal	mammary dysplasia	0
plaice	diabetic neuralgias	0
crocus	vulvar neoplasm	0
fresh basil	pustulosis of palms and soles	0
macadamia nut	tactile hypesthesia	0
ocimum tenuiflorum	head pains	0
melissa officinalis	basal cell nevus syndrome	0
suggesting fruit	mechanical low back pain	0
bell peppers	uterine neoplasm	0
brinjal	testicular cancer	0
copaifera	perforated appendicitis	0
plantain	deep-vein thromboses	0
swordfish	symptom clusters	0
refined olive	liver failure	0
cruciferous vegetable	ekbom dermatozoic delusion	0
flesh foods	lymphatic sarcomas	0
lemon balm tea	ovary cancer	0
pickled foods	deep venous thromboses	0
foeniculum	epimerase deficiency galactosemia	0
acer negundo	primary brain neoplasm	0
plantago psyllium	tonsil cancers	0
thousand foods	juvenile-onset diabetes	0
celery root	schizoaffective disorders	0
fat milk	vulvar cancer	0
meal times	visual seizure	0
herbal teas	substance abuse	0
poisonous plant	human t cell leukemia virus type iii	0
euterpe precatoria	sleep-related neurogenic tachypnea	0
salmonella food	human papillomavirus viruses hpv	0
sweet marjoram	androgenetic alopecia	0
red meat	female pattern baldness	0
taro	thyroid cancer	0
kangaroo meat	microcystic meningioma	0
chinese cassia	dysosmia	0
sweetleaf	bipolar disorder	0
durum wheat	coronary disease	0
guava	colon cancers	0
seltzer water	zoonotic infection	0
flax seed	zoonotic infection	0
chicken	udpglucose hexose 1 phosphate uridylyltransferase deficiency	0
chinook salmon	uterine cancer	0
apium graveolens var. rapaceum	plasma cell myeloma	0
breakfast cereal	hemorrhoid	0
punica granatums	e-b viruses	0
triticum turgidum subsp. durum	tubal abortions	0
corn oil	arrhythmia	0
kombucha teas	semirhythmic tremor	0
baking chocolate	felv	0
beet greens	ischemic heart disease	0
poroporo	leprosy	0
allium sativum	common bile duct gall stones	0
consumed chocolate	kidney failures	0
good soybeans	diabetic retinopathy	0
maguey	cardiac disease	0
toronja	leucocythemia	0
frozen cranberries	postural syncope	0
cinnamon	chronic pain	0
food supplementations	pancreatitis	0
pleurotus	senile tremors	0
drinking water	galactose-1-phosphate uridylyltransferase deficiencies	0
avoid peanuts	migraine headache	0
bad foods	birth defects	0
caramel	situational syncope	0
fast food	myelomatosis	0
commercial milk	guam form amyotrophic lateral sclerosis	0
citrus medica	national cancer	0
stevia rebaudianas	rna tumor virus	0
common foxgloves	acquired immuno deficiency syndrome	0
fenugreek	pregnancy-induced diabetes	0
kawa kawas	posterior compartment low back pain	0
group foods	cluster headache syndrome	0
lens plants	senile tremor	0
vegetable protein	amyotrophic lateral sclerosis with dementia	0
collard greens	small lymphocytic lymphomas	0
sea bilberry	bipolar disorder	0
flammulina	low back pain	0
hydroponic basil	chronic infectious mononucleosis-like syndrome	0
soy sauce	microglandular adenoses	0
grecian foxglove	diabetic polyneuropathy	0
breakfast time	colorectal neoplasms	0
mandarin orange tree	superficial head injury	0
atropa belladonna	retained surgical sponges	0
energy drinks	reticuloendotheliosis viruses	0
seven nutrients	chronic lymphoblastic leukemias	0
illicium anisatums	sarcoma	0
lemon grass	bse (bovine spongiform encephalopathy)	0
curry	acquired blindness	0
replenish nutrients	philadelphia-negative myeloid leukemia	0
organ meats	non-alcoholic fatty liver disease	0
cymbopogon nardus	fibroatheroma	0
sesame seeds	occipital trauma	0
citrus medicas	benign neoplasms	0
dairy product	skin cancers	0
regular olive	wound botulism	0
fryer	ulcer	0
peach trees	malignancy	0
bt corn	poisoning	0
pistachio nut trees	testicular tumors	0
cherry	malignant primary brain neoplasms	0
food colors	blindness	0
dress	non-b hepatitis enterically-transmitted non-a	0
eating broccoli	age-related maculopathies	0
breakfast cereals	increased cancer	0
soy proteins	fibroatheromatous plaque	0
portulaca oleracae	vaginal discharges	0
curcuma longa	uterine cancer	0
zea	wart	0
silybum marianum	heat strokes	0
dandelion	zoonotic infection	0
acai berry	age-related memory disorder	0
grape	spasm	0
almond milk	avitaminose	0
ocimum basilicums	cellulite	0
melissa	weight gains	0
pimenta officinali	degenerative intervertebral disk	0
drink milk	udpglucose 4-epimerase deficiency disease	0
kiwi fruits	congenital myxedema	0
zinger tea	lymphosarcoma	0
dairy yogurt	mammary dysplasia	0
berberis	lower back pain	0
green pepper	food hypersensitivities	0
grecian foxgloves	acidosis	0
chenopodium quinoa	amyloid plaque	0
dried plums	esophageal hernias	0
msg	kanner syndrome	0
amygdalus communis	cardiovascular stroke	0
tea plant	visceral obesities	0
processed meat	intertrochanteric fractures	0
deli meat	epimerase deficiency galactosemia	0
citrus	necrotizing fasciitis	0
saint john's wort	norovirus	0
poisonous plants	determination of death	0
triticum vulgare	endocrine breast disease	0
bread	vaginal neoplasm	0
cider vinegar	prion diseases	0
apricot trees	osteoarthritis	0
foenumgraecum	confusional states	0
barberry	breast fibrocystic change	0
chinese cinnamons	androgenic alopecias	0
almond tree	fibromyalgia-fibromyositis syndrome	0
navy beans	colitis gravis	0
narrow-leaved plantains	type 1 diabetes	0
cortland	widespread chronic pains	0
reindeer meat	benign brain neoplasms	0
plum trees	galactokinase deficiency diseases	0
taraxacum officinale	prostatic intraepithelial neoplasias	0
plantago ovata	nonalcoholic steatohepatitides	0
vaccinium macrocarpons	kanner syndrome	0
macadamia	prostatic cancer	0
areca catechus	involutional osteoporosis	0
pleurotus ostreatus	polymyositis ossificans	0
abelmoschus esculentus	microlissencephaly	0
pork	testicular cancer	0
usda poultry	fibromyositis fibromyalgia syndrome	0
brazil nuts	morning sickness	0
food pyramid	bewilderment	0
brain-invasive pork	prion protein diseases	0
edible grain	prediabetic state	0
dinner	epithelial cancers	0
portulaca	ankylosing spondylarthritis	0
mealtime	corpse	0
linum usitatissimums	barretts syndrome	0
frequent meals	intestinal diseases	0
specific cheeses	autistic disorders	0
legume pods	migraine headache	0
kava kavas	bronchial asthma	0
fagopyrum sagittatum	syncopal vertigos	0
anti-inflammatory plant	abdominal pain	0
chamomile	substance dependence	0
celery	thyroid adenomas	0
pomelo trees	dysosmia	0
no-calorie sweeteners	respiratory infections	0
cucumis melos	fetal iodine deficiency disorder	0
barley	olfaction disorders	0
guacamole	hemicrania	0
kidney bean	hypoxia	0
so-called meat	regional ileitides	0
assai palm berries	vertiginous seizures	0
vaccinium virgatum	small non-cleaved-cell lymphomas	0
swiss chard	severe mental disorder	0
cycad	amyotrophic lateral sclerosis parkinsonism dementia complex 1	0
soy yogurt	tonsillar cancers	0
baby carrots	gustatory seizure	0
red cabbage	somatotropin (acromegaly) hypersecretion syndromes	0
eugenia sandwicensis	breast carcinomas	0
carbonated waters	cancer of the bladder	0
filbert	cardiovascular conditions	0
marijuana	male infertility	0
cruciferous vegetables	spinal cord disease	0
soy bean curds	fibrocystic disease of breast	0
vitis	oncogenesis	0
sauerkraut	testis neoplasm	0
noncaloric sweetener	myeloma multiple	0
raw cranberries	chromosome 6-linked autosomal recessive parkinsonism	0
common olive tree	crushing pain	0
hemp	age-related maculopathy	0
steamer	clonic seizure	0
sea vegetable	mastitis	0
gooseberry	testis cancer	0
andropogon nardus	cancer of endometrium	0
carya	limb tremor	0
floret	head trauma	0
seville orange tree	clonic seizures	0
kombucha tea	resting tremor	0
rubus idaeus	colon cancers	0
dinner times	inflammatory bowel diseases	0
raw meat	somatotropin hypersecretion syndrome (acromegaly)	0
lemongrass	flatulence	0
oregano plants	mouth neoplasms	0
kawa	testis cancer	0
soy foods	heat strokes	0
butter	vestibular seizures	0
gala apples	cephalgia syndrome	0
morning meals	severe mental disorder	0
boiled broccoli	bovine spongiform encephalopathy	0
food allergies	age-related macular degeneration	0
pine nuts	age-related osteoporosis	0
oolong tea	lymphatic sarcomas	0
honeybush tea	familial atrial fibrillations	0
anti-inflammatory foods	cow disease	0
yam	pancreatic cancer	0
olea europaea	schizophrenia	0
fagopyrum	chicken embryo lethal orphan virus	0
coriandrum sativums	brain neoplasms	0
oat	ekbom delusional parasitosis	0
texturized vegetable proteins	philadelphia negative myeloid leukemia	0
lycopersicon esculentum	hemangiopericytic meningioma	0
ribes nigrum	congenital abnormalities	0
rooibo	vagina neoplasm	0
soda waters	spindle-cell carcinomas	0
cocoa powder	olfactory seizures	0
japanese plums	multiple myositides	0
areca nuts	utp-hexose-1-phosphate uridylyltransferase deficiency disease	0
nutmeg	vulvar neoplasm	0
garbanzo	meningioma	0
dairy eggs	autosomal dominant juvenile parkinsonism	0
black raspberries	psychotic disorder	0
healthiest snack	human herpesvirus 4	0
areca catechu	fibroid uterus	0
blueberry	vertiginous seizure	0
dioscorea	food hypersensitivity	0
brussel sprout	hypercholesterolemia	0
plant aril	primary fibromyalgias	0
hibiscus cannabinus	disc degradation	0
nut butters	galactose-1-phosphate uridylyltransferase deficiency	0
cassia fistulas	cardiac arrhythmia	0
plantago lanceolata	subwakefullness syndrome	0
eugenia malaccensis	fibroid tumor	0
unfiltered coffee	prostatic neoplasms	0
purple cabbage	marek's disease virus	0
high fructose corn syrup	female sub fertility	0
wort	thermal hypesthesias	0
goji berry plants	primary brain tumor	0
rubberplant	undifferentiated lymphoma	0
raw tomatoes	gynecomastia	0
pineapple juice	abdominal pain	0
sweet marjorams	paralysis	0
mastic tree	inflammatory demyelinating polyneuropathy	0
faba beans	fusiform aneurysms	0
curried tofu	barretts syndrome	0
safflower	parodontose	0
mangifera indicas	lower back pains	0
dried fruit	acquired immunodeficiency syndromes	0
amla	udpglucose hexose-1-phosphate uridylyltransferase deficiency	0
chilli pepper	palsy	0
jelly	acute inflammatory demyelinating polyradiculoneuropathy	0
raw garlic	apneas	0
crunch berries	contagious pustular dermatitis	0
texturized soy protein	rete testis tumor	0
myristica fragran	prostate neoplasm	0
iceberg lettuce	hyperemesis gravidarum	0
retail meat	ciguatera	0
sweet foods	multiple myositis	0
ganja	ponv	0
dioscorea opposita	endometrial carcinomas	0
domestic fowl	pustular psoriasis of palms and soles	0
pummelo trees	kidney cancer	0
century plant	semirhythmic tremor	0
mashed potatoes	pulmonary embolisms	0
include apples	effort syncope	0
pimpinella anisums	dyslipoproteinemia	0
safflower oil	prediabetic states	0
artificially-flavored corn	breast cystic diseases	0
purslane	juvenile parkinsonism	0
purine-rich plant	light-headedness	0
beta vulgaris	generalized seizures	0
sweet almonds	transitional meningiomas	0
no coffee	angioblastic meningiomas	0
dried fruits	adolescent obesity	0
healthy nuts	milk sugar intolerance	0
cod	migraine disorders	0
low vitamin	autoimmune diseases	0
purple potatoes	tumor of rete testis	0
prunus amygdalus	primary gh resistance	0
fennel	benign prostatic hyperplasia	0
cola nitida	rectal tumor	0
four nuts	lens opacities	0
sardine	als (amyotrophic lateral sclerosis)	0
bellis	mechanical low back pain	0
alpine strawberry	bewilderment	0
caryophyllus	transmissible dementias	0
entree	low-grade lymphomas	0
organic foods	sinusitis	0
high-fructose maize syrup	eye diseases	0
betel nut	breast pain	0
white pepper	plegia	0
prunus domestica	ekbom dermatozoic delusions	0
nutrient-dense foods	salmonella infections	0
soft drinks	lobar pneumonia	0
thymus vulgari	lung neoplasm	0
belladonna	gluten enteropathies	0
fragaria vesca	retro-ocular headaches	0
bitter nightshade	unilateral headaches	0
neutraceutical	human papillomavirus viruses hpv	0
fruit juice	jakob creutzfeldt disease	0
legume family	national cancer	0
fermented cabbage	spasm	0
brassica	diabetic mononeuropathies	0
cassia trees	disc degradations	0
ketchup	substance abuses	0
plantago	substance abuses	0
cinnamomum zeylanicum	episodic cluster headache	0
almond butter	fibrositide	0
tv dinners	a-v dissociations	0
powdered ginger	peripheral arterial diseases	0
hot sauce	prion induced disorder	0
papaya	benign meningiomas	0
bell pepper	atrioventricular dissociation	0
wild yams	crushing skull injury	0
squashe	chronic insomnia	0
squash	cardiac diseases	0
crataegus	ciguatera fish poisoning	0
organic plants	thyroid cancer	0
california avocado	primary growth hormone resistance	0
morinda	action tremor	0
color	exanthem	0
daily fruit	posterior fossa meningiomas	0
aspalathus	burkitt's lymphoma virus	0
cinnamomum trees	rete testis tumor	0
high fructose maize syrup	parkinsonism-dementia complex of guam amyotrophic lateral sclerosis	0
althaea officinalis	ocular headaches	0
higher vegetable	infectious diseases	0
dried apples	somatotropin hypersecretion (acromegaly) syndrome	0
eugenia aromatica	esophagitis	0
mustard greens	deep-venous thrombosis	0
syzygium	central obesity	0
parsley	memory deficits	0
red peppers	viral diseases	0
ceylon cinnamon	memory losses	0
exotic fruits	cancer of lung	0
mentha spicata	head pains	0
orange trees	lymphosarcoma	0
garlic	meningotheliomatous meningioma	0
neu5gc-rich food	epithelioid sarcomas	0
saffron crocus	causes cancers	0
marjoram	muscle spasm	0
placenta	rabies virus	0
carica papayas	hiccough	0
citrus sinenses	cystic breast disease	0
almond oil	sensory seizures	0
apium graveolens	polyp	0
turkey meat	motion sickness	0
arachis hypogaea	huntington’s disease	0
tea leaves	strains and sprains	0
cocoanut	fibroid uterus	0
thymus plants	ruptured appendicitis	0
bergamot	social anhedonia	0
brassica juncea	bovine leukemias	0
little saffron	pancreas cancer	0
food additives	hepatitis e	0
brewing tea	congenital abnormality	0
fungus	perioral tremors	0
handling meat	diverticulitide	0
sugar substitutes	paroxysmal atrial fibrillation	0
soy cheese	saccular aneurysm	0
unfertilized eggs	lightheadedness	0
peach	fibroid tumors	0
ranking foods	rectum cancer	0
soup	canker sore	0
foie gras	steatohepatitide	0
marshmallow	bilateral sciaticas	0
drinking coffee	senile tremors	0
deli meats	focal seizure	0
energy drink	bovine lymphomas	0
thyme	dizziness	0
aquatic food	brain vascular accident	0
chinese rhubarb	parietal region traumas	0
cannabis indica	bechterew's disease	0
myristica fragrans	weight gain	0
fermented foods	male sexual impotence	0
fava beans	age-related osteoporoses	0
frozen spinach	cancer of the skin	0
cardamom	age related maculopathy	0
spore	transitional meningioma	0
corn	involuntary quivers	0
aloe vera	familial atrial fibrillations	0
star anise	horton syndrome	0
ocimum basilicum	craniocerebral trauma	0
lemon balms	marek's disease virus	0
black teas	food hypersensitivities	0
biometal	small non cleaved cell lymphoma	0
guibourtia	degenerative arthritis	0
assai palm	mixed lymphocytic-histiocytic lymphomas	0
soy bean	gingivitide	0
buckwheat	galactose-1-phosphate uridyltransferase deficiency	0
big meals	endometrium cancers	0
processing meat	auriculo-ventricular dissociations	0
eugenia caryophyllata	muscle cramps	0
salsa	sliding hiatal hernias	0
shan yaos	oncornavirus	0
soy milk	auto-immune disease	0
hemp plants	protein deficiency	0
sweet basils	cancer of bladder	0
baked potato	osteoarthrose	0
prunus armeniaca	papillary meningiomas	0
pumpkin pie	unilateral headaches	0
porphyra	hepatic cancers	0
java plum tree	undifferentiated carcinomas	0
sugar-sweetened beverages	retained surgical tools	0
andean blackberry	brain disorders	0
andira	sensory seizure	0
pear	retained surgical sponge	0
saint john wort	intractable headaches	0
drug administration united states food	creutzfeldt jacob disease	0
oxen meat	mixed lymphocytic-histiocytic lymphoma	0
soy beans	tussive syncope	0
mangifera indica	undifferentiated lymphomas	0
flowering shrub	occipital traumas	0
mayo	macular dystrophy	0
plum tree	gastric acid reflux disease	0
hemp plant	infectious disease	0
prebiotic	abdominal cramps	0
pancake	elevated cholesterols	0
coca	epithelial cancer	0
poppy	cardiac dysrhythmia	0
nonfat meal	dissociative amnesia	0
organic meat	intertrochanteric fractures	0
milk chocolate	atrial fibrillations	0
stem vegetables	age related memory disorders	0
whole foods	viral infection	0
cucumis melo	parkinsonian disorders	0
potato	age related memory disorders	0
monosodium glutamate	muscle cramp	0
hordeum	prostate cancers	0
poenumgraecum	liver failure	0
banana plant	darkness tremors	0
digitalis purpurea	rabies	0
edible grains	barretts esophagus	0
topical ginger	pseudotumor cerebri	0
trigonella foenum-graecum	diabetic retinopathies	0
food company	hemicrania migraines	0
no meat	postural syncopes	0
sugar	endemic cretinism	0
fresh meat	communicable diseases	0
lemon trees	hypermelanose	0
chili peppers	frontal region traumas	0
eragrostis	landry guillain barre syndrome	0
kawa kawa	tonsillar cancers	0
fragaria	cancer of bladder	0
cooked meat	verruca	0
mussel	enzootic bovine leukosis	0
salmonella-infected eggs	tonsillar cancer	0
common olive trees	galactosemia 3s	0
tempeh	body weights	0
lemon balm	low-grade lymphoma	0
component spices	near-death experience	0
cuminum cyminum	gall stone	0
pudding	rodent ulcers	0
whole grain	schizophrenic disorder	0
vitamin	male sub fertility	0
coriander	rebound insomnia	0
prunis communis	testis neoplasms	0
poultry products	tubal abortion	0
mentha	cellulite	0
citrus-based fruits	nasal cavity cancer	0
grilled meat	diffuse mixed small and large cell lymphoma	0
aubergine	bacterial vaginitides	0
cabbage	disorder	0
dried yeast	muscle tremors	0
allium porrum	vaginal neoplasms	0
hickory trees	anoxia	0
marjoram plant	senile osteoporoses	0
diospyros digyna	nonhodgkin lymphoma	0
whole grains	fatty liver	0
colorful foods	anaplastic carcinomas	0
cannabis sativas	pyorrhea alveolaris	0
mentha piperita	gastric neoplasms	0
healthiest nuts	ekbom dermatozoic delusion	0
yerba mate	tongue cancer	0
sour fruit	peripheral autoimmune demyelinating disease	0
soybean	non-b hepatitis epidemic non-a	0
fortify milk	iodine deficiency	0
peanut butter	menstrual disorders	0
crataegus monogynas	male sub-fertility	0
pistacia lentiscus	acquired immuno deficiency syndrome	0
soy protein	myelogenous leukemia	0
green peas	penis neoplasm	0
cycad trees	encephalon diseases	0
tarragon	laron type dwarfism i	0
lycium barbarum	insulin-dependent diabetes mellitus 1	0
acer saccharum	venous thrombosis	0
soybean proteins	liver neoplasms	0
whole grain cereal	human immunodeficiency viruses	0
herb	texidor twinge	0
rosemary	postural low back pain	0
shiitake	muscular spasms	0
club sodas	painful diabetic neuropathy	0
frying meat	prostatic neoplasms	0
haritaki fruit	congenital defect	0
hamburger	joint pains	0
nut butter	diffuse mixed cell lymphoma	0
brassica napus	ovarian cancer	0
baby formulas	delusional parasitoses	0
tisane	muscle pain	0
raw foods	lymphatic sarcoma	0
petroselinum	stomach cancers	0
study lavender	pustular psoriasis of palms and soles	0
experience food	anticancer	0
ready-to-eat meals	acute monocytic leukemias	0
morinda citrifolias	exanthem	0
squash plant	post traumatic osteoporosis	0
syzygium sandwicense	familial diffuse gastric cancer	0
cooking meat	brain disease	0
chilli peppers	orthostatic headaches	0
spearmint	disorders of initiating and maintaining sleep	0
table salt	iritis	0
humulus lupulus	gastric acid reflux disease	0
anticancer plant	cvas (cerebrovascular accident)	0
lemon verbena	cough	0
oolong	degenerative intervertebral disks	0
mangosteen	iddm	0
consumer protection scientific committee on food	cancer of the thyroid	0
density foods	sliding esophageal hernias	0
lima beans	hiatal hernia	0
common bean plants	recrudescence	0
olea	auricular fibrillations	0
faba bean	pulmonary disease	0
common foxglove	lobar pneumonias	0
snacktime	tactile hypesthesia	0
humulus	oncogenic virus	0
jambolan plum trees	mastitis	0
adhatoda vasica	diabetic neuralgia	0
eat chocolate	udp galactose 4 epimerase deficiency	0
red delicious	hair loss	0
red lentils	urinary bladder cancer	0
morinda citrifolia	galactose 1 phosphate uridyl transferase deficiency disease	0
chicken salad	malignant epithelial neoplasm	0
orange	reticuloendotheliosis viruses	0
cocoa plants	bovine lymphomas	0
asparagus	parkinsonian syndrome	0
lentil	wart viruses	0
chinese yam	vertebrogenic pain syndromes	0
food companies	olfaction disorders	0
breast milks	hypercapnia	0
nicotiana tabacum	ms (multiple sclerosis)	0
popcorn	paratuberculose	0
daucus carota	multiple head injury	0
white wine	multiple meningioma	0
capparis	chronic lymphoblastic leukemia	0
plantago indica	parkinson disease 2	0
prunus dulcis	carcinogenic retroviruses	0
cured meat	hypermelanosis	0
papaver	ramsay hunt paralysis syndrome	0
anise seed	sphenoid wing meningioma	0
malabar-nut	cysticercose	0
overpriced vitamin	hepatitis	0
black pepper	arthropathy	0
rooibos	prediabetic states	0
century plants	senile paranoid dementia	0
chickpea	liver neoplasm	0
rose	proteinuria	0
pumpkin	rheumatoid spondylitis	0
bertholletia	galactokinase deficiencies	0
berry	cancer of the uterus	0
apple	gallbladder disease	0
plant embryos	small and large cleaved-cell lymphoma	0
concord grapes	carcinoma of endometrium	0
sea food	female sub fertility	0
sandwich	fibrosis	0
new vitamin	light headedness	0
curcuma zedoarias	virus infections	0
agaricaceae	pancreatitis	0
warm milk	hepatic cancers	0
frozen fruit	inflammatory bowel disease	0
pumpkin seeds	early infantile autism	0
cocoa	relapse	0
raphanus raphanistrum	retained surgical needles	0
cranberry juice	blood cancers	0
eggnog	creutzfeldt jakob syndrome	0
hibiscus sabdariffa	polymyositis	0
cocoa butter	lou gehrig's disease	0
dietary sucrose	tongue neoplasms	0
clathrotropis	guillaine barre syndrome	0
feather meal	hernia	0
poultry meat	rabies virus	0
amomum cardamomum	endometrial carcinoma	0
health nuts	celiac sprue	0
lipomul	influenza in human	0
oyster mushrooms	basal cell epitheliomas	0
emphasizes vegetables	hypoxia	0
meal time	endometrial carcinoma	0
indian laburnums	hypoascorbemia	0
silybum marianums	retained surgical instrument	0
fagopyrum esculentum	clear cell meningiomas	0
marjoram plants	weight loss	0
phaseolus	heartburn	0
sea bilberries	female infertility	0
caryophyllus aromaticus	hot flashes	0
agave	avitaminose	0
baby spinach	galk deficiencies	0
brew	sarcopenia	0
junk food	primary fibromyalgias	0
lens culinari	brain cancer	0
goji berries	clonic seizures	0
broccoli	tumor	0
coconut water	spindle-cell carcinoma	0
citrus limon	deep-venous thromboses	0
avenas	cryptogenic epilepsies	0
mushroom	pancreas neoplasm	0
low-salt diet	crohn's disease	0
little meat	hot flashes	0
reason food	weight loss	0
norus	study cancer	0
white potatoes	degenerative neurologic disorders	0
fast foods	galt deficiency	0
black coffee	chest pain	0
carica	breast neoplasms	0
boiled eggs	galt deficiencies	0
euchresta	congenital abnormalities	0
seville orange trees	small cell lymphoma	0
ultra-processed foods	visual seizure	0
java plum trees	amyloidosis	0
shoot	fibromyositis fibromyalgia syndrome	0
catfish	primary insomnia	0
dried cranberries	sleep-related neurogenic tachypnea	0
kiwi fruit	prelingual deafness	0
dietary fats	germinoblastoma	1
porgy	influenza in human	0
carbonated drink	pseudotumor cerebri	0
ground beef	acute inflammatory demyelinating polyradiculoneuropathy	0
ground meat	cardiovascular stroke	0
aloe	blood clot	0
corylus	transmissible spongiform encephalopathy	0
acer	anoxia	0
high-phytate foods	head injury	0
legume pod	pregnancy-induced diabetes	1
laciniate nightshades	vulvar neoplasm	0
marsh mallows	continuous tremor	0
vital nutrients	myeloid leukemia	0
apium graveolens var. dulce	bipolar affective psychoses	0
cereal	nephrolith	0
shorten	substance-related disorders	0
acacia tree	acute myeloid leukemia	0
chinese food	human t-cell leukemia virus type iii	0
collard green	water borne hepatitis	0
hypericum perforatum	cancer of vagina	0
bilberry	insulin-dependent diabetes mellitus	0
breakfast times	galt deficiency	0
rubus glaucus	subfertility	0
scallion	leukemia virus	0
gluten	lead poisoning	0
incorporates cloves	deep-venous thromboses	0
prunus salicina	lou gehrig's disease	0
rice	spinal meningioma	0
papaver somniferum	lactose intolerance	0
thymus plant	neurotic anxiety states	0
lard	acute monoblastic leukemias	0
blossom	vertebrogenic pain syndrome	0
chewed coca	enterocele	0
dried blueberries	prostatitis	0
horse bean	amyloid plaques	0
strawberry	degenerative neurologic disorders	0
alfalfa sprouts	crohn disease	0
contamination meat	testicular cancers	0
food manufacturers	basal cell nevus syndrome	0
low meat	cancer of the brain	0
citron tree	atopic diseases	0
cantaloupe	polyarthritide	0
glycyrrhiza	atherosclerotic plaques	0
leek	endothelial dysfunction	0
dog rose berries	acute confusional migraine	0
lunch times	peripheral artery disease	0
squid	back pain without radiation	0
rosa	kidney failures	0
licorice root	mechanical low back pain	0
frier	spiral fractures	0
cocos nucifera	common bile duct calculi	0
citrus hystrix	acquired immunodeficiency syndrome	0
french fries	diabetic polyneuropathy	0
euterpe edulis	carotid sinus syncopes	0
potassium-rich foods	painful menstruation	0
coconut	benign neoplasms	0
infant formulas	epithelial cancers	0
hot pepper	barrett's syndrome	0
smoked food	human immunodeficiency virus	0
split pea	age-related maculopathy	0
kenaf	galactosemia 3s	0
molasse	hemolytic-uremic syndrome	0
banana	cataract	0
cinnamomum aromaticum	marie struempell disease	0
carbonated beverages	udpglucose hexose 1 phosphate uridylyltransferase deficiency	0
healthy food	chicken viruses	0
butternut squash	bechterew's disease	0
eating food	coarse tremor	0
citrus x paradisi	iddm	0
wild radish	water-borne hepatitides	0
plant-based foods	udpglucose hexose-1-phosphate uridylyltransferase deficiency	0
coriandrum sativum	darkness tremor	0
bertholletia excelsas	rebound insomnia	0
peppermint oil	dims (disorders of initiating and maintaining sleep)	0
psyllium	weight reductions	0
goiaba	colonic neoplasm	0
black rice	brain benign neoplasms	0
dietary supplements	inappropriate gh secretion syndrome (acromegaly)	0
breakfast	ischemia	0
big apples	feline lymphoma viruses	0
indian laburnum	malignant brain neoplasm	0
whortleberry	muscular spasm	0
chinese cassias	dementia	0
adding blueberries	bipolar disorders	0
spinacia oleracea	anthrax	0
herbal tea	lyme arthritis	0
maize oil	chromosome 6-linked autosomal recessive parkinsonism	0
different fruits	oxygen deficiency	0
anise	non b hepatitis epidemic non a	0
fennel seeds	muscle disease	0
glycine max	cancer of stomach	0
cicer arietinum	hypovolemic shock	0
sustenance	macular dystrophy	0
indian gooseberry	psychogenic parasitoses	0
green tea	vaginal neoplasms	0
dried pomegranate	ovarian neoplasms	0
nut bars	colonic neoplasms	0
pisum sativum	salmonella infection	0
goji berry plant	manic disorders	0
sour orange trees	preterm birth	0
lettuce	acute monoblastic leukemia	0
kava	infant gynecomastia	0
anacardium occidentale	age related osteoporosis	0
dried foods	zoonotic disease	0
cultivated oat	adenoviridae	0
pomelo tree	atrophy	0
milk protein	anosmia	0
crab apples	cjd (creutzfeldt jakob disease)	0
jasmine tea	vertex headaches	0
pea family	basal cell epithelioma	0
cola acuminata	tonsillar cancers	0
nitrate-rich vegetables	thyroid disorders	0
soymilk	global amnesias	0
woodland strawberry	manic states	0
whale meat	exanthema	0
wolfberry	polyp	0
healthy fruit	macular degeneration	0
soy bean proteins	high blood pressure	0
canned foods	social anxiety disorder	0
yoghurt	atheromatous plaques	0
club soda	stomatognathic disease	0
osmanthus	bone fracture	0
soda pop	experimental parkinson disease	0
unhealthy food	renal cancer	0
antioxidant vitamin	thermal hypesthesias	0
last meal	endometrium carcinoma	0
chile peppers	gum disease	0
flammulina velutipes	colon cancers	0
peppermint	inherited human transmissible spongiform encephalopathies	0
chai tea	neoplasia	0
ceratonia	kanners syndrome	0
piper nigrum	food-borne disease	0
dietary plant protein	light headedness	0
confection	schilling type myeloid leukemia	0
oyster mushroom	testis neoplasm	0
philadelphia cream cheese	lou gehrig's disease	0
chicken meat	endometrium carcinoma	0
tuna	anal ulcers	0
tangerine trees	pulmonary neoplasm	0
healthiest fruits	mucous colitides	0
flax seeds	zoonotic infection	0
holy basil tea	mild neurocognitive disorder	0
healthy snack	small noncleaved-cell lymphoma	0
unrefined plant	abdominal pains	0
hibiscus	laron syndrome	0
bacon	sprains and strains	0
red meats	bipolar depression	0
white tea	classic galactosemias	0
sweetening agents	tactile amnesia	0
sea-food	oncovirinae	0
bean sprouts	throat cancer	0
lavandula	substance addiction	0
snack food	auditory seizures	0
cupcake	chronic fatigue-fibromyalgia syndrome	0
syzygium malaccense	condylomata acuminata	0
purple rice	deaf mutism	0
garcinia mangostana	episodic cluster headaches	0
maize	tumor viruses	0
pimpinella	thrombus	0
stevia	convulsive syncopes	0
oregano	colitide	0
larder	thyroid disease	0
malus	pus	0
kaffir lime	dims (disorders of initiating and maintaining sleep)	0
popular fruits	human immunodeficiency viruses	0
added sweeteners	age-related bone losses	0
cassia tree	penile cancer	0
seed	premenstrual tension	0
fried foods	epstein barr virus	0
soda pops	paraesophageal hiatal hernia	0
cereal grains	deep-venous thromboses	0
red delicious apples	temporal region trauma	0
ready-to-eat meal	fibrosis	0
rosehip	lymphadenopathy-associated viruses	0
fries	diabetes related complications	0
term vegetable	tonic-clonic seizures	0
citrus paradisi	proliferative bronchiolitis	0
brown rice	necrotizing fascitis	0
natural vitamin	oncovirinae	0
junk foods	amyotrophic lateral sclerosis with dementia	0
artichoke	varice	0
paprika	upper respiratory tract infections	0
cruciferous foods	cysticercosis	0
grapefruit	barretts esophagus	0
olive oil	animal virus	0
multivitamin	thinness	0
tepary bean	fusiform aneurysms	0
carbonated beverage	tonsil cancers	0
horsenettle	syncopal episode	0
vaccinium corymbosum	sick headache	0
vaccinium bracteatum	philadelphia-negative myeloid leukemias	0
betel nuts	parkinsonism-dementia complex of guam amyotrophic lateral sclerosis	0
cinnamomum verum	small-cell lymphomas	0
trompillo	varicose vein	0
french bean plants	meningotheliomatous meningioma	0
allium cepa	prion-induced disorders	0
rubus	peripheral artery diseases	0
ale	esophageal reflux	0
norovirus food	post-traumatic osteoporosis	0
animal-based foods	protein deficiency	0
undercooked meat	mixed lymphomas	0
specific nuts	palmoplantaris pustulosis	0
chocolate bars	prostatic neoplasms	0
coco	pyrose	0
trigonella foenum graecum	skin rash	0
processed foods	diffuse mixed cell lymphoma	0
target vitamin	sliding esophageal hernia	0
ready-prepared food	neoplasm metastases	0
crowberry	somatotropin (acromegaly) hypersecretion syndrome	0
prettiest fruit	cancer of the liver	0
potato chips	bacterial vaginitis	0
nutritional yeast	testicular neoplasms	0
calendula officinalis	fifth phacomatosis	0
find pork	postoperative nausea	0
pea	meningioma	0
citronella	canker sores	0
vaccinium angustifolium	fibroatheromatous plaque	0
flavoring	primary brain neoplasms	0
bitter orange tree	back pain without radiation	0
cider	primary growth hormone resistance	0
coleslaw	galactose-1-phosphate uridyltransferase deficiencies	0
pomegranate seeds	food hypersensitivities	0
citrus fruits	cattle leukemia virus	0
nettle tea	milk sugar intolerance	0
plant arils	breast cystic diseases	0
vinegar	minor head injury	0
red onions	bilateral headaches	0
weed	irritable colon	0
fruit and vegetable juices	migraine variant	0
horse nettle	malignant tumor of urinary bladder	0
psidium	colon cancers	0
healthiest beverages	neurotic anxiety state	0
eugenia cumini	liver steatoses	0
kola nuts	spindle-cell carcinoma	0
carrot	male breast tumor	0
pimenta officinalis	degenerative neurologic diseases	0
moose meat	abdominal aortic aneurysm	0
beet	malignant tumor of urinary bladder	0
digitalis lanata	generalized seizure	0
arginine-rich foods	psychophysiological insomnia	0
common plant	superficial head injury	0
rhubarb	chronic cystic mastitis	0
pecan	coronary heart disease	0
roselle	heart decompensation	0
cayenne peppers	involuntary quivers	0
green teas	disrupted in b-cell malignancy	0
milk thistles	sarcopenia	0
broccoli raab	intermediate-grade lymphomas	0
cultivated radish	tor-driven diseases	0
cooked meats	hemangioblastic meningiomas	0
flounder	variant creutzfeldt-jakob disease	0
petroselinum crispums	gehrig disease	0
iv vitamin	intracranial neoplasms	0
dried apricots	marsh fever	0
calling eggs	rest tremor	0
leguminosae	insulin dependent diabetes mellitus	0
triticum	irritable colon	1
pickled vegetables	perforated appendicitis	0
vitamin pills	open head injuries	0
monitoring food	degenerative arthritis	0
secale	lymphatic sarcomas	0
cultivated oats	uveitide	0
treat	schizoaffective disorder	0
herr	eczema	0
plantago arenaria	spindle-cell carcinomas	0
healthiest vegetable	microglandular adenoses	0
triticum turgidum	post-traumatic osteoporosis	0
healthiest beverage	headache	0
pimenta diocia	esophagus neoplasm	0
restrict food	cow disease	0
english walnuts	scorbutus	0
vicia faba	lead poisonings	0
carrot juice	female infertility	0
worldwide fruit	benign essential tremors	0
sun-dried raisin	muscle soreness	0
stuff	acute inflammatory demyelinating polyradiculoneuropathy	0
celeriac	spondyloarthritis ankylopoietica	0
ground ginger	thinness	0
pomegranate fruit	gastro-esophageal reflux	0
yolk	cephalgia syndromes	0
infant formula	physical anhedonia	0
syzygium aromaticum	thermal hypesthesia	0
fava bean	skin diseases	0
narrow-leaved plantain	fibrositide	0
japanese plum	philadelphia negative myeloid leukemia	0
sorrel	psammomatous meningiomas	0
citrus maxima	polyarthritide	0
tomato	dizzyness	0
walnut oil	testicular neoplasms	0
chervil	oncogenesis	0
cucurbita	eye diseases	0
stryphnodendron	occipital traumas	0
lunch time	fibroatheromatous plaques	0
bread mold	cerebrovascular apoplexy	0
grapefruit juice	uterus neoplasms	0
pistacia	gastro esophageal reflux	0
gui zhi	leucocythaemia	0
dried peas	udpglucose hexose 1 phosphate uridylyltransferase deficiency	0
dioscorea villosa	protein deficiencies	0
maple syrup	fighting cancer	0
liquorice	early awakening	0
pomegranate	impaired sensation	0
butter milk	parkinson disease 2	0
billion eggs	gehrigs disease	0
bean	painful diabetic neuropathies	0
mastictree	psychophysiological insomnia	0
tomato sauce	aphthous stomatitides	0
horsebean	cardiogenic syncope	0
assai palm berry	periorbital headache	0
narrow leaved plantain	vaginitis	0
rutabaga	beriberi	0
cacao bean	diarrhea	0
hazelnut	transmissible spongiform encephalopathy	0
solanum dulcamaras	gastric cancer	0
golden delicious	viral diseases	0
recommend tea	heart failure	0
pistachio nut tree	esophagus cancers	0
eugenia jambolana	urticaria	0
elettaria cardamomum	coronary disease	0
bhang	degenerative intervertebral disk	0
calendula officinali	medical conditions	0
ananas	non-epileptic convulsion	0
sunfish	grippe	0
arachis	respiratory tract cancer	0
açai berries	visual seizure	0
aspartame	spindle-cell carcinoma	0
flax	mixed lymphocytic histiocytic lymphoma	0
turmeric	undifferentiated lymphoma	0
berberi	familial atrial fibrillation	0
healthy snacks	skin diseases	0
tea hibiscus	hyperventilation syncope	0
gluten-free diet	marsh fever	0
romaine	kahler disease	0
euterpe oleracea mart.s	deep vein thrombosis	0
watercress	aphthous ulcers	0
bibhitaki fruit	orthostasis	0
steak	dehydration	0
citrus sinensis	subacute spongiform encephalopathies	0
poppy seeds	pituitary dwarfism ii	0
fed beef	polyradiculoneuropathy	0
cooked carrots	manic depressive psychoses	0
eupatorium rebaudianum	saturnine tremor	0
maple	iron overload	0
apple juice	fibromyalgia-fibromyositis syndromes	0
texturized soy proteins	udp-galactose-4-epimerase deficiencies	0
cooked broccoli	atrioventricular dissociations	0
yellow vegetables	rabies virus	0
garlic sauce	arthralgia	0
mandarin orange trees	human t-cell leukemia virus type iii	0
citrus reticulata	western diseases	0
plant capsule	seizure	0
malus domestica	memory disorders	0
dessert	age-related maculopathy	0
algarrobo	muscle sorenesses	0
mango	acute inflammatory demyelinating polyradiculoneuropathy	0
eating meat	acquired immunodeficiency syndrome virus	0
salt-free diet	gastric cancer	0
indian corn	early awakening	0
raphanus sativus	tumorigenese	0
rheum	germinoblastic sarcoma	0
chinese cinnamon	inflammatory polyneuropathy acutes	0
teosinte	essential tremor	0
horse nettles	benign brain neoplasms	0
favorite meals	kanner syndrome	0
hop	subacute spongiform encephalopathy	0
phytonutrient-rich food	infectious diseases	0
prunus cerasifera	auriculo ventricular dissociation	0
punicaceae	plasmodium infections	0
extracted fruit	ductal carcinoma	0
golden raisins	small and large cleaved-cell lymphoma	0
cereal grain	b cell chronic lymphocytic leukemia	0
powdered sugar	cardiac failure	0
blackberry	diabetes mellitus complications	0
jalapeno	sub-fertility	0
whole wheat	urinary bladder cancer	0
lens culinaris	migraine disorder	0
jam	hepatitide	0
candy	copd	0
eragrostus	recrudescence	0
sea vegetables	colonic cancers	0
almond	pill rolling tremors	0
pimpinella anisum	neoplasm metastasis	0
phaseolus vulgaris	heart attacks	0
liquor	infantile obesity	0
garden radish	constipation	0
soft drink	inflammatory bowel disease	1
dried food	starvation	0
musa	syncopal episode	0
chocolate	migraine	0
white rice	cysticercose	0
cuminum	inflammatory polyneuropathy acutes	0
red wine	heartburn	0
animal-based vitamin	penile neoplasm	0
sweet almond	rest tremors	0
shan yao	neurodegenerative disorder	0
empty calorie foods	juvenile-onset diabetes	0
orange tree	minor head injuries	0
national meat	arthritis	0
sunflower seeds	cervical migraine syndromes	0
flavourer	galactosemia iiis	0
safflower oils	gut dysfunction	0
apricot tree	arthropathy	0
brussels sprouts	cat leukemia virus	0
dripping	confusion	0
vegetarianism	uterine neoplasm	0
tobacco	passive tremor	0
cymbopogon	zoonosis	0
bolete	abdominal obesity	0
pineapple	thyroid disorders	0
lamb chops	coma	0
sweet potatoes	contusion	0
cherry plum tree	limb tremors	0
nightshade	igf-1 deficiency	0
chenopodium quinoas	migraine headache	0
baker's yeast	tick bite	0
vaccinium uliginosum	body weights	0
adhatoda	amnesia memory loss	0
trace elements	prediabetic states	0
jalapeno peppers	adenosis of breast	0
healthiest foods	prion-induced disorder	0
cherry plum trees	pancreas neoplasms	0
brown sugar	mixed-cell lymphomas	0
chlorella	small round-structured viruses	0
osmanthus tea	retained surgical instruments	0
low-fat diet	prediabetic states	0
tomato juice	fibroatheromatous plaques	0
eugenia jambos	episodic cluster headaches	0
dietary fiber	gingivitis	0
almond trees	syncopal vertigo	0
canned food	tick bites	0
maize oils	ciliary body spasms	0
cumin	alopecia	0
caper	intraepithelial neoplasm	0
maraschino cherry	arthritide	0
chewing fruit	cancer of rectum	0
peach tree	auricular fibrillations	0
pinto beans	gall bladder disease	0
turmeric root	birth defects	0
elettaria cardamomums	colonic neoplasm	0
fatty foods	vertebrogenic pain syndrome	0
mustard plants	galactosemia 2	0
mint tea	mammary cancer	0
fat foods	dermatozoic delusions	0
wild bananas	esophagus neoplasm	0
healthiest apple	hemolytic-uremic syndrome	0
snail meat	galactose 1 phosphate uridylyltransferase deficiency	0
beef	ovary neoplasms	0
assai palms	virus infection	0
milk proteins	paraesophageal hernias	0
exotic fruit	early detection of cancer	0
sockeye salmon	chromosome 6 linked autosomal recessive parkinsonism	0
deep-fry foods	rabies viruses	0
soy food	experimental lung inflammation	0
plantago seed	dyslipidemia	0
ginger	mptp-induced experimental parkinsonism	0
phyllanthus emblica	essential tremor	0
justicia	intraorbital meningioma	0
texturized vegetable protein	adolescent obesity	0
skim milk	liver neoplasms	0
red yeast rice	familial creutzfeldt jakob disease	0
tofu	macular dystrophy	0
foxglove	skin disease	0
psidium guajavas	reticulosarcoma	0
fabaceae	food-borne diseases	0
food supplement	aphthous stomatitis	0
tree nuts	iddm	0
olive oils	coronary diseases	0
fiddlehead ferns	degenerative intervertebral disk	0
drinking orange	back pain	0
silken tofu	skin neoplasms	0
largest meal	ovarian cancers	0
sugar maples	spiral fractures	0
jambolan plum tree	motion sickness	0
high-fructose corn	confusional states	0
trace element	leprosy	0
sunchoke	hiatus hernia	0
medicago sativa	chronic headaches	0
fagopyrum tataricum	testis neoplasm	0
origanum	gastric cancers	0
solanum melongenas	feminization	0
cheese	urinary bladder cancer	0
dietary supplementations	endometrium cancer	0
piper methysticum	cancer of the uterus	0
tumeric	myelogenous leukemia	0
cocoa powders	respiratory infections	0
euterpe oleracea	head trauma	0
thymus	brain neoplasm	0
dark meat	premenstrual syndromes	0
domestic fowls	ductal carcinomas	0
atropa belladonnas	lou gehrig disease	0
concord grape	myocardial infarctions	0
cola	chronic headaches	0
dietary fibers	head trauma	0
leafy vegetables	seasickness	0
citrus aurantiums	diabetic neuralgias	0
preserved food	malignant epithelial neoplasms	0
lemon tree	small non-cleaved-cell lymphoma	0
nicotiana tabacums	pulmonary inflammations	0
red rice	tussive syncope	0
chipotle	cardiac death	0
rabbit meat	malignant epithelial neoplasm	0
cooking oil	gallbladder diseases	0
dressing	parkinsonian syndromes	0
baptisia	galactosemia 2s	0
beer	b-cell chronic lymphocytic leukemia	0
lemon	pleomorphic lymphomas	0
vaccinium ashei	rachitide	0
eupatorium rebaudianums	neurotic anxiety state	0
petroselinum crispum	rectum cancer	0
real chocolate	low-grade b-cell malignancy	0
raisin	circulatory collapse	0
organic food	salmonella infections	0
citrus reticulatas	recrudescence	0
alcohol	semantic memory disorder	0
wild celery	mammalgia	0
millet	vulva cancers	0
healthier meat	prostatic adenoma	0
citron trees	manic disorders	0
secale cereale	senile plaques	0
corn oils	static tremors	0
raw broccoli	presyncope	0
fenugreek seeds	thyroid adenoma	0
big food	gehrig disease	0
drink tea	brains cancer	0
althea officinalis	histamine cephalgias	0
olive	megacolon	0
tuna fish	venereal warts	0
food poisonings	parkinsonian syndromes	0
crabapple	cataract	0
golden glow	hiatal hernias	0
english plantains	open head injury	0
squash plants	inflammatory disease	0
irritable bowel kiwi fruit	vertex headache	0
low-calorie diet	postviral fatigue syndromes	0
glycyrrhiza glabra	headache disorder	0
fake meat	oncogenic viruses	0
foeniculum vulgare	mild neurocognitive disorder	0
citrus aurantium	peripheral artery disease	0
ginger ale	manic disorder	0
taking vitamin	tumor viruses	0
pea families	myalgia	0
blueberry plants	chicken viruses	0
cream cheese	myocardial infarct	0
hypericum perforatums	atherosclerotic plaques	0
wild yam	acute inflammatory demyelinating polyradiculoneuropathy	0
kidney beans	convulsive syncope	0
indian gooseberries	lens opacity	0
persea	non-hodgkin lymphoma	0
delonix	cancer of kidney	0
flaked coconut	cjd (creutzfeldt-jakob disease)	0
sugar water	leucocythemia	0
triticum aestivum	mixed lymphoma	0
ready-prepared foods	migratory pain	0
spaghetti	central obesities	0
pepsi	peanut hypersensitivity	0
filtered coffee	sore throat	0
justicia adhatoda	esophagitide	0
dried apple	minor head injuries	0
ice cream	lyme arthritis	0
citrullus	skin cancers	0
pureed apples	biliary calculi	0
jelly beans	communicable disease	0
incorporate cloves	prostate cancers	0
granny smith apples	orf	0
antioxidant-rich food	leanness	0
dioscorea polystachya	e b virus	0
cassia fistula	cancer of the pancreas	0
grouper	atopic disease	0
origanum onites	diverticulosis	0
laudable legume	viral infections	0
high-fiber food	alopecia	0
including cloves	diffuse small cleaved cell lymphoma	0
granny smith	b cell leukemia	0
morning meal	liver cancers	0
hickory tree	familial creutzfeldt jakob disease	0
cocktail	pruritus	0
healthy foods	feline lymphoma virus	0
dietary proteins	infantile colic	0
da huang	intervertebral disc degeneration	0
illicium verum	pyrosis	0
nori	small non cleaved cell lymphoma	0
cannabis	acute inflammatory polyneuropathies	0
portulaca oleraceas	kanner syndrome	0
dairy products	syncopal episode	0
molasses	hypoesthesia	0
amaranth	psammomatous meningiomas	0
capsicum annuum	testis neoplasms	0
tulsi tea	physical sufferings	0
rowanberry	paludism	0
stevia rebaudiana	water-borne hepatitides	0
rice milk	cat leukemia virus	0
candy bar	alzheimer’s disease	0
nut	severe congenital microcephaly	0
white meat	drug dependence	0
pimenta diocias	drug use disorders	0
yerba mates	male sexual impotence	0
holy basil	esophageal hernia	0
white mallows	papillary meningioma	0
dragon fruit	central nervous system intracranial disorders	0
portulaca oleracea	infectious virus	0
beverage	menstrual pain	0
theobroma cacao	eczema	0
sweetener	male sub fertility	0
common bean plant	myocardial ischemias	0
cucumber	ankylosing spondylarthritis	0
syrup	remittent fever	0
antioxidant food	premature birth	0
antioxidant-rich foods	tonsillar cancers	0
prunus persica	drug hypersensitivity	0
cynara scolymus	bladder cancer	0
snack foods	diabetes complication	0
american meat	spinal cord degenerative diseases	0
pimiento	atheroma	0
açaí berry	hepatocellular cancer	0
cayenne pepper	mild neurocognitive disorder	0
handling food	bladder cancer	0
food supplements	cancer of the ovary	0
carbonated mineral water	eczema	0
tap water	small non-cleaved-cell lymphomas	0
zedoary zedoaria	obesity virus	0
crocus sativus	reversing chronic disease	0
scrambled eggs	prostatic cancers	0
green grapes	chronic airflow obstructions	0
organ	radiating pains	0
kohlrabi	malignant lymphomas	0
lime	heart attack	0
saccharomyces cerevisiae	feline lymphoma viruses	0
willow tree	retained surgical needle	0
laciniate nightshade	dairy product intolerance	0
saint johns wort	prostatitis	0
corn sugar	inner ear cancer	0
sesame oil	comatose	0
areca	muscular rheumatism	0
wheat	marie struempell disease	0
citrus bergamias	experimental lung inflammations	0
lemon grasses	renal failures	0
blueberry plant	tussive syncope	0
erythroxylon	chronic b cell leukemia	0
frosting	papillary meningioma	0
red tea	prostate cancer	0
anise tea	sudden infant death syndrome	0
fresh ginger	necrotizing fasciitides	0
frying foods	endothelial dysfunction	0
persea americanas	diffuse mixed-cell lymphoma	0
juiced broccoli	temporary amnesias	0
fig	thyroid diseases	0
spinach	foodborne disease	0
plant zygote	tactile hypesthesia	0
contaminated foods	norovirus	0
sweet basil	crushing skull injury	0
vegetable proteins	chronic diseases	0
carob	joint pain	0
soy beverage	paralysis agitans	0
coriandrum	parkinson's disease	0
macadamia nuts	breast malignant neoplasm	0
golden delicious apples	galactose-1-phosphate uridyltransferase deficiencies	0
persimmon	venereal warts	0
virgin olive	vagina cancer	0
longevity legumes	hereditary galactokinase deficiency	0
rose hips	atopic diseases	0
fructose corn	common bile duct biliary calculi	0
linseed	chronic lymphoblastic leukemia	0
specific foods	tactile hypesthesias	0
collard	carcinoma	0
rheum tanguticum	chronic disease	0
nutriceutical	jacksonian seizure	0
rye	hirsutism	0
endive	smell disorders	0
mint	cardiovascular disease	0
chamomile oils	auricular fibrillation	0
peanut	autosomal recessive familial parkinson disease	0
barley coffee	amyloid deposits	0
international nut	familial dementia	0
zea mays	virus infection	0
crave chocolate	polyp	0
afzelia	hair losses	0
hemlock	cancer of stomach	0
mother cell	asthma	0
common fruits	situational syncope	0
vicia fabas	salami brusher's disease	0
ovary	autoimmune diseases	0
drink	prediabete	0
table sugar	benign intracranial hypertension	0
camomile	sensory seizures	0
ficus	idiopathic polymyositis	0
uncooked foods	deep-venous thromboses	0
muffin	prediabetic state	0
cannabis sativa	blv	0
processed apples	cerebral convexity meningiomas	0
tepary beans	neurologic degenerative condition	0
olive tree	diabetic mononeuropathy simplex	0
curry powder	hemolytic jaundices	0
pithecolobium	parkinsonian disorders	0
pecan trees	infant botulism	0
eating almonds	symptom clusters	0
animal food	lens opacities	0
sugar substitute	disc degeneration	0
chewing gum	diffuse small cleaved-cell lymphoma	0
avena sativa	secondary insomnia	0
taraxacum	paroxysmal atrial fibrillations	0
soy	vulvar neoplasms	0
prosopi	prediabete	0
new candy	wheat allergies	0
shellfish	age-related maculopathy	0
happy meal	frontal region traumas	0
açaí berries	acromegaly	0
organic milk	small noncleaved cell lymphoma	0
horsemeat	morning sickness	0
dietary plant proteins	pharyngitide	0
black currant	thyroid cancer	0
trace mineral	chronic lymphocytic leukemia	0
bamboo shoots	malignant epithelial neoplasms	0
colocasia	spinal cord degenerative diseases	0
malabar nut	cerebrovascular accidents	0
aspalathus linearis	manic state	0
yeast rice	painful diabetic neuropathies	0
black walnut	fifth phacomatoses	0
inadequate fruit	fine tremors	0
eating nuts	intention tremors	0
mangifera	spinal cord disease	0
kale	sunburn	0
veal	spatial memory disorder	0
chamomile oil	cardiovascular strokes	0
juglans nigra	bacterial vaginitis	0
decaffeinated tea	rachitide	0
coca cola	barrett syndrome	0
pretzel	visceral obesities	0
plant embryo	sea sickness	0
althaea	gastro-oesophageal reflux	0
black walnuts	occipital trauma	0
kiwi	diabetes complications	0
nuclear power plant	coronary heart diseases	0
pyrus	lassitude	0
horse beans	brief reactive psychosis	0
ribe	endometrial carcinoma	0
acaí berries	galactose 1 phosphate uridylyltransferase deficiency	0
ready soybeans	comatose	0
dietary protein	phlebothrombosis	0
pasta	non hodgkin's lymphoma	0
sweetened cereal	respiratory tract infections	0
french bean plant	gastro-oesophageal reflux	0
citrus bergamia	autoimmune disorders	0
margarine	small-cell lymphoma	0
solanum melongena	substance dependence	0
green onions	male breast tumor	0
retail poultry	pustulosis palmaris et plantaris	0
cayenne	utp hexose 1 phosphate uridylyltransferase deficiency	0
hordeum vulgare	familial parkinson disease	0
individual food	juvenile-onset diabetes mellitus	0
cured meats	feminization	0
cashew	microcephaly	0
olive family	constipation	0
cannabi	senile tremors	0
proteus mirabilis	circulatory failure	0
raw food	retained surgical instruments	0
phaseolus vulgari	breast pain	0
include fennel	leukemia	0
beta vulgari	arterial fatty streaks	0
deep-fried foods	juvenile-onset diabetes	0
whipped cream	chromosome 6-linked autosomal recessive parkinsonism	0
green peppers	virus infections	0
licorice	esophagus cancers	0
psidium guajava	sleep initiation and maintenance disorders	0
apricot	small-cell lymphomas	0
apple tree	barrett's esophagus	0
cocos nuciferas	jaundice	0
include flaxseed	male breast carcinoma	0
hibiscus tea	familial parkinson disease	0
soya milk	juvenile parkinson disease	0
low fruit	penis cancers	0
nettle	long sleeper syndromes	0
black currants	cardiogenic syncope	0
diabetic diets	penis neoplasm	0
acer negundos	legal blindness	0
dietary supplement	migraine variants	0
actual fruit	apneas	0
pecan tree	guillain barre syndrome	0
individual candy	virus diseases	0
uncooked food	subwakefullness syndrome	0
espresso	acute confusional migraines	0
rheum officinale	psychotic disorder	0
hot peppers	heart failure	0
wine	small non-cleaved-cell lymphomas	0
clove	muscle tremors	0
pie	epithelioid sarcomas	0
andean blackberries	fight cancer	0
opium poppies	vaginal neoplasm	0
hypericum	chronic insomnia	0
natto	chronic b-cell leukemias	0
whole grain cereals	deep-venous thrombosis	0
eating fruits	experimental parkinson diseases	0
chili	graves disease	0
celebration meal	scorbutus	0
dog rose	painful diabetic neuropathies	0
amlas	bewilderment	0
brassica nigra	bladder diseases	0
eggplant	atrioventricular dissociations	0
spicy food	infantile botulism	0
foodstuff	landry-guillain-barre syndrome	0
bok choy	neurocysticercosis	0
bean sprout	rabies virus	0
sausage	colic	0
cassia cinnamon	persistent tremors	0
bagel	plasma cell myeloma	0
marsh mallow	relapse	0
star anises	rna tumor viruses	0
citrus grandis	deep-vein thromboses	0
black tea	acquired immunologic deficiency syndrome	0
spice turmeric	crushing skull injuries	0
emblica officinalis	subfertility	0
alfalfa sprout	stokes-adams syncopes	0
spice saffron	periodontal disease	0
roasted almonds	brain tumor	0
mustard oil	non epileptic convulsion	0
vitis vinifera	reticuloendotheliosis virus	0
marihuana	carsickness	0
serve	pulmonary inflammation	0
solanum laciniatum	galactokinase deficiency diseases	0
cicer arietinums	spinal cord diseases	0
bitter nightshades	galactose epimerase deficiencies	0
cannabis indicas	episodic cluster headaches	0
fenugreek seed	skin neoplasm	0
lycium chinense	deep-venous thrombosis	0
fruit-shaped marshmallows	peripheral autoimmune demyelinating disease	0
black beans	small round-structured viruses	0
hickory nuts	xanthomatous meningiomas	0
carthamus tinctorius	breast cystic disease	0
apple trees	chronic cystic mastitis	0
seltzer waters	complications of diabetes mellitus	0
root	cancer-causing viruses	0
brewed coffee	muscle spasms	0
grape juice	experimental lung inflammation	0
amorpha	dyschezia	0
beetroot	senile osteoporosis	0
low-sodium diet	tying disease	0
garcinia mangostanas	acquired immunodeficiency syndrome	0
know nuts	hemicrania migraine	0
ice creams	gastric neoplasm	0
emphasize plant	tactile amnesias	0
cacao	transmissible spongiform encephalopathies	0
nuclear power plants	corpse	0
origanum majorana	osteoarthrosis deformans	0
pithecellobium	posterior fossa meningioma	0
chamomile tea	terminal cancer	0
radish	sliding hiatal hernia	0
kava kava	hip fractures	0
gum acacia	neuritic plaques	0
gravy	lens opacity	0
venison	pseudotumor cerebri	0
anacardium occidentales	ovarian cancers	0
lentinus edodes	prion induced disorder	0
candy bars	colonic cancer	0
english walnut	thyroid carcinoma	0
plant zygotes	somatotropin hypersecretion syndrome (acromegaly)	0
olive trees	orthostasis	0
avocado fruit	new variant creutzfeldt-jakob disease	0
syzygium jambos	syncopal episode	0
roughage	creutzfeldt jakob syndrome	0
not-necessarily-so-healthy foods	kidney insufficiencies	0
bertholletia excelsa	a v dissociation	0
prunus salicinas	sleep initiation and maintenance disorders	0
linum	guam form amyotrophic lateral sclerosis	0
own vitamin	hepatitis	0
cauliflower	membranous cataracts	0
carbonated mineral waters	disk degenerations	0
vaccinium myrtillus	contagious pustular dermatitides	0
lycium	disorder	0
no noni	male sub fertility	0
solanum laciniatums	bruise	0
mock meats	menstrual pains	0
dietary sugars	oral neoplasm	0
suggesting apple	generalized headache	0
rooibos tea	autosomal dominant juvenile parkinsonism	0
syzygium cumini	water stress	0
artificial sweeteners	mixed lymphocytic-histiocytic lymphoma	0
smoked foods	diabetes-related complications	0
orange juice	disorientation	0
sweetening agent	psoriase	0
flower	ponv	0
tangerine tree	mechanical low back pain	0
jerusalem artichokes	seizure disorder	0
basil	galactokinase deficiency	0
dietary soybean proteins	pulmonary inflammations	0
zucchini	bechterews disease	0
mirobalanus embilicas	cluster headache syndromes	0
pizza	vertiginous seizure	0
melissa officinali	small-cell lymphomas	0
prenatal vitamins	reactive confusion	0
pistacia vera	cerebrovascular accident	0
new york coalition for healthy school food	weight reductions	0
carduus marianus	preventable cancers	0
greenery	rachitis	0
alcoholic beverages	plasma-cell myeloma	0
citrus fruit	sudden cardiac arrests	0
wheat brans	aneurysm	0
illicium	acidose	0
caffeinated coffee	chicken embryo lethal orphan virus	0
rose berries	parkinson's disease	0
sour orange tree	lymphoblastic leukemia	0
solanum dulcamara	bone cancer	0
juglans regia	syncopal episode	0
morel	myocardial infarcts	0
chestnut	massive tremor	0
dinnertime	cognitive retention disorders	0
sesame	carcinogenesis	0
radicchio	mptp-induced experimental parkinsonism	0
phyllanthus emblicas	hypolactasia	0
hickory nut	post-traumatic osteoporosis	0
processed food	galt deficiencies	0
probiotic	malignant melanomas	0
raspberry	pulmonary inflammations	0
gmo soybeans	chronic daily headache	0
wisconsin milk	oncogenesis	0
human milk	paralysis	0
egg	coronary heart diseases	0
tachigalia	bowel disease	0
anchovy	pustulosis palmaris et plantaris	0
poultry	ph1 negative myelogenous leukemia	0
curcuma longas	diffuse lymphocytic lymphoma	0
toxic plant	tumor viruses	0
origanum vulgare	rebound insomnia	0
antioxidant fruits	autosomal recessive parkinsonism	0
oreo	mixed lymphoma	0
elettaria	rectum cancer	0
pepper	juvenile parkinsonism	0
yogurt	amaurosis	0
corn syrup	alactasia	0
dietary fat	secondary insomnia	0
cocoa plant	adenovirus	0
green beans	vitamin deficiency	0
saffron	headache syndromes	0
intoxicant	deep venous thrombosis	0
national pork	virus infections	0
fruit juices	vagina neoplasm	0
oats	strain	0
noni fruit	amyloidose	0
hawthorn	undifferentiated lymphoma	0
sprout	diabetic polyneuropathies	0
eat flax	adolescent gynecomastia	0
plant kingdom	nutritional disease	0
croaker	chest pains	0
persea americana	intracranial cns disorders	0
flaxseed	fibrose	0
roundup-ready soybeans	idiopathic proctocolitis	0
toxic plants	breast disease	0
rise	primary insomnia	0
raphanus	lymphocytic leukemia	0
pistachio	mouth neoplasms	0
grape seeds	manic depressive psychoses	0
crab apple	cancer of penis	0
food additive	viral infection	0
drinking milk	tongue neoplasms	0
chia seeds	bovine lymphomas	0
capsicum	tongue neoplasms	0
eden foods	endometrioma	0
maize syrup	benign meningioma	0
canned fruit	diabetic mononeuropathy simplex	0
trace minerals	retained surgical tool	0
solanum lycopersicum	abdominal migraine	0
fresh fruits	acquired deafness	0
mastic trees	polymyositis ossificans	0
foeniculum vulgares	galactose-1-phosphate uridylyltransferase deficiency	0
cassia	weight losses	0
cinnamomum cassia	pyorrhea alveolaris	0
teff	gustatory seizures	0
restructured meat	bovine lymphosarcoma	0
piper methysticums	hyperventilation syncopes	0
artificial sweetener	disc degradation	0
nonus	relapse	0
sell meat	recrudescence	0
bottled water	pulmonary thromboembolisms	0
vegetable oil	sid	0
açai berry	reverse cancer	0
black sapote	osteoarthritis	0
sour cream	htlv-iii	0
health food	leukemogenic virus	0
box elders	gale deficiency	0
food allergy	non hodgkin's lymphoma	0
lavender	amaurosis	0
honey	mixed lymphoma	0
diospyros digynas	occipital trauma	0
triticum spelta	cancer of the penis	0
paella	substance induced organic mental disorders	0
milkshake	lung neoplasm	0
applesauce	right sided heart failure	0
pinto bean	car sickness	0
leaf lettuce	generalized seizure	0
miso	kidney diseases	0
mirobalanus embilica	comatose	0
drinking tea	lou-gehrigs disease	0
glucose-fructose syrup	abdominal migraine	0
oryza	multiple sclerosis	0
cardamon	orthostasis	0
food poisoning	liver dysfunctions	0
salad	wheat hypersensitivities	0
woodland strawberries	well-differentiated lymphocytic lymphomas	0
pease	cephalgia syndrome	0
romaine lettuce	central nervous system degenerative diseases	0
alfalfa	brain malignant neoplasm	0
ready prepared foods	precordial catch	0
goji berry	diverticulum	0
banana plants	regional ileitis	0
oryza sativa	unilateral headache	0
tea	atypical diffuse small lymphoid lymphoma	0
cookie	alopecia cicatrisata	0
sweeten	alopecia cicatrisatas	0
vegetable juices	human t-cell lymphotropic virus type iii	0
diospyro	diverticula	0
actual licorice	intraepithelial prostatic neoplasias	0
bitter orange trees	abdominal obesities	0
cucumis sativus	parkinsonism dementia complex of guam amyotrophic lateral sclerosis	0
coconut oil	cardiac sudden death	0
carya illinoensis	mad cow diseases	0
official vitamin	acute cerebrovascular accidents	0
acid-binding vegetables	common cancers	0
currant	amnesia	0
carbonated water	dental plaque	0
curcuma	hhv-4	0
cooked tomatoes	renal insufficiency	0
carica papaya	bechterew disease	0
plant capsules	metastasis	0
potable water	chronic b-lymphocytic leukemias	0
solanum tuberosums	ciliary neuralgia	0
pimenta	early-onset parkinsonism	0
ilex paraguarienses	aids viruses	0
wheat bran	neurocysticercose	0
broad beans	bechterew's disease	0
dark chocolate	familial diffuse gastric cancer	0
chard	experimental parkinson diseases	0
ephedra	backache	0
cranberry sauce	kanner syndrome	0
raisin bran	high cholesterol level	0
earl grey tea	zoonotic disease	0
onion	hyperthermia	0
okra	overeat	0
kola nut	kidney calculus	0
hashish	encephalopathy	0
brewage	cervical neoplasm	0
chewing gums	gall stones	0
betel	bovine spongiform encephalopathy	0
buttermilk	presyncope	0
raw alfalfa	motion sickness	0
dioscorea batatas	cancer of stomach	0
vaccinium bracteatums	renal insufficiency	0
diabetic diet	olfactory seizures	0
alcoholic beverage	prion-induced disorders	0
animal foods	uterine neoplasm	0
coffee	diabetic retinopathy	0
shiitake mushrooms	status migrainosus	0
illicium anisatum	gustatory seizure	0
chanterelle	chronic fatigue-fibromyalgia syndromes	0
citrus aurantiifolias	periadenitis mucosa necrotica recurrens	0
rheum rhaponticum	carcinoma	0
zingiber officinales	porcine endogenous retroviruses	0
cow's milk	cervix cancers	0
black sapotes	cll lymphoplasmacytoid lymphoma	0
seafood	temporal region traumas	0
red pepper	substance abuse	0
dasheen	scurvy	0
majorana hortensis	malignant lymphomas	0
food and drug administration	familial creutzfeldt-jakob disease	0
triticum durum	brain disorder	0
fatty meal	somatotropin hypersecretion syndromes (acromegaly)	0
machaerium	subacute spongiform encephalopathy	0
amomum cardamomums	melanoma	0
measuring food	spinal cord disorders	0
cranberry	involuntary quiver	0
weekly meat	skin cancers	0
rubus fruticosus	drop attack	0
snack	atherosclerose	0
conventional food	felv	0
colophospermum	chronic lymphoblastic leukemias	0
use sweeteners	central obesity	0
nutraceutical	fusiform aneurysms	0
convenience foods	mild neurocognitive disorders	0
linum usitatissimum	manic disorder	0
high-fat meal	autosomal recessive parkinsonism	0
mother cells	forehead traumas	0
mentha x piperita	b cell leukemia	0
nicotiana	chronic obstructive pulmonary disease	0
processed meats	micturition syncope	0
ephedras	colorectal tumor	0
brazil nut tree	bipolar depression	0
anana	gossypiboma	0
hummus	crohn disease	0
convenience food	cerebral convexity meningioma	0
punica granatum	autosomal recessive familial parkinson disease	0
ultra-processed food	small and large cleaved-cell lymphoma	0
illicium verums	gluten enteropathy	0
trigonella	acute inflammatory demyelinating polyneuropathy	0
trigonella foenum-graecums	symmetric diabetic proximal motor neuropathy	0
glucose fructose syrup	burn	0
soda water	exudative bronchiolitides	0
sweet peppers	gastric acid reflux	0
lavandula angustifolia	vulvar cancer	0
soy beverages	cancer of the vagina	0
artificial butter	bronchiolitis obliterans	0
cleistocalyx	familial diffuse gastric cancer	0
zedoary zedoarias	congenital hypothyroidism	0
plant-based nutrients	galactose epimerase deficiencies	0
sesame oils	gut dysfunction	0
oregano plant	hot flashes	0