
illicium verum	uterine cervical neoplasms	0
bertholletia	carcinoma of endometrium	0
soft drink	galactose 1 phosphate uridyl transferase deficiency disease	0
solanum melongenas	ciguatera	0
snack	intracranial neoplasm	0
apium graveolens	intervertebral disk degeneration	0
sardine	bacterial vaginoses	0
rose hips	varicose veins	0
hot peppers	diffuse undifferentiated lymphoma	0
whortleberry	food hypersensitivities	0
stevia	vaginal neoplasm	0
antioxidant fruits	galactokinase deficiency diseases	0
hibiscus tea	epithelial cancer	0
mussel	prediabete	0
fryer	tonsillar cancer	0
gui zhi	microlissencephaly	0
red yeast rice	low-grade b-cell malignancy	0
dried fruit	hiatal hernia	0
oats	urinary tract infection	0
inadequate fruit	epileptic seizures	0
retail meat	cerebral stroke	0
beverage	cognitive retention disorders	0
butter milk	gestational diabetes mellitus	0
rheum rhaponticum	testis cancer	0
milkshake	intraepithelial carcinoma	0
kombucha tea	schizophreniform disorders	0
dietary soybean proteins	neoplasm	1
lactuca sativa	iritide	0
vaccinium virgatum	retained surgical needles	0
eating meat	nonhodgkin lymphoma	0
carduus marianus	common colds	0
new york coalition for healthy school food	disk degradations	0
mock meats	diabetic complications	0
caramel	esophageal hernias	0
seafood	low back pains	0
marihuana	endemic cretinism	0
iceberg lettuce	blood cancers	0
nut butters	norwalk like viruses	0
narrow-leaved plantains	gasser's syndrome	0
tuna	meningioma	0
olive family	breast pains	0
avena	pseudocoma	0
flaked coconut	migraine disorders	0
acer negundos	et-nanbh	0
lemon verbena	bechterew disease	0
jalapeno pepper	kidney insufficiency	0
plantago ovata	juvenile-onset diabetes mellitus	0
flax seeds	infant botulism	0
frozen fruit	prediabetic states	0
maize oils	malignant brain neoplasm	0
safflower oil	icterus	0
gmo soybeans	broken bones	0
norovirus food	goiter	0
hypericum perforatums	mad cow disease	0
hawthorn	testicular cancers	0
garcinia mangostana	primary fibromyalgias	0
juiced broccoli	diabetes complication	0
dioscorea polystachya	bronchiolitide	0
camomile	cognitive declines	0
mesquite	peripheral artery diseases	0
chervil	breast adenosis	0
snail meat	burning pain	0
sea food	infectious mononucleosis viruses	0
green tea	microcystic meningiomas	0
shiitake mushrooms	small and large cleaved-cell lymphoma	0
adding blueberries	somatotropin (acromegaly) hypersecretion syndrome	0
alcoholic beverage	human cancer	0
lemon	early diagnosis of cancer	0
eating almonds	autosomal dominant parkinsonism	0
bolete	small noncleaved-cell lymphoma	0
black sapotes	gluten-sensitive enteropathy	0
breakfast times	ciliary body spasms	0
red peppers	testicular neoplasms	0
poppy seed	galactose-1-phosphate uridylyltransferase deficiencies	0
seltzer water	subwakefullness syndrome	0
algarrobo	non-epileptic convulsion	0
junk foods	sphenoid wing meningiomas	0
processed foods	chronic airflow obstructions	0
cassia fistula	impotence	0
energy drinks	penis neoplasms	0
milk proteins	zoonotic diseases	0
foenumgraecum	lichen planus	0
origanum	osteoporose	0
sweetened cereal	small-cell lymphomas	0
dried apple	ph1-negative myeloid leukemia	0
fresh ginger	common bile duct gallstones	0
vaccinium ashei	acute monoblastic leukemias	0
potassium-rich foods	metabolic acidosis	0
skim milk	sphenoid wing meningioma	0
olea europaea	hypesthesia	0
tea leaves	disorder	0
mangosteen	ekbom delusory parasitoses	0
dietary fat	respiratory tract infection	0
dried cranberries	human mammary carcinoma	0
vaccinium myrtillus	painful diabetic neuropathies	0
raphanus raphanistrum	jacksonian seizure	0
soy beans	severe congenital microcephaly	0
sweeten	inflammatory diseases	0
official vitamin	odontogenic keratocysts multiple basal cell nevi	0
avena sativa	colicky pains	0
maraschino cherry	chronic fatigue-fibromyalgia syndrome	0
ground ginger	adenoviridae	0
carbonated mineral waters	renal failures	0
ocimum sanctum	lower back pains	0
mustard plants	drug allergy	0
piper nigrum	degenerative arthritis	0
cannabis	ovarian cancers	0
ocimum basilicums	laron dwarfism	0
gluten	stokes-adams syncopes	0
raw broccoli	milk sugar intolerance	0
ready prepared foods	viral disease	0
low-calorie diet	anal ulcer	0
black currant	amyotrophic lateral sclerosis	0
green lentils	vertebrogenic pain syndrome	0
aspalathus	cancer of the liver	0
garlic sauce	exanthema	0
yolk	colorectal neoplasm	0
eat flax	human t-cell lymphotropic virus type iii	0
fresh basil	cognitive decline	0
chinese cinnamons	malignant epithelial neoplasms	0
betel nut	creutzfeldt jakob disease	0
cocktail	oncogenic viruses	0
carbonated drinks	sea sickness	0
anti-inflammatory foods	female sub-fertility	0
chilli pepper	myocardial ischemia	0
deep-fried foods	right-sided heart failure	0
rye bread	rectum cancer	0
sugar maples	insulin dependent diabetes mellitus	0
multivitamin	laron type dwarfism i	0
sour orange trees	cancer of the breast	1
processed food	galactose 1 phosphate uridyltransferase deficiency	0
vaccinium macrocarpon	increase cancer	0
mentha piperita	well-differentiated lymphocytic lymphomas	0
healthiest nuts	rachitis	0
fenugreek seed	seasickness	0
brain-invasive pork	upper respiratory tract infections	0
soda pops	early-onset parkinsonism	0
seville orange tree	psychotic disorders	0
pimenta officinalis	cancer of esophagus	0
suggesting apple	muscle spasm	0
gooseberry	endometrial carcinoma	0
popular fruits	visual seizure	0
apple	skin cancer	0
agave	brain diseases	0
know nuts	degenerative neurologic disorder	0
incorporate cloves	male sub fertility	0
tulsi tea	parkinsonian diseases	0
origanum onites	charcot disease	0
nicotiana	peripheral arterial diseases	0
parsley	thyroid adenoma	0
flammulina	paraesophageal hiatal hernia	0
infant formulas	atrioventricular dissociation	0
mandarin orange trees	regional enteritis	0
plum tree	nutritional disease	0
foeniculum	strains and sprains	1
carica papayas	chronic headache	0
energy drink	oral cancer	0
guibourtia	death	0
citrus reticulata	apoplexy	1
frosting	nbcc	0
bell peppers	senile plaques	0
food poisoning	diabetic amyotrophy	0
weekly meat	colorectal neoplasms	0
carthamus tinctorius	encephalon diseases	0
euterpe oleracea	mastalgia	0
rose berries	zoonotic diseases	0
peanut butter	familial creutzfeldt-jakob diseases	0
peach tree	gastric acid reflux disease	0
potato chips	brain cancers	0
little saffron	deaf mutism	0
miso	kidney failure	0
pimenta officinali	arrhythmia	0
porphyra	glaucoma	0
green teas	esophageal hernia	0
purple rice	parkinsons disease	0
pummelo tree	chest pains	0
fungus	bacterial vaginitis	0
piper methysticums	anal ulcers	0
fabaceae	colicky pains	0
health food	nonspecific vaginitis	0
dioscorea	cognitive retention disorder	0
radicchio	spinal cord degenerative diseases	0
wild bananas	infantile botulism	0
cuminum	rectal neoplasm	0
thousand foods	granulomatous colitis	0
whole foods	chromosome 6 linked autosomal recessive parkinsonism	0
cupcake	subfertility	0
dried yeast	pulmonary embolism	0
toxic plants	testis neoplasms	0
maple	severe congenital microcephalies	0
retail poultry	hypertension	0
baking chocolate	joint diseases	0
include flaxseed	muscle disease	0
pisum sativum	fever	0
boiled eggs	arrythmia	0
orange tree	orthostatic headaches	0
molasses	cardiogenic syncopes	0
uncooked food	autistic disorders	0
eating food	female sterility	0
healthy snack	autoimmune diabetes	0
meal time	neurocysticercosis	0
sorrel	hyperthermia	0
meal	diffuse small cleaved cell lymphoma	0
mashed potatoes	plasmodium infection	0
soy milk	hypercholesteremia	0
macadamia	amyloid plaque	0
morel	diarrhea	0
flammulina velutipes	premature aging	0
althea officinalis	light headedness	0
machaerium	gnathostomiasis	0
lycium chinense	tumor	0
atropa belladonnas	low-grade b-cell malignancy	0
brassica napus	lymphoplasmacytoid lymphoma	0
horsenettle	colorectal cancers	0
cassia tree	pseudotumor cerebri	0
wine	human papillomavirus virus	0
fat foods	hemolytic jaundices	0
sugar water	cognitive decline	0
unfiltered coffee	nephrolith	0
cherry	bovine leukemias	0
purple cabbage	mammary dysplasia	0
pineapple juice	cancer of brain	0
snack food	variant creutzfeldt jakob disease	0
dioscorea villosa	chronic airflow obstructions	0
alcohol	cot death	0
food manufacturers	lou gehrig disease	0
breakfast time	minor head injuries	0
diabetic diet	retained surgical items	0
trace mineral	bacterial vaginosis	0
zingiber officinales	benign essential tremors	0
dried foods	mucous colitis	0
low meat	rna tumor viruses	0
cacao bean	hypercholesterolemia	0
digitalis lanata	syncopal vertigos	0
bertholletia excelsas	hay fever	0
daily nut	social anxiety disorder	0
citrus aurantium	breast fibrocystic changes	0
humulus	complete hearing loss	0
mastic tree	pancreatic cancer	0
hydroponic basil	blood clot	0
sesame seeds	reticuloendotheliosis virus	0
romaine	atypical chronic myeloid leukemia	0
sweet orange	acquired deafness	0
mustard seeds	cognitive impairments	0
hibiscus	pneumonitide	0
cymbopogon	postural low back pain	0
vegetable protein	johnes disease	0
bitter orange tree	pernicious vomiting of pregnancy	0
citrus grandis	galt deficiency	0
althaea officinalis	scorbutus	0
fed beef	spindle-cell carcinoma	0
flower	diabetic neuralgias	0
açai berries	passive tremors	0
oolong tea	gastric ulcers	0
almond milk	pulmonary cancers	0
leguminosae	rest tremors	0
reason food	lung inflammation	0
marjoram	endothelial dysfunction	0
lemon balm	hiatus hernias	0
lycium	amyotrophic lateral sclerosis	0
sugar-sweetened beverages	cerebral convexity meningiomas	0
boiled broccoli	prostatic intraepithelial neoplasm	0
rosemary	low back pains	0
eugenia sandwicensis	endometriosis	0
cayenne	cot deaths	0
fast foods	gastroenteritide	0
crab apple	prostatitis	0
eugenia caryophyllata	undifferentiated lymphomas	0
açaí berries	small cleaved cell lymphoma	0
frozen spinach	amyloid plaque	0
whole grain	inflammatory demyelinating polyneuropathy	0
persimmon	aids viruses	0
animal-based foods	burkitt herpesvirus	0
horsebean	gout	0
punicaceae	heart attacks	0
java plum trees	atopic diseases	0
star anises	pituitary dwarfism iis	0
oat	severe congenital microcephalies	0
organic food	decreased cancer	0
guacamole	type c oncovirus	0
fiddlehead ferns	bechterew's disease	0
pithecolobium	pill rolling tremor	0
adhatoda	parkinsons disease	0
amygdalus communis	zoonotic diseases	0
rye	mottled enamels	0
four nuts	sudden cardiac arrest	0
cauliflower	fibromyalgia-fibromyositis syndrome	0
ice creams	nonalcoholic steatohepatitides	0
aquatic food	deaf mutism	0
pomelo trees	prostate cancers	0
arachis hypogaea	pseudoaphakia	0
baker's yeast	juvenile onset diabetes	0
cacao	bovine spongiform encephalopathy	0
citrus bergamia	cancer of the endometrium	0
ready-prepared food	cot deaths	0
greenery	hepatic neoplasms	0
pecan trees	stokes-adams syncopes	0
cucumis melos	mammalgia	0
pistil	bses (bovine spongiform encephalopathy)	0
kavas	human influenzas	0
butter	olfaction disorders	0
rose	pustular psoriasis of palms and soles	0
thymus	intracranial meningioma	0
filtered coffee	atypical diffuse small lymphoid lymphoma	0
healthiest vegetable	xanthomatous meningiomas	0
study lavender	substance induced organic mental disorders	0
experience food	amnestic state	0
food colors	autoimmune condition	0
artificial sweetener	deglutitional syncopes	0
tofu	psoriasis	0
grapefruit	papillary meningioma	0
healthiest foods	campylobacter infections	0
cranberry sauce	guillain-barre syndrome	0
areca	light headedness	0
syzygium malaccense	esophagus neoplasms	0
grape seeds	renal neoplasms	0
juglan	baldness	0
sugar substitutes	non hodgkin's lymphoma	0
rubus	cholera	0
elettaria cardamomums	osteoarthrosis deformans	0
radish	retained surgical needles	0
sweet marjorams	tactile amnesia	0
antioxidant food	secondary fibromyalgias	0
eugenia cumini	royal free disease	0
food additives	skin cancers	0
fruit and vegetable juices	gerd	0
isoglucose	strains and sprains	0
fagopyrum esculentum	bowel disease	0
tea plant	charcot disease	0
raw meat	rash	0
pumpkin	prostatic intraepithelial neoplasm	0
frequent meals	acute inflammatory demyelinating polyneuropathy	0
aspartame	autosomal dominant juvenile parkinson disease	0
orange juice	female subfertility	0
cooking oil	non hodgkins lymphoma	0
woodland strawberries	felv	0
high-fat meal	fibroid tumor	0
chlorella	back pain without radiation	0
vitis	insomnia disorders	0
noncaloric sweetener	texidor's twinge	0
raspberry	rabies viruses	0
fenugreek seeds	groundnut hypersensitivity	0
legume family	hypolactasia	0
whale meat	sudden cardiac arrest	0
molasse	situational syncope	0
elettaria	cancer of the ovary	0
irritable bowel kiwi fruit	subwakefullness syndrome	0
high fructose maize syrup	microglandular adenosis	0
smoked food	memory losses	0
prenatal vitamins	spinal cord disorder	0
muffin	johnes disease	0
cocoa powder	renal insufficiency	0
malus domestica	muscle tremors	0
black rice	vulva neoplasm	0
soy beverages	esophageal neoplasm	0
century plants	vertex headache	0
areca catechu	malignant brain neoplasm	0
yoghurt	pituitary dwarfism ii	0
copaifera	acute stroke	1
concord grapes	malignant epithelial neoplasms	0
raw cranberries	urinary tract infections	0
eat chocolate	age related bone loss	0
açai berry	mastodynia	0
aspalathus linearis	zoonotic infectious diseases	0
cultivated oat	small cleaved-cell lymphoma	0
blackberry	olfactory groove meningiomas	0
entree	acquired immunodeficiency syndrome virus	0
ocimum tenuiflorum	bse (bovine spongiform encephalopathy)	0
hop	dental diseases	0
pummelo trees	acquired immunologic deficiency syndrome	0
citrus sinenses	static tremor	0
hordeum	dementia	0
papaya	cancer of vulva	0
crataegus	jacksonian seizure	0
hummus	abdominal cramp	0
handling meat	male sub-fertility	0
herbal tea	sinusitis	0
theobroma cacao	male breast enlargement	0
buttermilk	saccular aneurysm	0
healthy food	cancer of the kidney	0
pimenta diocias	aortic aneurysm	0
pistacia vera	b-cell leukemia	0
ficus	prostate cancers	0
anchovy	transient blindness	0
sockeye salmon	microcystic meningiomas	0
club soda	schizoaffective disorders	0
cassia fistulas	cardiac arrhythmia	0
store licorice	fever	0
phaseolus vulgari	t viruses	0
triticum vulgare	small cell lymphoma	0
acer saccharum	blindness	0
citrus fruit	head injury	0
dairy eggs	skin neoplasms	0
eugenia jambolana	dna injuries	0
milk protein	uterus cancer	0
baby carrots	tumor virus	0
aloe vera	heat strokes	0
fenugreek	anosmia	0
trigonella foenum-graecum	diffuse mixed small and large cell lymphoma	0
dietary supplementations	recurrent brain tumors	0
lycopersicon esculentum	galt deficiencies	0
musa	parietal region traumas	0
taraxacum	non-b hepatitis epidemic non-a	0
target vitamin	varicose veins	0
soy bean proteins	oral disease	0
pineapple	bipolar affective psychosis	0
almond trees	chronic fatigue fibromyalgia syndrome	0
cherry plum tree	pneumonitis	0
wort	bleed	0
white potatoes	plasma-cell myeloma	0
nuclear power plant	germinoblastic sarcomas	0
green pepper	ciliary neuralgia	0
beta vulgari	bovine leukemia	0
goji berry	inflammatory bowel disease 1	0
eragrostis	uterine cervical neoplasms	0
lemon grasses	uterine cancer	0
kangaroo meat	coarse tremors	0
healthiest snack	neurologic degenerative condition	0
sour fruit	ramsay hunt paralysis syndrome	0
soda waters	age-related memory disorder	0
cassia trees	serious disease	0
deli meats	high grade lymphoma	0
silken tofu	myelogenous leukemia	0
lamb chops	early diagnosis of cancer	0
hibiscus sabdariffa	tonic-clonic seizures	0
new vitamin	hypospadia	0
neutraceutical	brain vascular accidents	0
squash seeds	abdominal migraines	0
flax seed	infantile autism	0
hemp plants	age-related maculopathies	0
sweet potatoes	galactose-1-phosphate uridylyltransferase deficiency	0
shan yaos	lyme borreliosis	0
cynara scolymus	schizoaffective disorders	0
red onions	breast fibrocystic change	0
empty calorie foods	diabetes related complications	0
pomegranate seeds	insulin dependent diabetes mellitus	0
ground flax	mild neurocognitive disorder	0
capparis	basal cell epitheliomas	0
pimpinella anisum	weight reduction	0
jerusalem artichokes	vulvar neoplasms	0
snacktime	joint pains	0
berberis	ciliary body spasm	0
bad foods	early awakening	0
big food	penis cancers	0
corn syrup	auto-immune disease	0
purple potatoes	retained surgical needle	0
sesame oil	retrovirus	0
zea mays	fibromyoma	0
corylus	water-borne hepatitis	0
apricot	myalgic encephalomyelitis	0
plant embryo	ph1-negative myeloid leukemias	0
caffeinated coffee	childhood obesity	0
psidium	male breast tumors	0
frozen broccoli	membranous cataract	0
favorite meals	horton syndrome	0
canned food	ankylosing spondyloarthritides	0
digitalis purpurea	udp galactose 4 epimerase deficiency disease	0
blossom	broken bone	0
vicia faba	small round structured viruses	0
solanum	abdominal migraines	0
anti-inflammatory plant	coronary heart disease	0
amorpha	meningotheliomatous meningiomas	0
chewing gum	pneumonitide	0
specific nuts	gastric neoplasm	0
soy bean	disc degenerations	0
citronella	fissure in ano	0
barley	necrotizing fasciitis	0
lunch time	hereditary galactokinase deficiencies	0
antioxidant vitamin	testicular neoplasms	0
triticum	viral infections	0
organic plants	low back pains	0
laciniate nightshades	esophageal hernia	0
kohlrabi	cadaver	0
fake meat	insulin-dependent diabetes mellitus 1	0
fries	esophagus neoplasms	0
eugenia jambos	hiatal hernias	0
sauerkraut	ketosis-prone diabetes mellitus	0
hickory trees	osteoarthrosis deformans	0
rheum	primary brain neoplasm	0
plant embryos	androgenic alopecia	0
asparagus	utp-hexose-1-phosphate uridylyltransferase deficiency disease	0
colophospermum	thyroid adenomas	0
pork	cancer of the esophagus	0
cucumis melo	sarcopenia	0
cortland	autistic disorder	0
dietary proteins	bechterew disease	0
opium poppy	peripheral artery disease	0
black tea	nerve tremor	0
bean	irritable bowel syndrome	0
saint johns wort	aphthous stomatitis	0
black sapote	near-death experience	0
adhatoda vasica	lactose malabsorption	0
pea	cancer of rectum	0
apricot tree	tubal abortions	0
trigonella	muscle tremors	0
ketchup	cancer of skin	0
hickory nut	thyroid carcinoma	0
solanum melongena	udp-galactose-4-epimerase deficiency	0
brinjal	tactile amnesia	0
plantago arenaria	sharp headaches	0
spicy food	sliding hiatal hernia	0
squash	tonic-clonic seizure	0
sunflower seeds	uterine cervical neoplasm	0
marijuana	polyarthritis	0
sweetening agents	develop cancer	0
hordeum vulgare	chronic daily headache	0
citrus reticulatas	cjd (creutzfeldt jakob disease)	0
bilberry	diffuse lymphomas	0
rubberplant	water-borne hepatitis	0
shan yao	nonhodgkin's lymphoma	0
chenopodium quinoas	sore throat	0
golden delicious	gastroenteritide	0
citrus x paradisi	primary fibromyalgias	0
pecan tree	secondary insomnia	0
big apples	hansen disease	0
lycium barbarum	degenerative neurologic disorder	0
frozen cranberries	circulatory collapse	0
amaranth	bladder cancers	0
lunch times	impaired sensation	0
kaffir lime	chronic fatigue-fibromyalgia syndrome	0
juglans regia	condylomata acuminata	0
ready-to-eat meals	laron syndrome	0
sour orange tree	sleep wake disorder	0
berry	post-traumatic osteoporoses	1
milk	ekbom delusional parasitoses	0
egg	infant obesity	0
sprout	colonic cancer	0
ultra-processed food	chronic b lymphocytic leukemia	0
pimenta diocia	drug hypersensitivity	0
higher vegetable	cerebral strokes	0
vegetable proteins	endocrine breast disease	0
sesame	brain vascular accidents	0
sea bilberry	gastric ulcer	0
canned foods	odontogenic keratocysts multiple basal cell nevi	0
cappari	carcinoma	0
raw garlic	amaurosis	0
gravy	early awakening	0
sweet pepper	spinal cord degenerative diseases	0
solanum laciniatums	headache	0
virgin olive	lower back pains	0
solanum tuberosums	throbbing headache	0
yam	polyphagia	0
arginine-rich foods	human herpesvirus 4	0
oregano plants	auricular fibrillation	0
national meat	galactosemia 3	0
coriandrum sativum	low back ache	0
rutabaga	generalized spasm	0
illicium anisatums	grippe	0
sesamum	palmoplantaris pustulosis	0
carica papaya	childhood obesity	0
arachis	guillain-barre syndrome	0
melissa	bipolar depression	0
erythroxylon	mixed cell lymphoma	0
food poisonings	extreme hearing loss	0
sweet basils	skin neoplasm	0
eggnog	esophagus neoplasms	0
glycyrrhiza	hemolytic jaundice	0
common plant	primary brain neoplasm	0
eragrostus	ruptured appendicitis	0
lemongrass	tactile hypesthesias	0
garden radish	diabetes-related complication	0
nut butter	ciguatera fish poisoning	0
tangerine tree	colorectal carcinoma	0
margarine	intraepithelial neoplasm	0
phaseolus	social phobias	0
peach trees	biliary calculi	0
beetroot	lymphosarcoma	0
raw poultry	food borne diseases	0
peppermint oil	psychogenic parasitosis	0
allspice	weight gains	0
soy sauce	male sub fertility	0
carya illinoensis	scorbutus	0
avenas	bipolar affective psychoses	0
anticancer plant	gnathostoma infection	0
acer	utp-hexose-1-phosphate uridylyltransferase deficiency disease	0
octopus	thrombosis	0
foeniculum vulgare	complications of diabetes mellitus	0
chilli peppers	epileptic seizures	0
english walnuts	heart disease	0
pasta	memory deficits	0
no-calorie sweeteners	gastroenteritide	0
crataegus monogyna	johnes disease	0
pumpkin seeds	food-borne diseases	0
solanum tuberosum	craniocerebral traumas	0
sushi	muscle tremors	0
pithecellobium	myalgia	0
elettaria cardamomum	tonic clonic seizures	0
sunchoke	male breast tumors	0
individual candy	small cell lymphoma	0
poenumgraecum	uterine cervical cancer	0
legume pod	sinusitide	0
soda pop	pleomorphic lymphoma	0
biometal	parodontose	0
red meat	acidose	0
vegetable juice	neurodegenerative disorder	0
dressing	burkitt's lymphoma virus	0
taraxacum officinale	oral cancers	0
emphasize plant	head injuries	0
purple grape	hiccough	0
indian laburnums	gallbladder disease	0
tarragon	plasma cell myeloma	0
fagopyrum tataricum	action tremor	0
morinda citrifolia	bilateral deafness	0
tepary bean	breast disease	0
anacardium	acquired immuno-deficiency syndrome	0
citrus limon	involuntary quiver	0
fig	gossypiboma	0
portulaca oleracea	rachitide	0
baptisia	progressive disorder	0
citrus aurantiums	zoonosis	0
syzygium aromaticum	malignant epithelial tumors	0
plant foods	retained surgical sponge	0
lemon grass	light headedness	0
organic milk	seizure	0
fructose corn	substance abuses	0
yogurt	malignant tumor of urinary bladder	0
white mallow	crohn’s disease	0
squash plant	symptom clusters	0
good soybeans	chronic pain	0
milk thistles	nonhodgkin lymphoma	0
chewing fruit	utp-hexose-1-phosphate uridylyltransferase deficiency disease	0
lard	postural low back pain	0
steamer	xanthomatous meningioma	0
low-salt diet	foreign object	0
ice cream	mucous colitides	0
illicium anisatum	auricular fibrillations	0
stem vegetables	rectal tumors	0
decrease meat	bladder neoplasms	0
marjoram plants	chronic b lymphocytic leukemia	0
coconut oil	pneumonitis	0
mangifera indicas	western diseases	0
alpine strawberries	cancer of uterus	0
psidium guajavas	remittent fever	0
eden foods	coarse tremors	0
chard	primary growth hormone resistance	0
grouper	cephalodynia	0
sugary foods	marie-struempell disease	0
new candy	infant botulisms	0
malus	circulatory collapse	0
dried apples	early infantile autism	0
health nuts	kidney cancer	0
antioxidant-rich food	virus disease	0
incorporates cloves	tonic seizure	0
no meat	zoonotic infections	0
rooibo	drug use disorder	0
diet	brain tumors	0
coco	urinary bladder disease	0
black teas	single seizures	0
cranberry juice	psammomatous meningiomas	0
kiwi fruit	acute fulminating multiple sclerosis	0
include fennel	thermal hypesthesias	0
veal	deep-vein thromboses	0
fagopyrum sagittatum	cancer of the pancreas	0
include apples	androgenic alopecias	0
citrullus	polyradiculoneuropathy	0
prunus salicina	ciguatera poisonings	0
monosodium glutamate	malignancy	0
vodka	cancer of testis	0
poultry	lymphatic sarcomas	0
assai palms	fine tremors	0
split peas	lichen rubra planus	0
capsicum	prostatic intraepithelial neoplasms	0
bran flakes	cancer of the testes	0
watermelon	chronic lymphatic leukemia	0
color	tonic seizure	0
junk food	sudden infant death syndrome	0
burrito	brain disorders	0
prunus armeniaca	heat strokes	0
flavoring	liver neoplasms	0
pleurotus	ulcerative colitis type inflammatory bowel disease	0
healthiest beverages	national cancer	0
drink	age-related bone loss	0
swordfish	bilateral sciaticas	0
trigonella foenum-graecums	generalized seizure	0
zingiber officinale	disc degenerations	0
soy cheeses	heart attack	0
fruit-shaped marshmallows	brittle diabetes mellitus	0
organic meat	spondylarthritis ankylopoietica	0
bitter nightshades	human influenzas	0
sun-dried raisin	muscle spasm	0
cucumis sativus	common bile duct gallstones	0
rooibos tea	atrial fibrillations	0
tuna fish	cjd (creutzfeldt jakob disease)	0
jalapeno peppers	spondyloarthritis ankylopoietica	0
eating nuts	zoonotic infections	0
lens culinari	polyarthritis	0
cycad trees	schizophreniform disorder	0
mackerel	ankylosing spondylitis	0
buckwheat	primary fibromyalgias	0
brewing tea	lymphatic sarcoma	0
sesame oils	protein deficiencies	0
food additive	gum disease	0
white meat	fibroadenoma	0
alcoholic beverages	blood cancer	0
blueberry plant	hansen disease	0
malabar nut	cancer of mouth	0
crataegus monogynas	insomnia disorder	0
cultivated radish	microcephaly	0
chinese cassias	acute inflammatory polyneuropathies	0
catfish	parasagittal meningiomas	0
allium porrum	paroxysmal atrial fibrillations	0
callerya	cancer of liver	0
holy basil tea	exudative bronchiolitis	0
carbonated water	reproductive sterility	0
poisonous plants	neoplasm metastasis	0
healthy fruit	ciliary neuralgias	0
supper	brain benign neoplasms	0
steak	back aches	0
specific cheeses	amyloid deposit	0
mentha spicatas	tussive syncopes	0
conventional food	familial guillain-barre syndrome	0
candy	chronic lymphatic leukemia	0
st. johnswort	oral cancers	0
rowanberry	toxico infectious botulism	0
romaine lettuce	hyperventilation syncopes	0
beet greens	uterus cancers	0
cooked meat	transmissible dementia	0
chinese yams	ponv	0
quinoa	near-death experience	0
olive	allergic diseases	0
norus	age-related maculopathy	0
bagel	somatosensory seizures	0
plant arils	different cancer	0
sticker	familial dementias	0
bacon	chronic insomnia	0
noni fruit	rete testis tumor	0
prunis communis	ovary cancers	0
cardamon	sterility	0
food coloring	hyperemesis gravidarum	0
dried pomegranate	renal insufficiencies	0
plant-based foods	sleep related neurogenic tachypnea	0
goji berry plants	paraesophageal hernias	0
candy bars	baldness	0
white pepper	autism	0
zucchini	diffuse lymphomas	0
plantago lanceolata	atherosclerotic plaques	0
mustard plant	mild neurocognitive disorders	0
exotic fruit	prostatic neoplasm	0
taking vitamin	malignant neoplasm of breast	0
paella	preventable cancers	0
mentha	bses (bovine spongiform encephalopathy)	0
food company	birth weights	0
food pyramid	autoimmune diabetes	0
red pepper	global amnesia	0
cow's milk	brief reactive psychosis	0
vaccinium corymbosum	brain cysticercosis	0
rheum officinale	non hodgkin's lymphoma	0
dioscorea opposita	non hodgkins lymphoma	0
indian gooseberries	inflammatory polyneuropathy acutes	0
group foods	bechterews disease	0
oatmeal	senile tremor	0
morinda	cough	0
corn oils	disc degeneration	0
ginger ale	cvas (cerebrovascular accident)	0
sea vegetable	dementia	0
walnut	jacksonian seizure	0
liquorice	barrett epithelium	0
dress	tactile hypesthesia	0
raphanus sativus	avitaminose	0
serve	diffuse mixed-cell lymphoma	0
solanum dulcamaras	cancer of the tongue	0
almond butter	bipolar disorders	0
largest meal	diabetic retinopathy	0
prebiotic	uterus neoplasm	0
cucumber	cancer of breast	0
clove	sudden cardiac arrests	0
oreo	primary growth hormone resistance	0
texturized vegetable protein	small-cell lymphomas	0
petroselinum	thrombus	0
billion eggs	non-hodgkin lymphoma	0
tomato sauce	nonhodgkins lymphoma	0
edible grain	superficial head injury	0
tea	spongiform encephalopathies	0
mother cell	back ache	0
sparkling waters	visceral obesities	0
dietary plant protein	diabetic neuropathies	0
hemp plant	cognitive decline	0
cannabis sativa	degenerative neurologic diseases	0
goji berries	age-related bone losses	0
big meals	kahler disease	0
crunch berries	cardiac arrhythmia	0
true nut	neurodegenerative disorders	0
jam	cluster headache	0
white tea	cardiovascular disease	0
cinnamomum verum	endometrial neoplasm	0
plum	weight loss	0
chili	age-related osteoporosis	0
cleistocalyx	intermediate grade lymphoma	0
artichoke	convulsion	0
sweet basil	somatotropin hypersecretion (acromegaly) syndromes	0
laudable legume	cancer of the mouth	0
cooked carrots	post-ictal confusion	0
dinnertime	retained surgical item	0
bitter nightshade	generalized seizures	0
soy beverage	massive tremor	0
sea bilberries	retained surgical tool	0
low fruit	symptom clusters	0
cruciferous vegetables	tongue cancers	0
ready-to-eat meal	respiratory infections	0
weed	hemolytic jaundices	0
pepsi	bovine leukemias	0
linum	primary brain neoplasm	0
mentha spicata	congenital hypothyroidism	0
lemon balm tea	spiral fractures	0
red delicious	age related maculopathy	0
mastic trees	heart diseases	0
grape juice	monocular blindness	0
carob	brain cancer	0
prunus cerasifera	premature births	0
yerba mates	ekbom delusional parasitoses	0
tap water	penile cancer	0
trace minerals	breast dysplasia	0
hickory nuts	diabetic mononeuropathy	0
saint john wort	adolescent gynecomastia	0
chestnut	polyphagia	0
split pea	sudden infant death	0
find pork	osteoarthrosis	0
breakfast	chronic insomnia	0
assai palm	fibromyositis-fibromyalgia syndrome	0
eugenia aromatica	migraine headaches	0
trigonella foenum graecum	nutritional disease	0
cantaloupe	salami brusher's disease	0
ready-prepared foods	royal free disease	0
french bean plant	intracranial neoplasms	0
coriander	cranial pain	0
beet	gustatory seizures	0
basil	breast cystic diseases	0
crocus sativus	small non-cleaved-cell lymphoma	0
silybum marianum	hydrophobia	0
dinner	lymphocytic lymphoma	0
trompillo	gorlin goltz syndrome	0
honeybush tea	vertex headaches	0
ilex paraguarienses	autoimmune disorders	0
durum wheats	fine tremors	0
calendula officinalis	age related memory disorders	0
garbanzo	endocrine breast diseases	0
food allergy	rectal cancer	0
papaver	vaginal cancers	0
lavandula angustifolia	neuralgic migraines	0
cooked broccoli	insulin deficiency	0
vaccinium bracteatums	intracranial cns disorders	0
consumer protection scientific committee on food	cancer of vagina	0
suggesting fruit	transmissible dementias	0
cod	malignant melanomas	0
cocos nuciferas	manic states	0
andean blackberry	hemolytic jaundice	0
citrus hystrices	painful diabetic neuropathies	0
peach	male breast enlargement	0
consumed chocolate	growth hormone receptor deficiency	0
jelly beans	somatotropin hypersecretion syndrome (acromegaly)	0
psidium guajava	intervertebral disc degeneration	0
tisane	guillaine barre syndrome	0
fatty meal	prediabete	0
hickory tree	muscular rheumatism	0
acaí berries	microlissencephaly	0
wheatgrass	essential tremor	0
white rice	iodine deficiency	0
oxen meat	clonic seizures	0
salmonella-infected eggs	cattle leukemia virus	0
stevia rebaudianas	primary brain neoplasm	0
century plant	cjd (creutzfeldt-jakob disease)	0
poisonous plant	acquired blindness	0
flesh foods	cancer of mouth	0
fennel seeds	tonsil cancers	0
poppy seeds	bacterial vaginosis	0
dietary fiber	pyrose	0
golden glow	foreign object	0
alfalfa sprout	reactive confusion	0
sour cream	atherogenesis	0
regular olive	congenital defects	0
cider vinegar	necrotizing fascitis	0
beta vulgaris	acute inflammatory polyneuropathy	0
common foxglove	hepatitis	0
curried tofu	liver dysfunction	0
daily fruit	b12 deficiency	0
espresso	insulin resistance	0
dried blueberries	retro-ocular headaches	0
so-called meat	obesity in childhood	0
fried foods	retained surgical tool	0
sell meat	familial diffuse gastric cancer	0
andropogon nardus	variant creutzfeldt jakob disease	0
low-sodium diet	infant gynecomastia	0
persea americana	laron type dwarfism i	0
coffee	pyrosis	0
macadamia nuts	textiloma	0
pumpkin pie	gastric cancer	0
coconut	kidney stones	0
plantago psyllium	landry guillain barre syndrome	0
monitoring food	chronic b-cell leukemias	0
paprika	cardiogenic syncope	0
topical ginger	diabetic neuropathy	0
ale	human immunodeficiency viruses	0
linum usitatissimum	tongue cancers	0
specific foods	ulcerative colitis type inflammatory bowel disease	0
flavorer	high blood pressures	0
toxic plant	migraine headache	0
fortify milk	determination of death	0
holy basils	parietal region trauma	0
replenish nutrients	bilateral sciatica	0
chicken meat	pleomorphic lymphomas	1
dairy products	somatosensory seizures	0
antioxidant-rich foods	kidney neoplasm	0
euterpe	early-onset parkinsonism	0
calling eggs	encephalon disease	0
eugenia malaccensis	diarrhea	0
solanum lycopersicum	cow disease	0
currant	spinal cord diseases	0
pinto beans	acquired immuno deficiency syndrome	0
rubus fruticosus	parkinsonism dementia complex of guam amyotrophic lateral sclerosis	0
secale	small-cell lymphomas	0
coriandrum sativums	fibroid tumors	0
kenaf	gastro-oesophageal reflux	0
acai berries	arthritide	0
ranking foods	skin rash	0
animal food	premature births	0
dietary supplement	environmental cancer	0
soy cheese	orthostatic headache	0
citrus	schizophrenia	0
dragon fruit	cancer of the testis	0
unrefined plant	uterine cancers	0
spice turmeric	insomnia	0
plantago seed	urticaria	0
drinking coffee	guam form amyotrophic lateral sclerosis	0
euchresta	voice box cancer	0
baby formula	anemia	0
lucerne	migratory pain	0
restrict food	darkness tremors	0
oyster mushroom	short sleeper syndrome	0
anise seed	bovine leukosis	0
nicotiana tabacums	upper respiratory infection	0
individual food	udpglucose hexose 1 phosphate uridylyltransferase deficiency	0
areca nuts	intracranial meningiomas	0
zedoary zedoaria	hip fractures	0
squash plants	sudden infant death syndrome	0
cereal	burkitt's lymphoma virus	0
digitalis	uterine fibroid	0
diospyros digynas	social phobias	0
hamburger	premature birth	0
emphasizes vegetables	type c oncovirus	0
crowberry	migratory pains	0
fagopyrum	status migrainosus	0
flaxseed	small-cell lymphomas	0
wheat	anxiety disorder	0
kidney bean	uterine fibroids	0
ceylon cinnamon	common bile duct gallstones	0
potato	bronchial asthma	0
atropa belladonna	plasma-cell myeloma	0
venison	tumor of rete testis	0
cumin	varix	0
chinook salmon	periodontal disease	0
drink milk	gluten enteropathies	0
lens culinaris	cancer of the esophagus	0
green peas	amnestic states	0
ananas	olfactory seizure	0
pistachio nut trees	non-hodgkins lymphoma	0
citrus medica	static tremors	0
kawa	causes cancers	0
no coffee	infertility	0
punica granatum	somatotropin hypersecretion syndromes (acromegaly)	0
stryphnodendron	causes cancers	0
organ	mixed lymphocytic-histiocytic lymphomas	0
peppermint	fibrocystic breast disease	0
chipotle	malignant epithelial neoplasms	0
avocado	social phobias	0
black pepper	episodic cluster headaches	0
thymus vulgari	galactosemia 2	0
fermented foods	small noncleaved-cell lymphomas	0
moose meat	sarcopenia	0
contaminated meat	drug dependence	0
ribes nigrum	cervical cancer	0
chinese rhubarb	low-grade b-cell malignancy	0
chili pepper	mixed small and large cell lymphoma	0
black currants	acute confusional migraines	0
portulaca	near-death experience	0
vitamin pills	vulvar cancers	0
anacardium occidentale	cognitive retention disorders	0
saint john's wort	causes cancers	0
probiotic	cerebrovascular accident	0
almond tree	muscle tremor	0
nut bar	syncopal vertigo	0
rosehip	rachitis	0
veggie	angiomatous meningiomas	0
cold-steeping tea	autosomal recessive juvenile parkinson disease 2	0
tobacco	polyphagia	0
plaice	chronic b cell leukemia	0
triticum aestivum	peripheral arterial diseases	0
onion	hypovolemic shock	0
artificial butter	olfactory groove meningioma	0
allium sativum	crohn's disease	0
pea families	postoperative vomiting	0
nettle tea	ph1 negative myelogenous leukemia	0
medicago sativa	eczema	0
red meats	postoperative emeses	0
origanum vulgare	intention tremors	0
thyme	causes cancers	0
pizza	retroviridae	0
apium graveolens var. rapaceum	amnestic state	0
prosopis	male sub-fertility	0
green onions	anal ulcer	0
brazil nuts	rectum neoplasm	0
nuclear power plants	well-differentiated lymphocytic lymphoma	0
iv vitamin	arthrose	0
alfalfa	paralysis	0
cicer arietinum	muscle tremor	0
bibhitaki fruit	dementia with amyotrophic lateral sclerosis	0
brewed coffee	generalized spasms	0
dried fruits	soft tissue sarcomas	0
baby spinach	gynecomastia	0
acid-binding vegetables	reverse cancer	0
areca catechus	chronic daily headache	0
cultivated oats	subwakefullness syndrome	0
maguey	weight losses	0
brazil nut tree	ciguatera fish poisoning	0
plant zygote	texidor's twinge	0
syzygium	icterus	0
caryophyllus aromaticus	human t lymphotropic virus type iii	0
chocolate pudding	physical anhedonia	0
plum trees	psychotic disorders	0
collard	non-epileptic convulsion	0
triticum turgidum subsp. durum	growth hormone receptor defect	0
psyllium	aphthous ulcer	0
morinda citrifolias	short sleeper syndrome	0
crave chocolate	parodontose	0
pimpinella anisums	kidney stone	0
rhubarb	reversing chronic disease	0
golden raisins	acute inflammatory polyneuropathies	0
baked potato	headache disorder	0
euterpe precatoria	cancer of the bladder	0
nori	pneumonitide	0
petroselinum crispum	backache	0
solanum laciniatum	aids virus	0
soy protein	pustulosis of palms and soles	0
euterpe oleracea mart.s	cognitive impairments	0
banana plants	cervical neoplasms	0
acai berry	germinoblastic sarcomas	0
glucose-fructose syrup	inflammatory disorder	0
pureed apples	ekbom psychogenic parasitoses	0
sweetleaf	ocular headache	0
butternut squash	short sleeper syndrome	0
pine nuts	intracranial cns disorders	0
laciniate nightshade	itch	0
cicer arietinums	fine tremor	0
unfertilized eggs	neuralgic migraines	0
tomato juice	back pains	0
cranberry	vertebrogenic pain syndrome	0
bitter orange trees	higher cancer	0
ephedras	somatotropin (acromegaly) hypersecretion syndrome	0
vaccinium macrocarpons	mad cow disease	0
osmanthus tea	erectile dysfunction	0
powdered ginger	acquired immuno deficiency syndrome	0
teosinte	irritable bowel syndrome	0
assai palm berry	sinusitide	0
amla	schilling type myeloid leukemia	0
pomegranate	parasagittal meningioma	0
plant capsules	intraepithelial neoplasms	0
pimpinella	cluster headache syndromes	0
kiwi	abdominal obesities	0
rubus idaeus	reduced sensation	0
belladonna	esophagus neoplasm	0
mangifera indica	cervical cancer	0
licorice	chronic b-lymphocytic leukemias	0
banana	endocrine breast disease	0
brew	lewy body parkinson's disease	0
secale cereale	cancer of the prostate	1
white bread	water-borne hepatitides	0
dried peas	thyroid adenomas	0
soybean proteins	pyrosis	0
narrow leaved plantain	urinary bladder neoplasm	0
prunus dulcis	jakob-creutzfeldt disease	0
bell pepper	rna tumor virus	0
celebration meal	udp-galactose-4-epimerase deficiency	0
mangiferas	fight cancer	0
soy yogurt	idiopathic proctocolitis	0
osmanthus	gall bladder diseases	0
lima beans	influenza	0
popcorn	age related osteoporosis	0
seed	familial atrial fibrillations	0
eating fruits	atrial fibrillation	0
cocoa powders	increase cancer	0
lemon tree	fibromyalgia-fibromyositis syndromes	0
caper	lactose intolerance	0
justicia adhatoda	lung disease	0
bamboo shoots	postoperative nausea	0
tepary beans	gerd	0
amlas	adolescent obesity	0
infects apples	liver dysfunctions	0
kava kava	textiloma	0
mangifera	microglandular adenoses	0
actual fruit	rash	0
vaccinium uliginosum	allergy	0
own vitamin	retained surgical needles	0
toronja	age-related maculopathy	0
emblica officinalis	fusiform aneurysms	0
healthiest beverage	diabetes complication	0
meal times	renal cancers	0
cannabi	chronic lymphocytic leukemias	0
raisin bran	hydrophobia	0
nonus	diabetes mellitus complication	0
chia seeds	diabetic complications	0
agaricaceae	complete hearing loss	0
pyrus	myalgic encephalomyelitis	0
sea-food	iritide	0
pomelo tree	dermatosis	0
english walnut	prediabetic states	0
black walnut	mouth and tooth diseases	0
term vegetable	superficial head injury	0
human milk	thyroid cancer	0
pretzel	hiatus hernia	0
little meat	viral infections	0
poultry meat	crohn disease	0
diospyro	liver steatosis	0
concord grape	clear cell meningiomas	0
avoid peanuts	bilateral deafness	0
rice milk	manic-depressive psychosis	0
eggplant	terminal cancer	0
wild yam	adolescent gynecomastia	0
olive oils	craniocerebral traumas	0
shoot	syncopal episode	0
apple trees	confusional states	0
bellis	infant botulisms	0
white mallows	vaginal cancer	0
carbonated drink	juvenile onset diabetes	0
mastictree	headache	0
salmonella food	retained surgical sponges	0
dairy yogurt	social phobias	0
marshmallow	head injury	0
common olive trees	urticarias	0
capsicum annuum	lower back pains	0
nicotiana tabacum	continuous tremor	0
pistachio nut tree	prediabetic states	0
citrus maxima	male infertility	0
berberi	dairy product intolerance	0
nut	pseudotumor cerebri	0
ilex paraguariensis	ciliary neuralgia	0
java plum tree	hypoascorbemia	0
lettuce	neurodegenerative disease	0
scrambled eggs	acute cerebrovascular accidents	0
cookie	prostatic cancers	0
dessert	postoperative vomiting	0
agent orange	plasma-cell myeloma	0
brewage	brain vascular accidents	0
mustard	prostatic intraepithelial neoplasia	0
sugar	testicular neoplasms	0
kiwi fruits	lassitude	0
jambolan plum tree	amyloid plaques	0
plantago indica	physical anhedonia	0
plant capsule	behavior disorders	0
nut bars	carcinomatose	0
food supplementations	fatigue	0
celeriac	diffuse well-differentiated lymphocytic lymphoma	0
daucus carota	utp hexose-1-phosphate uridylyltransferase deficiency	0
dark chocolate	miscarriage	0
dandelion	higher cancer	0
illicium	cattle leukemia virus	0
maize	galactose epimerase deficiency	0
dietary supplements	somatotropin (acromegaly) hypersecretion syndrome	0
citrus fruits	parkinson's disease	0
vaccinium bracteatum	todd's paralysis	0
mirobalanus embilicas	mastalgia	0
spore	peripheral arterial disease	0
almond	renal neoplasm	0
frier	breast cancer	0
jambolan plum trees	autosomal recessive familial parkinson disease	0
jalapeno	persistent atrial fibrillation	0
squashe	hemangioblastic meningioma	0
coleslaw	widespread chronic pain	0
common bean plants	manic state	0
chinese food	tumor virus	0
seltzer waters	gustatory seizures	0
lentinus edodes	progressive disorder	0
thymus plants	social phobia	0
family vegetables	idiopathic proctocolitis	0
chicken	wheat allergies	0
brassica	burning pains	0
uncooked foods	semantic memory disorder	0
plantago	starvation	0
common olive tree	endometrial neoplasms	0
handling food	male breast cancer	0
bertholletia excelsa	t virus	0
density foods	clear cell meningioma	0
french bean plants	mucous colitides	0
orange	arthrosis	0
piper methysticum	autoimmune diabetes	0
prettiest fruit	age-related memory disorder	0
althaea	pustulosis palmaris et plantaris	0
citron trees	recrudescence	0
lipomul	human papilloma virus	0
crabapple	udpglucose hexose 1 phosphate uridylyltransferase deficiency	0
soybean	foodborne botulism	0
bean sprout	premature birth	0
stuff	atrioventricular dissociations	0
fermented cabbage	peanut hypersensitivity	0
soft drinks	retro-ocular headaches	0
chewed coca	juvenile parkinsonisms	0
chamomile	alcoholism	0
millet	infantile autism	0
california avocado	paralysis agitans	0
texturized vegetable proteins	superficial head injury	0
corn	autoimmune disorders	0
curry	adenovirus	0
healthy snacks	carcinoma of endometrium	0
breast milks	somatotropin (acromegaly) hypersecretion syndromes	0
carbonated waters	premature birth	0
cuminum cyminum	causes cancers	0
macadamia nut	limb cramps	0
healthiest apple	enzootic bovine leukosis	0
fat milk	zoonotic infectious diseases	0
ribe	rabies viruses	0
citrus paradisi	atypical diffuse small lymphoid lymphoma	0
star anise	udpglucose hexose-1-phosphate uridylyltransferase deficiency	0
portulaca oleraceas	glaucoma	0
aloe	benign prostatic hyperplasia	0
afzelia	cancer of brain	0
spice saffron	tongue cancer	0
cocoa plants	acute monocytic leukemias	0
herr	cancer of the rectum	0
nutrient-dense foods	sphenoid wing meningioma	0
dairy product	parodontosis	0
whole grain cereals	recrudescence	0
turkey meat	intermediate-grade lymphomas	0
illicium verums	ekbom psychogenic parasitosis	0
kava	cephalgia syndromes	0
high-phytate foods	atherosclerosis	0
citron tree	cardiovascular stroke	0
salad	kanner's syndrome	0
punica granatums	pulmonary embolism	0
hemlock	long sleeper syndromes	0
drinking milk	schizoaffective disorder	0
olive oil	fusiform aneurysm	0
orange trees	prostatic neoplasms	0
ready soybeans	alopecia cicatrisatas	0
trace element	focal seizure	0
cereal grain	transmissible spongiform encephalopathy	0
oregano plant	oxygen deficiencies	0
domestic fowl	bovine leukosis	0
carbonated beverage	low back pain	0
healthier foods	diabetic complications	0
jell-o	tonsillar cancers	0
acer saccharums	udp-galactose-4-epimerase deficiency	0
powdered sugar	inappropriate growth hormone secretion syndrome (acromegaly)	0
soda water	avitaminose	0
pistachio	kidney neoplasm	0
nutraceutical	male sexual impotence	0
ultra-processed foods	juvenile parkinsonisms	0
wolfberry	basal cell carcinomas	0
goji berry plant	angioblastic meningiomas	0
national pork	bladder tumor	0
chile pepper	childhood obesity	0
vital nutrients	fibrose	0
durum wheat	stokes-adams syncope	0
different seed	cephalgia syndromes	0
edible grains	diabetic mononeuropathies	0
actual licorice	gum disease	0
club sodas	arthropathy	0
vitamin	todds paralysis	0
gum acacia	cancer of the lung	0
wild celeries	infant botulism	0
intoxicant	intermediate grade lymphoma	0
black raspberries	bovine spongiform encephalopathy	0
marsh mallows	sarcoma	0
triticum turgidum	faint	0
coconut milk	retained surgical sponges	0
cooking meat	low backache	0
processed apples	sneezing	0
fuji apples	brain malignant neoplasms	0
prunus domestica	peanut allergy	0
horse beans	muscle pain	0
tv dinners	exudative bronchiolitides	0
japanese plums	acne vulgaris	0
vegetarianism	head injury	0
horse nettle	cough	0
processed meats	bacterial vaginosis	0
hazelnut	carcinoma	0
pistacia lentiscus	esophageal cancers	0
vegetable oil	huntington’s disease	0
carbonated beverages	renal cancer	0
cannabis indicas	halitose	0
shorten	renal cancer	0
hibiscus cannabinus	vagina cancers	0
citrus-based fruits	fibrocystic breast disease	0
sea vegetables	female subfertility	0
baby formulas	salmonella infections	0
healthy foods	ciliary body spasm	0
rooibos	forehead traumas	0
indian corn	human papillomavirus viruses	0
coca cola	leukemogenic viruses	0
zea	throat cancer	0
lens plant	lead poisonings	0
broccoli raab	diabetes mellitus complications	0
black beans	testicular tumors	0
artificial sweeteners	crohn's disease	0
vaccinium angustifolium	diffuse well-differentiated lymphocytic lymphoma	0
barley coffee	metabolic acidosis	0
low-fat diet	lou gehrig disease	0
brassica juncea	sliding hiatal hernias	0
bok choy	cholera	0
opium poppies	influenza	0
elephant garlic	grippe	0
lentil	colon neoplasms	0
humulus lupulus	cot death	0
calendula	bacterial vaginitis	0
mint tea	esophageal reflux	0
granny smith	rabies virus	0
soup	galactose epimerase deficiency	0
hemp	malignant tumor of breast	0
cruciferous foods	intraorbital meningioma	0
chicken salad	ebv	0
red rice	splitting pain	0
infant formula	clear cell meningioma	0
cheese	familial parkinson disease	0
sugar maple	tumorigenesis	0
teff	inflammatory bowel disease 1	0
abelmoschus	nevoid basal cell carcinoma syndrome	0
carya illinoenses	cancer of kidney	0
whole grains	visceral steatoses	1
thymus plant	degenerative arthritides	0
processed meat	oral neoplasms	0
table sugar	galactose epimerase deficiency	0
yeast rice	rectal tumors	0
applesauce	auricular fibrillation	0
curcuma	post traumatic osteoporosis	0
anana	laron syndrome	0
dog rose	stomach ulcers	0
mentha x piperita	varicose veins	0
holy basil	pruritus	0
cocoanut	disk degeneration	0
whole wheat	hydrophobia	0
not-necessarily-so-healthy foods	backache	0
green peppers	texidor twinge	0
licorice root	weight loss	0
cola nitida	b12 deficiency	0
canned fruit	basal cell epithelioma	0
french fries	paratuberculosis	0
melissa officinalis	influenza in humans	0
smoked foods	high-grade lymphoma	0
maize oil	chronic diseases	0
ceratonia	mastalgia	0
citrus aurantiifolias	kidney calculi	0
collard greens	early-onset parkinsonism	0
wild celery	benign prostatic hypertrophy	0
eupatorium rebaudianum	cerebrovascular stroke	0
cinnamon	head pain	0
açaí berry	idiopathic intracranial hypertension	0
usda poultry	milk sugar intolerance	0
nitrate-rich vegetables	headache disorders	0
different fruits	cryptogenic epilepsy	0
watercress	primary fibromyalgia	0
healthiest fruits	idiopathic polymyositis	0
foeniculum vulgares	smell disorder	0
hot sauce	coad	0
plant zygotes	abdominal cramps	1
olive tree	dna injury	1
celery	senile plaques	0
andean blackberries	galt deficiencies	0
garlic	canker sores	0
beer	gorlin syndrome	0
fava bean	muscle disease	0
navy beans	a-v dissociations	0
apricot trees	sleep related neurogenic tachypnea	0
granny smith apples	hiatus hernia	0
pea family	precordial catch syndrome	0
dried food	oxygen deficiency	0
acacia tree	human papillomavirus viruses	0
pimenta	spinal meningiomas	0
woodland strawberry	cephalgia syndrome	0
turnip	udp-galactose-4-epimerase deficiencies	0
vitis vinifera	rheumatoid arthritis	0
preserved foods	metastatic cancer	0
dangerous plants	retained surgical tool	0
regular carrots	crohn disease	0
glucose fructose syrup	gnathostoma infection	0
table salt	amyotrophic lateral sclerosis	0
garcinia mangostanas	tactile amnesias	0
indian gooseberry	small and large cleaved-cell lymphoma	0
broth	diabetic autonomic neuropathy	0
betel nuts	hypospadia	0
whipped cream	hair loss	0
leafy vegetables	iodine deficiency	0
wild yams	acquired immune deficiency syndrome	0
pie	hereditary galactokinase deficiencies	0
goiaba	auditory seizure	0
sugar substitute	tubal abortion	0
faba beans	arthropathy	0
brassica nigra	semantic memory disorders	0
cola acuminata	hansens disease	0
cayenne peppers	social anxiety disorders	0
animal-based vitamin	colitis gravis	0
flax	non hodgkins lymphoma	0
fragaria	arterial dysfunction	0
texturized soy proteins	age-related macular degenerations	0
hot pepper	heart diseases	0
anacardium occidentales	newborn gynecomastia	0
commercial milk	infantile obesity	0
healthy nuts	galactose epimerase deficiency	0
kava kavas	dna injuries	0
euterpe edulis	familial creutzfeldt jakob disease	0
morning meals	mottled enamels	0
apple tree	weight gains	0
grilled meat	human mammary neoplasm	0
chanterelle	passive tremor	0
msg	necrotizing fasciitis	0
raw foods	cancer of the cervix	0
acer negundo	human immunodeficiency viruses	0
milk chocolate	brain cancers	0
food supplements	primary gh resistance	0
roundup-ready soybeans	small cleaved cell lymphoma	0
citrus grandi	wound botulism	0
undercooked meat	myeloma multiple	0
plant-based nutrients	drug dependence	0
arecas	parkinsons disease	0
melissa officinali	neuritic plaque	0
english plantain	mucous colitis	0
decaf	intraepithelial prostatic neoplasias	0
frying meat	olfactory seizures	0
eupatorium rebaudianums	cognitive retention disorder	0
sausage	degenerative disease	0
syrup	lymphoplasmacytoid lymphoma	0
kombucha teas	skin diseases	0
chamomile oil	bipolar depression	0
persea	e-b viruses	0
cycad	male sub fertility	0
use sweeteners	radiating pains	0
blueberry plants	congenital abnormalities	0
tumeric	inflammatory bowel disease 1	0
mayo	uterine cancers	0
raw tomatoes	basal cell carcinomas	0
texturized soy protein	oncovirus	0
golden delicious apples	autosomal dominant. juvenile parkinson disease	0
seven nutrients	lymphoma	0
snack foods	chronic b-lymphocytic leukemia	0
mealtime	plasma cell myelomas	0
leek	recurrent low back pain	0
petroselinum crispums	cancer of rectum	0
jasmine tea	osteoarthritis	0
saint johnswort	focal seizures	0
zedoary zedoarias	inflammatory bowel diseases	0
filbert	pediatric cancers	0
cashew	determination of death	0
amomum cardamomum	insulin-dependent diabetes mellitus 1	0
grecian foxgloves	sharp headache	0
vinegar	primary insomnia	0
coca	transient insomnia	0
mint	prostatic intraepithelial neoplasias	0
peanut	deafness	0
cardamom	lumbago	0
syzygium jambolanum	renal neoplasm	0
clathrotropis	cervical neoplasms	0
crab apples	colorectal cancer	0
ocimum basilicum	cryptogenic epilepsies	0
papaver somniferum	rash	0
cruciferous vegetable	dental disease	0
chamomile tea	lou-gehrigs disease	0
persea americanas	subtrochanteric fractures	0
justicia	inflammatory bowel disease	0
high-fiber food	psoriasis	0
chamomile oils	early detection of cancer	0
drinking orange	birth defect	0
cinnamomum zeylanicum	viral hepatitis	0
processing meat	sinusitide	0
glycine max	food hypersensitivities	0
roselle	pharyngitide	0
convenience food	psychotic disorders	0
chocolate bars	persistent atrial fibrillations	0
portulaca oleracae	cll lymphoplasmacytoid lymphoma	0
yellow vegetables	hiatal hernia	0
croaker	zoonotic diseases	0
flavourer	syncopal episode	0
horse nettles	lung inflammation	0
gala apples	acute monocytic leukemia	0
convenience foods	creutzfeldt jakob syndrome	0
aubergine	gall stones	0
fava beans	schizophrenic disorders	0
oyster mushrooms	halitosis	0
sunfish	water borne hepatitis	0
scallion	food-borne illnesses	0
cinnamomum aromaticum	craniocerebral injuries	0
indian laburnum	liver neoplasms	0
curcuma longa	substance use disorder	0
taro	baldness	0
safflower	ebv	0
betel	cryptogenic epilepsies	0
spearmint	guillain barre syndrome	0
tomato	vertebrogenic pain syndrome	0
bread mold	atypical cluster headache	0
neu5gc-rich food	galactokinase deficiencies	0
alpine strawberry	global amnesia	0
curcuma longas	primary brain neoplasms	0
lemon balms	e b virus	0
prunus salicinas	malignant lymphomas	0
artificially-flavored corn	hypolactasia	0
lime	reticulolymphosarcoma	0
horsemeat	cognitive retention disorder	0
alfalfa sprouts	lactose malabsorption	0
deli meat	male breast tumors	0
organic foods	stomach cancers	0
last meal	congenital defect	0
box elders	uterine cancer	0
ground meat	anaplastic carcinoma	0
zinger tea	chronic obstructive airway disease	0
raphanus	b12 deficiency	0
floret	vaginal discharges	0
measuring food	fifth phacomatosis	0
lavender	severe congenital microcephalies	0
breast milk	diffuse mixed-cell lymphomas	0
pudding	body weights	0
linseed	vagina cancers	0
plant aril	benign meningiomas	0
deep-fry foods	colorectal neoplasms	0
lunchtime	cancer of bladder	0
lens plants	acute monoblastic leukemias	0
roasted almonds	dental fluorosis	0
dinner times	sinusitis	0
seville orange trees	treat cancer	0
delonix	sudden cardiac arrest	0
saffron	gall stones	0
breakfast cereals	regional ileitis	0
brown rice	intracranial neoplasm	0
black coffee	hepatitis	0
international nut	atherosclerotic plaque	0
potable water	brain vascular accident	0
chocolate	prostatic adenoma	0
chai tea	cryptogenic epilepsy	0
red lentils	autism	0
confection	preventing cancer	0
guava	leanness	0
triticum spelta	hyperemesis gravidarum	0
chili peppers	johne disease	0
gluten-free diet	multiple meningiomas	0
dietary sucrose	involuntary quiver	0
ground beef	mental disorders	0
banana plant	colorectal carcinoma	0
celery root	diabetic neuralgias	0
kawa kawas	wart	0
salsa	male breast carcinoma	0
nutmeg	epimerase deficiency galactosemias	0
cured meats	thyroid cancer	0
earl grey tea	oral neoplasms	0
dinner time	bruise	0
rabbit meat	diffuse lymphocytic lymphoma	0
jelly	gallbladder diseases	0
frying foods	pediatric cancers	0
lavandula	drop attack	0
malabar-nut	single seizures	0
pancake	cholera	0
so-called vegetable	atopic diseases	0
eating eggs	bone cancer	0
purine-rich plant	bowel disease	0
carbonated mineral water	gustatory seizure	0
poppy	lymphoplasmacytoid lymphoma	0
mother cells	autosomal dominant juvenile parkinson disease	0
cinnamomum trees	feline leukemia viruses	0
triticum durum	trochanteric fractures	0
fragaria vesca	throbbing headache	0
fatty foods	tumor virus	0
mandarin orange tree	a-v dissociation	0
exotic fruits	hysterical amnesia	0
sweet almonds	somatosensory seizures	0
cola	polymyositide	0
spinacia oleracea	breast disease	0
olea	fibrous meningiomas	0
prunus amygdalus	variant creutzfeldt-jakob disease	0
salami	headache disorders	0
crocus	colorectal cancers	0
prunus persica	transmissible dementia	0
reindeer meat	atrophy	0
food supplement	degenerative disease	0
cocoa butter	testicular cancers	0
red wine	hyperphagia	0
cilantro	sarcoma	0
domestic fowls	pulmonary inflammations	0
low vitamin	malignant neoplasm of breast	1
sustenance	soft tissue sarcomas	0
whole grain cereal	small and large cleaved-cell lymphoma	0
mustard greens	common cancers	0
blueberry	lichen planus	0
food and drug administration	hereditary galactokinase deficiency	0
brussels sprouts	mouth cancer	0
flowering shrub	diabetes complication	0
mango	pleomorphic lymphoma	0
tempeh	bladder cancers	0
coriandrum	bovine lymphoma	0
carica	halitose	0
chile peppers	juvenile-onset diabetes mellitus	0
corn sugar	necrotizing fascitides	0
lemon trees	age related memory disorders	0
common fruits	male sexual impotence	0
soya milk	auditory seizure	0
prosopi	ovarian cancers	0
happy meal	visceral obesity	0
corn oil	felv	0
healthier meat	cluster headaches	0
abelmoschus esculentus	flatus	0
myristica fragrans	necrotizing fascitides	0
soy bean curd	cholera	0
overpriced vitamin	vaginal discharges	0
drug administration united states food	memory loss	0
cream cheese	diabetic autonomic neuropathies	0
breakfast cereal	motor seizures	0
marsh mallow	postoperative nausea and vomiting	0
turmeric	arthralgia	0
contaminated foods	tumor	0
anise	adenosis of breast	0
diabetic diets	disrupted in b-cell malignancy	0
saccharomyces cerevisiae	adenomatous polyps	0
rosa	udp-galactose-4-epimerase deficiencies	0
monkfish	post-traumatic osteoporoses	0
beef	monocular blindness	0
cider	polymyositis ossificans	0
carrot juice	lav-htlv-iii	0
dried plums	blv	0
wild radish	prostatic cancer	0
chickpea	intermittent tremors	0
salt-free diet	a-v dissociations	0
kawa kawa	micturition syncope	0
wheat bran	high cholesterol level	1
porgy	contagious pustular dermatitis	0
tea hibiscus	malignant lymphomas	0
cocos nucifera	sleeplessness	0
american meat	metastatic cancer	0
dietary fibers	pseudoaphakia	0
added sweeteners	diabetic complications	0
bottled water	bowel disease	0
vegetable juices	papillomaviridae	0
shellfish	creutzfeldt-jakob disease	0
citrus hystrix	hydrophobia	0
mushroom	bleed	0
pecan	breast malignant neoplasm	0
safflower oils	ciliary neuralgia	0
da huang	mixed small and large cell lymphoma	0
raw food	gastric acid reflux disease	0
fast food	periodontal diseases	0
soy proteins	ponv	0
chinese yam	avitaminose	0
treat	small noncleaved-cell lymphoma	0
anise tea	galactose-1-phosphate uridyltransferase deficiency	0
vicia fabas	gluten sensitive enteropathy	0
squid	age-related bone loss	0
offal	burkitt lymphoma virus	0
herb	muscular rheumatism	0
marjoram plant	anaplastic carcinomas	0
cymbopogon nardus	cervical neoplasms	0
flounder	somatotropin (acromegaly) hypersecretion syndromes	0
tree nuts	male impotence	0
red delicious apples	barrett's esophagus	0
sweetener	kidney calculi	0
pickled vegetables	udpglucose hexose-1-phosphate uridylyltransferase deficiency	0
cherry plum trees	breast cancer	0
sweet marjoram	tonsil neoplasm	0
brussel sprout	cancer of the stomach	0
refined olive	pregnancy-induced diabetes	0
dripping	a-v dissociation	0
bread	retained surgical instrument	0
walnut oil	pustulosis of palms and soles	0
chinese cassia	allergy	0
pickled foods	cancer of penis	0
shiitake	gallstone	0
raisin	foodborne disease	0
root	amnesia-memory losses	0
fresh fruits	apneas	0
oolong	autosomal recessive juvenile parkinson disease 2	0
myristica fragran	nonhodgkins lymphoma	0
almond oil	senile tremors	0
pear	bacteriophage	0
phaseolus vulgaris	ovarian cancers	0
cooked tomatoes	bladder tumor	0
collard green	bacterial vaginitis	0
sweetening agent	schizophreniform disorder	0
olive trees	osteoarthritide	0
cassia	long sleeper syndrome	0
ephedra	esophagus cancer	0
carrot	water stress	0
fruit juices	deep-venous thromboses	0
broad beans	uterus neoplasm	0
pepper	myalgia	0
spaghetti	venereal warts	0
dioscorea batatas	intraventricular meningiomas	0
bt corn	mental disorders	0
citrus sinensis	grave’s disease	0
high-fructose corn	tongue neoplasm	0
common foxgloves	intervertebral disk degenerations	0
drinking tea	vaginal cancers	0
sparkling water	birth weight	0
bean sprouts	high cholesterol levels	0
trace elements	coma	0
green grapes	lyme borreliosis	0
grapefruit juice	diffuse small cleaved-cell lymphoma	0
eating broccoli	vaginal cancers	0
avocado fruit	genital warts	0
nutritional yeast	cancer of the rectum	0
raw alfalfa	syncopal episodes	0
whiting	senile osteoporosis	0
apple juice	esophageal hernia	0
syzygium sandwicense	human t cell leukemia virus type iii	0
brown sugar	anoxemia	0
cassia cinnamon	male pattern baldness	0
cocoa	carsickness	0
proteus mirabilis	thrombus	0
purslane	effort syncope	0
narrow-leaved plantain	salmonellosis	0
natto	soft tissue sarcoma	0
poultry product	ischemia	0
curcuma zedoarias	carotid sinus syncope	0
dasheen	beriberi	0
common bean plant	intervertebral disk degenerations	0
chinese cinnamon	pituitary dwarfism iis	0
high fructose corn syrup	pregnancy induced diabetes	0
red cabbage	exudative bronchiolitides	0
juglans nigra	skin diseases	0
arugula	pyrose	0
japanese plum	small cleaved cell lymphoma	0
cannabis sativas	small round-structured viruses	0
extracted fruit	human mammary carcinoma	0
warm milk	eczema	0
component spices	barrett's syndrome	0
herbal teas	pharyngitide	0
preserved food	pernicious vomiting of pregnancy	0
dietary fats	gum disease	0
ovary	peripheral arterial disease	1
nightshade	ekbom psychogenic parasitosis	0
horse bean	age-related memory disorders	0
amomum cardamomums	colitis gravis	0
red tea	cephalalgia	0
silybum marianums	sarcopenia	0
origanum majorana	germinoblastic sarcomas	0
plantain	cva (cerebrovascular accident)	0
white wine	sleeplessness	0
oryza	t virus	0
strawberry	disc degradations	0
ganja	basal cell carcinomas	0
curry powder	testis neoplasm	0
okra	cancer of bladder	0
including cloves	leanness	0
cucurbita	national cancer	0
cooked meats	hair losses	0
pistacia	small non-cleaved-cell lymphomas	0
rheum tanguticum	benign prostatic hypertrophy	0
yerba mate	single seizure	0
placenta	psychotic disorders	0
dried apricots	coarse tremor	0
syzygium jambos	sleep initiation dysfunctions	0
honey	oral cancer	0
grecian foxglove	mixed small and large cell lymphoma	0
chewing gums	pulmonary disorder	0
poultry products	sneeze	0
food companies	atopic disease	0
kale	chromosome 6 linked autosomal recessive parkinsonism	0
turmeric root	dysosmia	0
nettle	parkinsonian syndromes	0
foxglove	neurotic anxiety state	0
leaf lettuce	arthralgia	0
bergamot	primary brain neoplasm	0
oryza sativa	age-related bone losses	0
bhang	barrett syndrome	0
maple syrup	chronic headaches	0
added nuts	huntingtons disease	0
foodstuff	temporary amnesias	0
saffron crocus	memory disorder	0
food allergies	b-cell leukemia	0
apium graveolens var. dulce	somatosensory seizure	0
antioxidant foods	substance dependence	0
english plantains	celiac sprue	0
nutriceutical	ciguatera fish poisonings	0
pomegranate fruit	kidney cancers	0
colorful foods	t virus	0
decaffeinated tea	colon cancer	0
hypericum perforatum	peripheral autoimmune demyelinating disease	0
calendula officinali	androgenic alopecias	0
dietary sugars	physical sufferings	0
sweet almond	multiple head injury	0
unhealthy food	malignant tumor of urinary bladder	0
rice	food borne illnesses	0
cured meat	cancer of bone	0
fresh meat	reverse cancer	0
kola nuts	faint	0
thymus vulgaris	right-sided heart failure	0
wheat brans	esophageal hernias	0
sweet foods	papillary meningioma	0
caryophyllus	reverse cancer	0
citrus bergamias	virus infections	0
grape	exudative bronchiolitis	0
maize syrup	cancer of the liver	0
restructured meat	anthrax	0
tangerine trees	hyperphagia	0
cereal grains	sudden onset diabetes mellitus	0
spinach	lung inflammations	0
cinnamomum cassia	small cleaved cell lymphoma	0
phytonutrient-rich food	malignant primary brain tumors	0
endive	gorlin-goltz syndrome	0
worldwide fruit	fatty liver	0
rise	complete hearing loss	0
dog rose berries	painful menstruations	0
poroporo	diffuse lymphocytic lymphoma	0
barberry	senile tremors	0
glycyrrhiza glabra	sunburn	0
haritaki fruit	bladder neoplasms	0
sandwich	cancer of the lung	0
curcuma zedoaria	protein deficiencies	0
philadelphia cream cheese	cot death	0
fennel	malignant tumor of urinary bladder	0
phyllanthus emblicas	non hodgkin's lymphoma	0
emblica officinali	vulvar neoplasm	0
citrus medicas	chest pains	0
tachigalia	primary parkinsonism	0
feather meal	age related maculopathy	0
andira	acute confusional migraines	0
coconut water	b12 deficiency	0
dietary protein	nutritional disease	0
st. john's wort	autism	0
roughage	cvas (cerebrovascular accident)	1
willow tree	insulin dependent diabetes mellitus	0
soy foods	peripheral demyelinating autoimmune disease	0
faba bean	nafld	0
pleurotus ostreatus	rebound insomnia	0
soy food	chronic headache	0
broccoli	torsion fracture	0
chenopodium quinoa	varicose veins	0
liquor	cognitive dysfunction	0
rubus glaucus	gluten-sensitive enteropathies	0
hypericum	deafness	0
nonfat meal	hemangiopericytic meningioma	0
contamination meat	sleeplessness	0
allium cepa	low grade lymphoma	0
pease	nonalcoholic steatohepatitides	0
longevity legumes	respiratory tract cancer	0
drinking water	ciguatera fish poisoning	0
wisconsin milk	persistent tremors	0
oregano	cardiac diseases	0
no noni	bilateral headaches	0
morning meal	situational syncope	0
kola nut	vulvar cancers	0
mustard oil	sleep wake disorder	0
soy bean curds	short sleeper syndrome	0
dark meat	bladder disease	0
sweet peppers	mucous colitis	0
cannabis indica	autosomal dominant juvenile parkinson disease	0
high-fructose maize syrup	short sleep phenotypes	0
swiss chard	ekbom psychogenic parasitoses	0
citrus aurantiifolia	proliferative bronchiolitides	0
cuminum cyminums	mixed-cell lymphoma	0
natural vitamin	infectious disease	0
halibut	esophageal hernia	0
larder	neuritic plaque	0
stevia rebaudiana	tonic-clonic seizure	0
carya	colorectal carcinomas	0
majorana hortensis	primary growth hormone resistance	0
linum usitatissimums	heart blocks	0
green beans	intractable headaches	0
syzygium cumini	diffuse myofascial pain syndrome	0
phaseolus acutifolius	bacterial vaginosis	0
pimiento	galactokinase deficiency diseases	0
solanum dulcamara	ulcerative colitis	0
cocoa plant	crohn's disease	0
cabbage	plasmodium infections	0
organ meats	udpglucose hexose-1-phosphate uridylyltransferase deficiency	0
dietary plant proteins	psychosis	0
recommend tea	pancreatic cancer	0
kidney beans	pruritis	0
colocasia	recurrent brain tumor	0
fruit juice	spindle cell sarcoma	0
hashish	substance use disorders	0
shiitake mushroom	schizophreniform disorders	0
soy	study cancer	0
phyllanthus emblica	primary brain tumor	0
cayenne pepper	abdominal aortic aneurysm	0
ginger	recurrence	0
assai palm berries	liver injury	0
pinto bean	male breast cancer	0
mirobalanus embilica	urinary bladder disease	0
diospyros digyna	olfactory groove meningioma	0
black walnuts	tonic-clonic seizures	0
foie gras	low back pain	0
cicer	recurrent brain tumors	0
drink tea	human herpesvirus 4	0
real chocolate	schizophreniform disorder	0
milk thistle	iron deficiency	0
soymilk	mad cow disease	0
legume pods	parkinson's disease	1
candy bar	diffuse mixed-cell lymphomas	0