
fenugreek	cancer of the ovary	0
cinnamomum aromaticum	lower back pains	0
triticum turgidum	avitaminose	0
tomato	female infertility	0
nut	peanut hypersensitivity	0
collard greens	tactile amnesias	0
macadamia nuts	cat leukemia virus	0
cassia tree	childhood obesity	0
cocos nuciferas	cardiovascular stroke	0
lime	tongue cancer	0
vaccinium uliginosum	mental disorders	0
contaminated meat	aortic aneurysms	0
juiced broccoli	urinary bladder neoplasms	0
cola acuminata	gustatory seizures	0
group foods	male breast neoplasm	0
pancake	brain benign neoplasm	0
candy	spinal cord disorder	0
bilberry	galactose 1 phosphate uridyl transferase deficiency disease	0
cocoa plants	bacterial vaginitides	0
density foods	bowel disease	0
illicium anisatums	familial creutzfeldt jakob disease	0
ultra-processed foods	crohnâ€™s disease	0
pureed apples	sore throat	0
lens plants	human t-cell lymphotropic virus type iii	0
food supplement	pill rolling tremors	0
pithecolobium	neuralgic migraine	0
solanum melongenas	head traumas	0
individual candy	stomatognathic diseases	0
texturized vegetable protein	primary malignant brain tumors	0
green teas	crushing skull injury	1
anise	colorectal neoplasms	0
citrus paradisi	environmental cancer	0
flaxseed	lymphosarcoma	0
artificial sweeteners	wound botulisms	0
caramel	gastro oesophageal reflux	0
low-salt diet	congenital abnormalities	0
chilli peppers	rest tremor	0
cured meat	disorders of initiating and maintaining sleep	0
cilantro	benign brain neoplasms	0
hydroponic basil	vulva cancers	0
musa	endotoxemia	0
no coffee	uveitide	0
beet greens	steatosis of liver	0
flesh foods	arrhythmia	0
oolong	uterine fibroma	0
ready soybeans	hypoesthesia	0
food colors	breast tumor	0
cantaloupe	craniocerebral injuries	0
wild celery	alcoholism	0
colophospermum	disseminated sclerosis	0
chewing gums	malignant melanomas	0
junk food	manic-depressive psychosis	0
coriandrum sativums	atherosclerotic plaque	0
malus domestica	colon disease	0
glucose fructose syrup	growth hormone receptor deficiency	0
beta vulgari	thyroid diseases	0
baby spinach	psychotic disorders	0
foeniculum vulgare	torsion fracture	0
handling meat	ms (multiple sclerosis)	0
indian gooseberries	cervical neoplasm	0
mango	zoonosis	0
sea bilberry	varice	0
sweet basils	congenital hypothyroidism	0
glucose-fructose syrup	human papillomavirus virus	0
sugar-sweetened beverages	forehead traumas	0
poultry meat	preinvasive carcinoma	0
squashe	udp-galactose-4-epimerase deficiency disease	0
euterpe edulis	cancer of the bladder	0
fermented foods	sleep wake disorders	0
wild radish	drug use disorders	0
chinese food	uterine cancer	0
soy cheeses	liver dysfunction	0
green tea	colonic inertia	0
fatty meal	ph1 negative myeloid leukemia	0
soy bean proteins	autistic disorders	0
amla	kanners syndrome	0
ribes nigrum	sunburn	0
indian laburnums	tongue cancer	0
artichoke	endometrioma	0
citrus medica	male breast tumors	0
drinking tea	porcine endogenous retroviruses	0
organic meat	angioblastic meningiomas	0
peach	auricular fibrillation	0
cassia fistulas	parkinson disease 2	0
black sapotes	unhealthy conditions	0
mushroom	ileocolitis	0
chickpea	anosmia	0
garlic	diffuse mixed-cell lymphomas	0
chamomile oils	creutzfeldt jakob disease	0
gluten-free diet	non hodgkins lymphoma	0
cocos nucifera	preterm birth	0
whole grain cereals	tonic seizure	0
alcoholic beverages	high blood pressures	1
delonix	coronary diseases	0
mandarin orange tree	premature aging	0
almond butter	small cleaved-cell lymphoma	0
blueberry plants	coronary disease	0
veal	manic states	0
alcoholic beverage	sclerosis	0
apple tree	hemangiopericytic meningioma	0
bread mold	mucous colitides	0
prunus amygdalus	meningioma	0
plaice	amyotrophic lateral sclerosis-parkinsonism-dementia complex 1	0
solanum	creutzfeldt jakob syndrome	0
sunflower seeds	cancer of prostate	0
oregano plant	chronic cluster headaches	0
reason food	lower back pains	0
apricot tree	oral cancer	0
soybean	spindle-cell carcinoma	0
grapefruit	proteinuria	0
vicia faba	non epileptic convulsion	0
theobroma cacao	felv	0
olea europaea	mucous colitis	0
psidium guajavas	sphenoid wing meningioma	0
soda water	neurocysticercose	0
isoglucose	pyrexia	0
durum wheat	cancer of thyroid	0
turnip	asymmetric diabetic proximal motor neuropathy	0
plum trees	burning pains	0
secale cereale	hiatus hernias	0
illicium verum	transmissible spongiform encephalopathy	0
chamomile tea	deep-venous thromboses	0
punicaceae	neonatal tremor	0
secale	metabolic acidoses	0
organ	human herpesvirus 4 (gamma)	0
eugenia malaccensis	contusion	0
hypericum perforatums	open head injuries	0
black coffee	severe mental disorder	0
plant embryo	cluster headache syndrome	0
black walnuts	hepatic neoplasms	0
energy drink	penis neoplasm	0
walnut	acute autoimmune neuropathies	0
jelly beans	blood cancers	0
soy foods	tonsil cancer	0
chipotle	gastroenteritide	0
poultry	herpesvirus	0
broad beans	retained surgical sponge	0
multivitamin	temporary amnesia	0
dietary sucrose	syncopal episode	0
tea plant	salmonella infections	0
healthy food	neurologic degenerative disease	0
raw meat	rachitis	0
low vitamin	iron deficiency	0
carya	infant obesity	0
dietary fiber	orf	0
spicy food	diabetic mononeuropathy simplex	0
ice creams	johnes disease	0
canned fruit	carcinoma of endometrium	0
red cabbage	right-sided heart failure	0
maple syrup	disc degradations	0
crabapple	small non cleaved cell lymphoma	0
nutrient-dense foods	malignant epithelial tumors	0
saint johnswort	dehydration	0
marshmallow	rodent ulcers	0
pecan	sudden cardiac arrest	0
red meats	vulva cancer	0
erythroxylon	prostate disease	0
cassia trees	sciatica	0
daily fruit	mental disorder	0
thymus	plasma cell myeloma	0
english plantains	torsion fractures	0
woodland strawberry	penis cancer	0
foie gras	ekbom delusional parasitoses	0
coca cola	fibromyositis-fibromyalgia syndrome	0
cooked tomatoes	spinal cord disorder	0
common foxglove	scurvy	0
prettiest fruit	a-v dissociations	0
solanum dulcamara	hypermelanosis	0
ilex paraguarienses	myocardial infarctions	0
pretzel	congenital hypothyroidism	0
regular carrots	acquired deafness	0
oregano plants	effort syncopes	0
white wine	basal cell carcinomas	0
cocoanut	muscular cramp	0
japanese plums	growth hormone insensitivity syndrome	0
antioxidant fruits	short sleep phenotypes	0
melissa officinalis	acute confusional migraine	0
hickory nut	hirsutism	0
diospyros digynas	dwarfism	0
grecian foxgloves	wheat hypersensitivities	0
ale	diabetic retinopathies	0
brussel sprout	mptp induced experimental parkinsonism	0
purslane	tonic-clonic seizure	0
soy milk	bone neoplasms	0
dioscorea polystachya	myalgia	0
brew	severe mental disorders	0
currant	death	0
cupcake	adolescent obesity	0
flavoring	dysfunction	0
eugenia caryophyllata	spiral fracture	0
crab apples	inflammatory polyneuropathy acute	0
humulus	mptp induced experimental parkinsonism	0
steak	chronic headache	0
wild yams	gossypiboma	0
star anises	kill cancer	0
refined olive	crohn's enteritis	0
ficus	cluster headaches	0
common plant	low-grade b-cell malignancy	0
myristica fragran	fatigue	0
mangosteen	cervix neoplasms	0
health food	plegia	0
lamb chops	hypercholesteremia	0
soy beans	megacolon	0
espresso	artery disease	0
pistacia	prostatic intraepithelial neoplasias	0
laudable legume	nonhodgkin's lymphoma	0
euchresta	renal failures	0
incorporates cloves	kidney failure	0
cymbopogon	aphthae	0
beta vulgaris	multiple myeloma	0
rosehip	campylobacter infection	0
plant embryos	hereditary essential tremor	0
mustard	pulmonary embolisms	0
frequent meals	chronic b-lymphocytic leukemias	0
bean	cancer of the vagina	0
popcorn	male pattern baldness	0
thymus plants	galactosemia	0
calendula	common bile duct calculi	0
crataegus monogyna	vulvar neoplasms	0
cymbopogon nardus	inflammatory bowel disease 1	0
horsebean	age related maculopathies	0
kidney bean	male pattern alopecia	0
foeniculum	carotid sinus syncope	0
french bean plants	soft tissue sarcoma	0
almond tree	muscle pain	0
cola nitida	insomnia	0
aspalathus linearis	variant creutzfeldt jakob disease	0
shorten	avitaminosis	0
msg	hemangioblastic meningioma	0
trigonella foenum graecum	hemicrania	0
corn oils	phage	0
neutraceutical	severe gh insensitivity	0
ultra-processed food	overeat	0
origanum	intraorbital meningiomas	0
seville orange trees	gastroenteritis	0
actual licorice	chronic obstructive airway disease	0
cereal grains	social anhedonias	0
tangerine tree	epithelioid sarcomas	0
agaricaceae	prostate cancers	0
chile peppers	burn	0
replenish nutrients	wheat allergy	0
eden foods	male sub-fertility	0
raisin	canker sores	0
morel	high blood pressure	0
blackberry	uterine fibroid	0
greenery	cva (cerebrovascular accident)	0
nutmeg	autosomal dominant juvenile parkinson disease	0
conventional food	atopic diseases	0
garlic sauce	constrictive bronchiolitis	0
olive trees	esophagus neoplasm	0
hop	colon disease	0
anise seed	lumbago	0
marihuana	mastodynia	0
jelly	intraepithelial neoplasm	0
ready-to-eat meals	inner ear cancer	0
brewing tea	action tremor	0
carica papayas	muscular spasms	0
gravy	bone cancer	0
cultivated oats	minor head injury	0
lemon balm tea	degenerative intervertebral disks	0
myristica fragrans	viral infections	0
sell meat	barrett esophagus	0
leafy vegetables	texidor twinge	0
sweet peppers	rebound insomnia	0
eupatorium rebaudianum	retained surgical item	0
acer negundo	carotid sinus syncope	0
split pea	migraine disorder	0
pomegranate	cancer of brain	0
english walnut	barrett esophagus	0
seville orange tree	avian leukosis/sarcoma virus	0
nicotiana	pulmonary embolism	0
guacamole	cancer of skin	0
health nuts	toxico infectious botulism	0
oreo	brain benign neoplasm	0
fennel	canker sores	0
alcohol	ovary cancers	0
prunus domestica	thyroid diseases	0
box elders	esophageal hernias	0
capsicum annuum	brain benign neoplasms	0
acer saccharums	coarse tremors	0
pork	stomach neoplasms	0
antioxidant vitamin	retained surgical sponges	0
romaine	campylobacter infection	0
retail poultry	oral neoplasm	0
pyrus	uterine cervical neoplasms	0
dark meat	periorbital headaches	0
narrow leaved plantain	galactose-1-phosphate uridyltransferase deficiencies	0
betel nut	parkinsonism-dementia complex of guam amyotrophic lateral sclerosis	0
sour orange tree	apnea	0
coconut milk	endothelial dysfunction	0
cuminum	diffuse mixed-cell lymphomas	0
daily nut	blood clot	0
baking chocolate	tongue cancer	0
low-fat diet	diabetic amyotrophies	0
white tea	intracranial cns disorder	0
citrus sinenses	diffuse lymphoma	0
apium graveolens var. dulce	sick headache	0
andropogon nardus	fibromyalgia-fibromyositis syndrome	0
pinto beans	zoonotic infectious diseases	0
drinking coffee	udp-galactose-4-epimerase deficiency diseases	0
cuminum cyminum	migraine variants	0
faba beans	tumor virus	0
mayo	insomnia	0
black sapote	udp-galactose-4-epimerase deficiency	0
longevity legumes	retained surgical instruments	0
celery root	psychophysiological insomnia	0
brussels sprouts	spinal cord disease	0
persea americana	premenstrual syndromes	0
tuna fish	mixed-cell lymphoma	0
malabar nut	gossypiboma	0
milk proteins	barrett syndrome	0
pomegranate seeds	lyme arthritis	0
camomile	e-b viruses	0
fresh fruits	intermediate-grade lymphomas	0
philadelphia cream cheese	skin disease	0
plantain	brains cancer	0
chinese cinnamons	resting tremor	0
apium graveolens	rectal tumor	0
high-fructose maize syrup	gluten enteropathies	0
triticum vulgare	prostate cancers	1
crunch berries	multiple head injuries	0
stem vegetables	brain tumor	0
chlorella	migraine variants	0
bt corn	jakob creutzfeldt syndrome	0
stevia rebaudiana	gallstone	0
squid	salmonella infection	0
soup	spasm	0
butter	kahler disease	0
wild celeries	short sleeper syndromes	0
citrus aurantiifolia	cardiac sudden death	0
salsa	diabetic amyotrophy	0
ground flax	posterior fossa meningioma	0
fabaceae	artery disease	0
lycium barbarum	cervical neoplasm	0
morning meals	foodborne botulism	0
phaseolus vulgaris	intracranial meningioma	0
salt-free diet	kanner syndrome	0
piper methysticum	creutzfeldt jacob disease	0
organic food	medical conditions	0
zucchini	liver neoplasms	0
sesame seeds	paraesophageal hiatal hernia	0
dog rose	ulcerative colitis	0
dried fruits	abdominal aortic aneurysms	0
animal food	dripped virus	0
bagel	mucous colitides	0
edible grain	ciliary body spasm	0
berberi	impaired sensation	0
saint john wort	stomatognathic diseases	0
triticum durum	acute confusional migraine	0
sugar maple	viral hepatitis	0
curcuma zedoaria	painful diabetic neuropathies	0
clathrotropis	craniocerebral traumas	0
allium sativum	malignant meningioma	0
suggesting apple	epithelioid sarcoma	0
bamboo shoots	reticulolymphosarcoma	0
laciniate nightshades	brain vascular accidents	0
flounder	pyrosis	0
red peppers	cardiac diseases	0
olive oils	influenza in humans	0
petroselinum crispums	vertiginous seizure	0
taraxacum officinale	nafld	0
pomelo trees	early detection of cancer	0
drink	age-related osteoporoses	0
elettaria cardamomum	insulin sensitivity	0
brassica nigra	nephrolith	0
portulaca oleracae	feline leukemia virus	0
norus	bruise	0
mashed potatoes	disseminated sclerosis	0
reindeer meat	radiating pains	0
citrus	zoonotic infectious disease	0
alfalfa sprouts	nanism	0
eating nuts	tumor	1
fast food	hemicrania migraine	0
neu5gc-rich food	bses (bovine spongiform encephalopathy)	0
potato	idiopathic parkinson's disease	1
poenumgraecum	anxiety disorder	0
poppy	polymyositide	0
pistachio	vitamin deficiency	0
eragrostis	minor head injuries	0
arachis	recrudescence	0
common bean plants	meningiomatose	0
dried pomegranate	kidney insufficiencies	0
mint tea	anhedonia	0
lard	cancer of the lung	0
noncaloric sweetener	juvenile onset diabetes	0
sardine	cerebrovascular apoplexy	0
sesamum	pustulosis of palms and soles	0
cocoa powder	infant botulism	0
aspalathus	familial tremors	0
rose	breast tumor	0
vitis vinifera	salami brusher's disease	0
bellis	rectum cancers	0
fagopyrum esculentum	colitis gravis	0
cassia fistula	viral diseases	0
pimenta	convulsive seizure	0
frozen fruit	atherosclerotic plaque	0
navy beans	congenital myxedema	0
fagopyrum sagittatum	transmissible dementia	0
ranking foods	ekbom delusional parasitoses	0
different fruits	obesity	0
bolete	manic state	0
morinda	testicular neoplasm	0
barley	recurrent brain tumor	0
include apples	sunburn	0
lunchtime	breast cystic disease	0
high fructose corn syrup	guam disease	0
snack	schizoaffective disorders	0
kiwi fruit	bone fractures	0
olive oil	dysmenorrhea	0
so-called vegetable	congenital myxedema	0
fava beans	torsion fractures	0
pickled foods	pediatric obesity	0
tree nuts	social anhedonias	0
dried apricots	malignancy	0
carica	acidosis	0
paella	ulcerative colitis type inflammatory bowel disease	0
wheat bran	gastro-esophageal reflux	0
cod	megacolon	0
kavas	premenstrual syndrome	0
sunfish	determination of death	0
leaf lettuce	cancer of the endometrium	0
regular olive	post ictal confusion	0
fuji apples	insulin-dependent diabetes mellitus	0
tuna	toxico-infectious botulism	0
citrus grandi	rachitis	0
rutabaga	mastodynia	0
dietary fats	deep-venous thromboses	0
texturized soy proteins	hansen disease	0
dietary plant proteins	degenerative disease	0
brewed coffee	broken bones	0
juglans nigra	cattle leukemia virus	0
candy bars	chronic lymphoblastic leukemia	0
chewed coca	galactokinase deficiency disease	0
spice saffron	neonatal tremor	0
rooibo	halitosis	0
eat flax	landry guillain barre syndrome	0
plantago ovata	saturnine tremors	0
french fries	cretinism	0
pomelo tree	diffuse lymphocytic lymphoma	0
golden delicious apples	vulva cancers	0
poroporo	fusiform aneurysm	0
eugenia sandwicensis	ciguatera poisonings	0
colorful foods	chronic lymphatic leukemia	0
pimiento	aphthous ulcer	0
thousand foods	fibroadenoma	0
persimmon	tonsil cancers	0
include fennel	plasmodium infection	0
belladonna	thyroid diseases	0
nut bars	water-borne hepatitides	0
milkshake	cjd (creutzfeldt jakob disease)	0
exotic fruit	secretory meningiomas	0
proteus mirabilis	occipital region traumas	0
eggnog	lung cancers	0
dietary sugars	age-related memory disorders	0
potable water	benign prostatic hypertrophy	0
plant capsules	gasser syndrome	0
chamomile oil	pharyngitis	0
hummus	mouth and tooth diseases	0
nut bar	paraesophageal hiatal hernia	0
cannabis sativa	rachitide	0
so-called meat	atherosclerotic plaques	0
gmo soybeans	overeat	0
kaffir lime	manic-depressive psychoses	0
anise tea	retained surgical item	0
da huang	weight reduction	0
monitoring food	convulsion	0
preserved foods	xanthomatous meningioma	0
psidium	kidney neoplasms	0
lemongrass	senile osteoporoses	0
marjoram plant	ulcer	0
goji berry	gall bladder disease	0
ginger	olfactory groove meningioma	0
cucumis melos	tactile hypesthesias	0
individual food	leukemogenic viruses	0
rose hips	mild neurocognitive disorders	0
cookie	limb tremor	0
shan yao	stomach neoplasm	0
jalapeno pepper	orthostasis	0
lettuce	neurotic anxiety states	0
sun-dried raisin	hernia	0
solanum laciniatum	nasal cavity cancer	0
petroselinum crispum	lou gehrig's disease	0
fried foods	fibromyositis fibromyalgia syndrome	0
punica granatums	insulin resistance	0
empty calorie foods	germinoblastoma	0
pistacia lentiscus	htlv-iii	0
sugar maples	enzootic bovine leukosis	0
grecian foxglove	hemolytic-uremic syndrome	0
serve	sleep wake disorder	0
rice	vertex headache	0
sugar	central obesities	0
guava	malignant melanomas	0
nori	mottled enamel	0
bertholletia excelsas	oncovirus	0
treat	colon disease	0
black walnut	fine tremors	0
red pepper	hiatus hernias	0
cuminum cyminums	tor-driven diseases	0
adhatoda	galactose 1 phosphate uridylyltransferase deficiency	0
plant zygote	foodborne illnesses	0
canned food	nutritional disease	0
drink milk	pulmonary neoplasm	0
soy sauce	gastric acid reflux disease	0
monosodium glutamate	hiv	0
syzygium jambolanum	bladder tumors	0
vegetable protein	anoxia	0
hazelnut	study cancer	0
processed foods	basal cell nevus syndrome	0
hemlock	peanut allergy	0
rheum officinale	degenerative intervertebral disc	0
acai berry	gingivitis	0
consumed chocolate	avitaminose	0
sandwich	pancreatic cancer	0
banana	bilateral headaches	0
low-calorie diet	disk degradations	0
study lavender	symptom cluster	0
new vitamin	passive tremor	0
carbonated drinks	tactile hypesthesias	0
soy proteins	oncovirus	0
black tea	voice box cancer	0
french bean plant	somatosensory seizure	0
berry	goiter	0
toxic plant	food-borne disease	0
jambolan plum trees	non-hodgkin's lymphoma	0
triticum spelta	chronic cluster headaches	0
oregano	bovine lymphosarcomas	0
cucurbita	neoplasm metastasis	0
peppermint oil	disc degenerations	0
elettaria cardamomums	thyroid neoplasm	0
fagopyrum tataricum	verruca	0
domestic fowl	fibromyalgia-fibromyositis syndromes	0
clove	global amnesias	0
dairy products	retained surgical needles	0
potassium-rich foods	carotid sinus syncope	0
miso	delusional parasitosis	0
lens culinaris	focal seizures	0
chewing fruit	prostate cancer	0
fenugreek seed	primary gh resistance	0
plant zygotes	prostatic neoplasm	1
amaranth	pyrexia	0
crocus	myocardial infarctions	0
vegetable juices	autistic disorder	0
recommend tea	renal neoplasm	0
soy food	ovarian cancer	1
sea food	venous thrombosis	0
cayenne peppers	perioral tremor	0
grape seeds	broken bone	0
big food	tonic seizures	0
experience food	premature aging	0
horsenettle	juvenile onset diabetes mellitus	0
mangifera indicas	allergic diseases	0
soda waters	chronic daily headaches	0
anchovy	circulatory collapse	0
lavender	rabies viruses	0
soda pops	prostatic intraepithelial neoplasm	0
salad	jakob-creutzfeldt syndrome	0
malabar-nut	degenerative neurologic diseases	0
carya illinoensis	galactose-1-phosphate uridylyltransferase deficiencies	0
acaÃ­ berries	sarcopenia	0
cinnamomum trees	brain cysticercosis	0
butternut squash	cancer of pancreas	0
raisin bran	insulin resistance	0
papaver	foodborne botulism	0
mastic trees	parkinsonism-dementia complex of guam amyotrophic lateral sclerosis	0
tomato sauce	lou gehrig disease	0
eating eggs	diabetic neuropathies	0
soy bean curds	reticulosarcoma	0
watercress	renal calculus	0
sweetening agent	newborn gynecomastia	0
corn sugar	heart attack	0
cardamom	ekbom delusional parasitosis	0
foxglove	cerebral strokes	0
avena	inappropriate growth hormone secretion syndrome (acromegaly)	0
cycad trees	brain vascular accidents	0
official vitamin	neoplasm	0
organic plants	multiple myositis	0
dietary proteins	disk degenerations	0
daucus carota	vestibular seizures	0
common bean plant	rabies viruses	0
hypericum perforatum	gorlin-goltz syndrome	0
banana plants	plasma-cell myeloma	0
dried fruit	sphenoid wing meningioma	0
shellfish	atopic diseases	0
aloe	galactose-1-phosphate uridylyltransferase deficiencies	0
trace elements	dna injury	0
squash plants	brain malignant neoplasm	0
carbonated beverages	continuous tremor	0
zingiber officinale	paralysis	0
citrus limon	crohn's disease	0
plant kingdom	atopic disease	0
national pork	todd's paralysis	0
fiddlehead ferns	degenerative diseases	0
maize oils	varice	0
suggesting fruit	high cholesterol levels	0
sprout	sterility	0
weekly meat	toxico infectious botulism	0
narrow-leaved plantains	sclerosis	0
cicer arietinum	gastroenteritide	0
crowberry	osteoarthrosis deformans	0
coca	colon disease	0
no noni	iodine deficiency	0
pizza	neurotic anxiety states	0
kidney beans	galactosemia 2s	0
spearmint	ulcerative colitis	0
cooked carrots	lyme arthritis	0
mangifera	ovarian neoplasm	0
vaccinium ashei	vulvar neoplasms	0
carthamus tinctorius	cerebral convexity meningiomas	0
target vitamin	prostatic intraepithelial neoplasia	0
vaccinium corymbosum	prostate neoplasms	0
citronella	androgenic alopecia	0
dragon fruit	breast neoplasm	0
confection	primary parkinsonism	0
boiled eggs	sciatic neuralgias	0
guibourtia	benign brain neoplasm	0
taro	osteoporose	0
restructured meat	epithelial cancer	0
pistachio nut tree	social phobia	0
feather meal	penile neoplasms	0
molasses	endothelial dysfunction	0
prunus persica	atrioventricular dissociations	0
soy	fibroid tumor	0
specific foods	prion protein diseases	0
soybean proteins	pancreatic cancer	0
lemon grasses	amyotrophic lateral sclerosis-parkinsonism-dementia complex 1	0
snack foods	atypical cluster headaches	0
golden glow	barretts syndrome	0
kenaf	hemangioblastic meningioma	0
eating broccoli	central obesities	0
pecan tree	mad cow diseases	0
vaccinium virgatum	bladder disease	0
fungus	autoimmune disease	0
flavourer	wound botulism	0
lentinus edodes	ovary cancer	0
osmanthus	nonalcoholic fatty liver disease	0
pepsi	sleep disorders	0
triticum	female pattern baldness	0
dandelion	sclerosis	0
indian gooseberry	ovary neoplasms	0
diabetic diets	non hodgkins lymphoma	0
poultry product	brain disorder	0
boiled broccoli	penile cancers	0
emblica officinalis	galactose-1-phosphate uridylyltransferase deficiencies	0
japanese plum	diarrhea	0
justicia adhatoda	common bile duct gall stones	0
ovary	non-hodgkin lymphoma	1
cicer arietinums	penis cancer	0
coriandrum sativum	sexual dysfunction	0
big meals	intervertebral disk degenerations	0
poppy seeds	germinoblastic sarcomas	0
food supplements	pyrose	0
rosemary	gastric neoplasm	0
ribe	cognitive retention disorders	0
sesame oil	sciatica	0
syzygium aromaticum	substance dependence	0
norovirus food	autosomal recessive parkinsonism	0
vaccinium macrocarpons	cancer of thyroid	0
linum usitatissimum	virus infections	0
breakfast times	hortons syndrome	0
citrus aurantiums	androgenic alopecias	0
cauliflower	lou-gehrigs disease	0
high-fiber food	suppuration	0
green peas	phage	0
cortland	bacterial vaginitides	0
poisonous plant	cot deaths	0
dried apples	rectum neoplasm	0
lens plant	prostatic cancers	0
dinnertime	asymmetric diabetic proximal motor neuropathy	0
artificially-flavored corn	brain conditions	0
andean blackberry	coronary heart disease	0
food manufacturers	pulmonary inflammation	0
honey	primary brain tumors	0
vaccinium macrocarpon	hair losses	0
flax seeds	auto-immune diseases	0
bertholletia excelsa	parkinsonian diseases	0
seltzer water	reduced sensation	0
collard green	tussive syncope	0
healthy fruit	secretory meningioma	0
rye	foodborne botulism	0
plant capsule	recurrence	1
faba bean	cancer of the colon	0
cappari	insulin resistance	0
raw alfalfa	heart disease	0
cicer	intermediate-grade lymphoma	0
common olive tree	aphthous stomatitis	0
veggie	autosomal recessive juvenile parkinsonism	0
carduus marianus	peanut allergies	0
molasse	vitamin deficiencies	0
dioscorea batatas	terminal ileitis	0
zedoary zedoaria	ileocolitis	0
cumin	inflammatory disease	0
soy bean	diffuse well-differentiated lymphocytic lymphoma	0
grape juice	b cell leukemia	0
holy basil tea	frontal region trauma	0
garbanzo	intracranial cns disorder	0
cocktail	tongue cancer	0
ready prepared foods	acute monocytic leukemias	0
lycopersicon esculentum	diabetes-related complication	0
contaminated foods	skin neoplasms	0
texturized soy protein	iron deficiency	0
color	hernia	0
yerba mates	wheat allergies	0
alfalfa	cervical cancer	0
peach tree	inflammatory bowel disease	0
lemon trees	continuous tremors	0
cooked broccoli	kidney disease	0
citron tree	autistic disorder	0
betel	chronic lymphatic leukemia	0
fennel seeds	chicken virus	0
ready-to-eat meal	lyssa	0
infant formula	hortons syndrome	0
chinese cassia	dysmenorrhea	0
whole grain cereal	cancer of the prostate	1
pasta	philadelphia-negative myeloid leukemias	0
punica granatum	marie struempell disease	0
yam	schizophreniform disorders	0
diabetic diet	atherosclerotic plaque	0
spore	male pattern alopecia	0
squash	cancer of the testes	0
silken tofu	endometrium cancer	0
safflower oils	cancer of the esophagus	0
dried food	cat leukemia viruses	0
iv vitamin	transmissible dementia	0
kola nut	muscle tenderness	0
apple	neurodegenerative disorders	0
black currant	pernicious vomiting of pregnancy	0
arginine-rich foods	stokes adams syncope	0
melissa	anemia	0
hibiscus sabdariffa	brain vascular accident	0
ephedras	benign essential tremors	0
lunch time	human immunodeficiency viruses	0
portulaca oleraceas	fibroadenoma	0
oryza sativa	nonhodgkin's lymphoma	0
ananas	prostate cancers	0
allium cepa	gastric acid reflux	0
last meal	stomach cancers	0
snack food	somatotropin hypersecretion (acromegaly) syndromes	0
vaccinium angustifolium	inhibit cancer	0
flower	cva (cerebrovascular accident)	0
fragaria vesca	auriculo-ventricular dissociation	0
citrus medicas	cat leukemia viruses	0
pineapple	high blood pressures	0
citrus bergamias	physical sufferings	0
cruciferous vegetable	memory disorder	0
own vitamin	diabetic mononeuropathy	0
hemp plant	coronary heart diseases	0
machaerium	diverticulosis	0
citrus hystrix	prostatic neoplasm	0
black pepper	premature births	0
frying foods	light-headedness	0
butter milk	primary gh resistance	0
decaffeinated tea	histamine cephalgia	0
banana plant	chronic b lymphocytic leukemia	0
stuff	ileocolitis	0
syzygium sandwicense	cancer of lung	0
little meat	endometriosis	0
silybum marianum	deep vein thrombosis	0
illicium	precordial catch	0
vinegar	hyperpigmentation	0
hamburger	oncogenesis	0
ceylon cinnamon	memory deficits	0
rowanberry	rectal neoplasms	0
four nuts	malignant lymphoma	0
herbal tea	marie-struempell disease	0
chinese yam	prostate cancers	0
asparagus	somatotropin (acromegaly) hypersecretion syndrome	0
aÃ§aÃ­ berries	acquired immunologic deficiency syndrome	0
pomegranate fruit	blood clot	0
brazil nuts	renal calculi	0
ganja	periorbital headache	0
betel nuts	cerebrovascular apoplexy	0
cheese	convulsive seizures	0
fagopyrum	gnathostoma infection	0
bhang	tonic-clonic seizure	0
apple juice	bovine spongiform encephalitis	0
overpriced vitamin	autoimmune disease	0
lavandula	behavior disorders	0
eat chocolate	acute monoblastic leukemia	0
antioxidant-rich food	galactose epimerase deficiencies	0
syzygium malaccense	carotid sinus syncopes	0
sweet foods	parkinson disease	0
rooibos tea	hip fractures	0
lipomul	lens opacities	0
curry powder	tactile hypesthesias	0
pummelo trees	light-headedness	0
carbonated water	tactile hypesthesias	0
worldwide fruit	vertiginous seizures	0
pineapple juice	vertiginous seizure	0
candy bar	intervertebral disc degenerations	0
tea	salami brusher's disease	0
foenumgraecum	dental fluoroses	0
horse nettles	testicular cancer	0
whale meat	sleep wake disorder	0
phaseolus acutifolius	semirhythmic tremor	0
billion eggs	ovary neoplasms	0
turkey meat	vulvar cancers	0
vodka	foodborne disease	0
dressing	lead poisoning	0
rooibos	hair losses	0
healthier foods	cot deaths	0
chocolate	persistent tremor	0
osmanthus tea	fatty liver	0
mock meats	parkinsonism	0
inadequate fruit	udpglucose 4 epimerase deficiency disease	0
actual fruit	substance induced organic mental disorders	0
no meat	intraorbital meningiomas	0
kava	passive tremors	0
preserved food	upper respiratory tract infections	0
cannabis indica	bone cancer	0
prosopis	non-hodgkins lymphoma	0
meal	human papillomavirus virus	0
milk protein	spinal cord diseases	0
pease	rete testis tumors	0
papaver somniferum	congenital abnormality	0
common olive trees	intraepithelial prostatic neoplasias	0
bread	food-borne diseases	0
fragaria	diabetic mononeuropathy simplex	0
ready-prepared foods	non alcoholic fatty liver disease	0
saint john's wort	gastric ulcers	0
fryer	deficiency disease	0
eating meat	acidose	0
bitter orange tree	fibrous meningioma	0
beer	single seizures	0
olive family	galactosemia iiis	0
euterpe oleracea	parasagittal meningiomas	0
hawthorn	microcystic meningiomas	0
macadamia nut	iritide	0
oats	jakob-creutzfeldt syndrome	0
breakfast cereal	lead poisonings	0
mentha spicata	cancer of vulva	0
high-fructose corn	cholera	0
white pepper	pregnancy induced diabetes	0
kawa kawas	menstrual pain	0
coconut water	halitose	0
table salt	horton's syndrome	0
euterpe	liver steatosis	0
thyme	vulvar cancer	0
taraxacum	igf-1 deficiency	0
chai tea	inflammatory bowel disease	0
anti-inflammatory foods	psoriase	0
scrambled eggs	communicable diseases	0
cannabis sativas	breast malignant tumors	0
healthiest apple	thinness	0
chile pepper	autosomal recessive familial parkinson disease	0
phyllanthus emblica	bladder neoplasm	0
real chocolate	intervertebral disc degenerations	0
jalapeno peppers	retro-ocular headaches	0
cinnamon	avian leukosis/sarcoma virus	0
emphasizes vegetables	hepatic cancers	0
calling eggs	mental disorders	0
legume pods	cot death	0
porgy	pulmonary thromboembolisms	0
avena sativa	utp hexose 1 phosphate uridylyltransferase deficiency	0
dairy product	common bile duct gallstones	0
halibut	sick headache	0
fava bean	excess cancer	0
persea americanas	colorectal tumors	0
taking vitamin	zoonotic infectious diseases	0
chili pepper	back pain with radiation	0
acer saccharum	recrudescence	0
celery	cancer of the liver	0
cardamon	abdominal aortic aneurysms	0
salami	acute autoimmune neuropathies	0
purple grape	micturition syncope	0
sesame oils	benign intracranial hypertension	0
healthiest fruits	microlissencephaly	0
sweet basil	small non-cleaved-cell lymphoma	0
ceratonia	small-cell lymphoma	0
breast milk	pulmonary diseases	0
prunus dulcis	dental disease	0
sour fruit	cacosmia	0
prunus salicina	bone fractures	0
buckwheat	hepatitide	0
oat	diverticula	0
garcinia mangostanas	unilateral headaches	0
origanum onites	inhibit cancer	0
flax seed	hiatal hernia	0
sweet pepper	mammary dysplasia	0
golden delicious	acquired immuno-deficiency syndrome	0
lunch times	prostate neoplasms	0
popular fruits	kanner's syndrome	0
pea family	sleep related neurogenic tachypnea	0
black raspberries	stomach cancers	0
crataegus	ulcer	0
maize	foodborne illnesses	0
ketchup	head pains	0
cashew	tumor of rete testis	0
wine	acute inflammatory polyneuropathies	0
octopus	prostatic intraepithelial neoplasia	0
jell-o	tonsil cancers	0
dried apple	joint disease	0
added nuts	high blood pressure	0
horse beans	undifferentiated carcinoma	0
bean sprout	chicken virus	0
pithecellobium	tongue cancer	0
areca catechus	familial creutzfeldt jakob disease	0
meal time	carcinomatosis	0
areca	acute autoimmune neuropathy	0
hemp	virus infections	0
pumpkin seeds	lobar pneumonia	0
linseed	chronic lymphocytic leukemia	0
cereal grain	recurrent low back pain	0
yellow vegetables	disc degeneration	0
common fruits	brain vascular accident	0
white meat	chronic illnesses	1
maize syrup	periodontal diseases	0
green beans	lymphadenopathy-associated viruses	0
lens culinari	high-grade lymphomas	0
edible grains	carcinogenesis	0
curcuma	leukemia	0
arugula	animal virus	0
chard	idiopathic intracranial hypertension	0
low fruit	nontropical sprue	0
intoxicant	colonic inertia	0
added sweeteners	olfactory seizures	0
human milk	fibroatheromatous plaques	0
woodland strawberries	mottled enamels	0
century plants	colorectal tumor	0
saccharomyces cerevisiae	parasagittal meningiomas	0
lycium chinense	orthostatic headaches	0
chanterelle	pulmonary inflammation	0
dried blueberries	urinary bladder disease	0
domestic fowls	anhedonia	0
including cloves	bladder tumors	0
grape	acute inflammatory demyelinating polyneuropathy	0
breakfast	juvenile-onset diabetes mellitus	0
broth	tonic-clonic seizure	0
high-phytate foods	chronic b lymphocytic leukemia	0
cranberry juice	thrombose	0
goiaba	rheumatoid spondylitis	0
yeast rice	chronic obstructive airway disease	0
kava kavas	perioral tremor	0
tobacco	ekbom psychogenic parasitosis	0
raspberry	precordial catch	0
cynara scolymus	schizophrenic disorder	0
pickled vegetables	acidose	0
fruit and vegetable juices	brain disorders	0
citrus hystrices	ciguatera	0
decaf	nonorganic insomnia	0
carbonated waters	acquired blindness	0
maize oil	soft tissue sarcoma	0
carya illinoenses	contusion	0
areca nuts	serious disease	0
table sugar	unilateral headache	0
cayenne pepper	barrett's esophagus	0
anacardium occidentales	testis neoplasm	0
turmeric root	oncovirinae	0
handling food	atherogenesis	0
mustard seeds	bovine lymphosarcoma	0
assai palm berry	amnesia memory loss	0
allspice	head traumas	0
cider	galt deficiency	0
amorpha	landry guillain barre syndrome	0
concord grapes	virus infection	0
kiwi	massive tremor	0
kola nuts	hereditary essential tremor	0
croaker	johne's disease	0
iceberg lettuce	utp hexose 1 phosphate uridylyltransferase deficiency disease	0
assai palms	retained surgical sponges	0
chestnut	human mammary neoplasm	0
rubus fruticosus	dysfunction	0
brassica napus	lou gehrig disease	0
durum wheats	unilateral headaches	0
hickory nuts	sudden cardiac death	0
lactuca sativa	intermediate grade lymphoma	0
mesquite	drug addiction	0
raw foods	action tremors	0
okra	polyarthritide	0
rise	heart attacks	0
chili peppers	bone neoplasms	0
eugenia jambos	gale deficiencies	0
pleurotus	macular degenerations	0
wheat	diverticulitis	0
nut butter	hypoascorbemia	0
hot pepper	rectal tumors	0
chocolate bars	congenital myxedema	0
buttermilk	hyperventilation syncope	0
white potatoes	avitaminosis	0
almond trees	oncogenese	0
offal	open head injury	0
citrus aurantium	atherosclerosis	0
petroselinum	thinness	0
oolong tea	hepatitide	0
nutritional yeast	grippe	0
glycine max	menstrual disorders	0
larder	painful diabetic neuropathy	0
sea-food	cva (cerebrovascular accident)	0
tempeh	cancer viruses	0
beverage	myeloma-multiple	0
carbonated beverage	substance use disorder	0
eating food	brain malignant neoplasm	0
whole grain	crohn disease	0
food additives	cat leukemia viruses	0
know nuts	superficial head injury	0
noni fruit	diffuse mixed-cell lymphomas	0
sweet almond	involutional osteoporosis	0
nuclear power plant	brittle diabetes mellitus	0
spinacia oleracea	laron dwarfism	0
majorana hortensis	emesis	0
filbert	drug abuse	0
healthiest foods	thyroid carcinomas	0
lavandula angustifolia	peripheral arterial diseases	0
barberry	cancer of the pancreas	0
jalapeno	dental plaque	0
curry	barrett esophagus	0
store licorice	contagious pustular dermatitides	0
wild bananas	androgenetic alopecia	0
crocus sativus	penile cancer	0
cruciferous foods	benign meningioma	0
cider vinegar	head pain	0
flax	mental deterioration	0
saffron	mixed lymphoma	0
orange juice	varicose vein	0
grilled meat	epstein-barr virus	0
peanut	chronic b-cell leukemia	0
citrus fruits	broken bones	0
bottled water	infantile obesity	0
earl grey tea	post traumatic osteoporosis	0
healthiest snack	hemicrania	0
bran flakes	creutzfeldt-jakob syndrome	0
food coloring	cva (cerebrovascular accident)	0
kale	smell disorder	0
plant-based nutrients	retained surgical item	0
green onions	gynecomastia	0
andira	guillain-barre syndrome	0
apricot	bovine lymphosarcoma	0
placenta	kidney disease	0
althaea officinalis	insomnia disorders	0
specific cheeses	chronic disease	0
white mallow	dysmenorrhea	0
topical ginger	diabetic retinopathy	0
kombucha tea	neoplasm metastases	0
green peppers	fibroid tumors	0
citrus aurantiifolias	breast fibrocystic disease	0
bitter nightshade	atrial fibrillations	0
vicia fabas	spongiform encephalopathies	0
convenience food	aortic aneurysms	0
energy drinks	male subfertility	0
kava kava	pyrexia	0
plantago indica	chronic b-lymphocytic leukemia	0
processed meats	ebv	0
toronja	deficiency disease	0
celebration meal	gall bladder disease	0
muffin	congenital myxedema	0
food allergies	acromegaly	0
cucumis sativus	brief reactive psychoses	0
cassia cinnamon	disorientation	0
seven nutrients	degenerative arthritides	0
gluten	acute inflammatory demyelinating polyneuropathy	0
digitalis lanata	als (amyotrophic lateral sclerosis)	0
international nut	small noncleaved-cell lymphomas	0
romaine lettuce	bowel diseases	0
amomum cardamomums	gastric acid reflux	0
milk thistles	bipolar disorder	0
dasheen	acute cerebrovascular accident	0
shan yaos	cough	0
deli meats	brain cysticercosis	0
cooking oil	myeloma-multiple	0
dripping	cancer of the bone	0
grouper	symptom cluster	0
cacao bean	vestibular seizures	0
carbonated drink	tumor viruses	0
morinda citrifolias	arterial dysfunction	0
thymus plant	low back pains	0
plantago arenaria	postoperative emesis	0
flavorer	cysticercose	0
cranberry	uterine cervical neoplasm	0
chilli pepper	hansens disease	0
eupatorium rebaudianums	myalgic encephalomyelitis	0
tea leaves	cirrhosis	0
soft drink	diabetic autonomic neuropathies	0
fermented cabbage	soft tissue sarcoma	0
whole foods	pancreas neoplasm	0
mangiferas	prostatic cancer	0
food allergy	colon disease	0
little saffron	autoimmune diabetes	0
mackerel	primary insomnia	0
acer negundos	pseudotumor cerebri	0
eating almonds	angiomatous meningiomas	0
processed food	esophageal reflux	0
raw garlic	prostate disease	0
curried tofu	block cancer	0
vegetable proteins	gnathostoma infection	0
dairy eggs	increased cancer	0
tarragon	nerve tremors	0
carob	aneurysm	0
ocimum sanctum	pulmonary cancer	0
beetroot	mad cow disease	0
pisum sativum	global amnesia	0
whole grains	fibrocystic breast disease	0
tulsi tea	premenstrual syndromes	0
cooking meat	fever	0
blueberry	intraepithelial neoplasm	0
pimpinella	vertebrogenic pain syndrome	0
chocolate pudding	prediabetic state	0
brewage	rhabdomyolysis	0
broccoli	allergy	0
raw broccoli	htlv-iii	0
zea mays	intraventricular meningioma	0
food supplementations	plegia	0
baker's yeast	cancer of the mouth	0
chinese cassias	aids viruses	0
melissa officinali	neonatal tremor	0
trace mineral	cancer of uterus	0
citrus maxima	parietal region trauma	0
sustenance	diabetes mellitus complication	0
dinner times	sprain	0
whipped cream	tick bite	0
frozen cranberries	causes cancers	0
anacardium occidentale	dizziness	0
honeybush tea	paraesophageal hiatal hernias	0
bell pepper	sprain	0
family vegetables	tumorigenese	0
sweet marjoram	small round structured viruses	0
emblica officinali	cephalalgia	0
tangerine trees	nonspecific vaginitis	0
usda poultry	age-related maculopathy	0
olive tree	cadaver	0
low meat	barrett metaplasia	0
stevia	tumor viruses	0
largest meal	sarcopenia	0
citrus sinensis	bacteria-eating virus	0
poppy seed	b cell chronic lymphocytic leukemia	0
soymilk	benign meningiomas	0
dangerous plants	a v dissociation	0
porphyra	mixed lymphocytic-histiocytic lymphoma	0
plant-based foods	atrioventricular dissociation	0
gui zhi	transient blindness	0
fruit-shaped marshmallows	felv	0
purple potatoes	diffuse mixed-cell lymphomas	0
plantago	acquired blindness	0
mustard greens	brain disorders	0
justicia	pattern baldness	0
drink tea	nonalcoholic steatohepatitides	0
trace element	lewy body parkinson's disease	0
lucerne	utp hexose 1 phosphate uridylyltransferase deficiency	0
black rice	schilling-type myeloid leukemia	0
vitamin	barrett's esophagus	0
cassia	pancreas cancer	0
pumpkin pie	pleomorphic lymphomas	0
healthy nuts	micturition syncopes	0
plant arils	atrial fibrillation	0
soy beverages	fibroadenoma	0
sweet potatoes	tactile amnesias	0
capsicum	degenerative arthritides	0
emphasize plant	deaf mutism	0
swiss chard	intervertebral disk degenerations	0
english walnuts	memory deficits	0
coconut	reducing cancer	0
pea families	galactose-1-phosphate uridylyltransferase deficiency	0
pleurotus ostreatus	ovarian cancer	0
nut butters	chronic lymphocytic leukemias	0
cream cheese	apnea	0
coconut oil	texidor's twinge	0
frosting	neuralgic migraine	0
citrus bergamia	acute monocytic leukemias	0
shoot	food-borne disease	0
plantago lanceolata	textiloma	0
grapefruit juice	crohn's enteritis	0
favorite meals	liver cancer	0
snacktime	cancer of the uterine cervix	0
whortleberry	jakob creutzfeldt syndrome	0
opium poppies	familial guillain-barre syndrome	0
chicken	deficiency diseases	0
glycyrrhiza glabra	mottled enamels	0
mint	respiratory tract infections	0
virgin olive	a-v dissociation	0
dried foods	bipolar disorder	0
acacia tree	mptp induced experimental parkinsonism	0
walnut oil	social phobias	0
marjoram	male sterility	0
vegetable juice	uveitis	0
solanum laciniatums	chest pains	0
leguminosae	infant obesity	0
silybum marianums	exanthem	0
sea vegetables	burkitt herpesvirus	0
warm milk	dehydration	0
almond	basal cell epitheliomas	0
sweetener	continuous tremors	0
uncooked foods	mental deteriorations	0
linum	infantile obesity	0
horsemeat	rectal neoplasms	0
parsley	bladder diseases	0
corylus	pulmonary disorder	0
sticker	pulmonary embolism	0
convenience foods	massive tremor	0
floret	intracranial meningiomas	0
cranberry sauce	saturnine tremors	0
aloe vera	sarcopenia	0
apple trees	manic disorders	0
hibiscus cannabinus	inflammatory bowel diseases	0
horse bean	kidney disease	0
dietary fibers	parietal region trauma	0
oyster mushrooms	spontaneous abortions	0
roasted almonds	motion sickness	0
red yeast rice	early onset parkinsonism	0
lemon balms	insulin dependent diabetes mellitus 1	0
lemon balm	vulva cancer	0
applesauce	plasma-cell myeloma	0
cold-steeping tea	cancer of the thyroid	0
yogurt	social anhedonia	0
tepary beans	basal cell nevus syndrome	0
exotic fruits	weight reductions	0
antioxidant-rich foods	convulsion	0
brinjal	common bile duct gall stones	0
aubergine	vulvar neoplasms	0
star anise	crushing skull injuries	0
seed	acne vulgaris	0
purine-rich plant	breast carcinomas	0
no-calorie sweeteners	fibrocystic changes of breast	0
wheatgrass	prostatic cancers	0
piper nigrum	obesity virus	0
lemon tree	joint pains	0
illicium anisatum	pseudoaphakia	0
rubberplant	chicken embryo lethal orphan virus	0
algarrobo	hiatal hernias	0
citrus reticulatas	chronic lymphocytic leukemia	0
lemon grass	preinvasive carcinoma	0
green pepper	intracranial cns disorders	0
kawa kawa	mechanical low back pain	0
higher vegetable	mental disorder	0
avoid peanuts	urinary bladder neoplasms	0
cucumis melo	wound botulism	0
yerba mate	acute inflammatory polyradiculoneuropathy	0
tofu	degenerative neurologic disorder	0
kangaroo meat	sclerosis	0
wheat brans	effort syncopes	0
bean sprouts	inflammatory bowel diseases	0
calendula officinali	rectal cancers	0
pistacia vera	breast pains	0
granny smith	cancer of lung	0
rubus idaeus	headache disorder	0
fresh ginger	autosomal recessive familial parkinson disease	0
artificial butter	cancer of stomach	0
solanum melongena	hypovolemic shock	0
animal-based foods	cancer viruses	0
prosopi	udpglucose 4 epimerase deficiency disease	0
coleslaw	lung disease	0
sour orange trees	iron overload	0
deli meat	fatigue	0
cherry	myalgic encephalomyelitis	0
hibiscus tea	chronic cluster headache	0
nettle	back aches	0
find pork	crib death	0
diospyros digyna	airsickness	0
hemp plants	headache syndrome	0
abelmoschus	avitaminosis	0
bitter orange trees	bronchiolitis obliterans	0
raw food	tubal abortion	0
strawberry	prostatic neoplasms	0
blossom	infectious mononucleosis viruses	0
cacao	olfactory groove meningiomas	0
animal-based vitamin	occipital trauma	0
piper methysticums	psoriasis	0
low-sodium diet	utp hexose 1 phosphate uridylyltransferase deficiency	0
adhatoda vasica	cancer of the stomach	0
prunus armeniaca	vagina cancer	0
moose meat	rectal neoplasms	0
fenugreek seeds	headache disorders	0
tumeric	mouth and tooth diseases	0
jerusalem artichokes	colorectal carcinomas	0
horse nettle	burning pain	0
squash plant	migratory pain	0
barley coffee	bovine leukemia	0
snail meat	chronic b-lymphocytic leukemia	0
rye bread	tonic clonic seizures	0
safflower oil	human t cell leukemia virus type iii	0
restrict food	ph1 negative myelogenous leukemia	0
catfish	fibroid uterus	0
oatmeal	drug hypersensitivities	0
wort	ciliary body spasm	0
hordeum	iritide	0
cinnamomum cassia	acquired immuno deficiency syndrome	0
dioscorea	substance induced organic mental disorders	0
avocado fruit	anaplastic carcinoma	0
macadamia	zoonotic infectious disease	0
lentil	drug dependence	0
digitalis	clear cell meningiomas	0
amygdalus communis	cognitive retention disorder	0
flammulina velutipes	primary brain tumors	0
poisonous plants	syncopal episode	0
crataegus monogynas	rete testis tumor	0
specific nuts	brain cancers	0
sockeye salmon	chronic lymphatic leukemia	0
digitalis purpurea	memory deficit	0
artificial sweetener	ekbom delusory parasitosis	0
unhealthy food	gale deficiencies	0
plum tree	sciatic neuralgias	0
dioscorea villosa	galactokinase deficiency	0
shiitake	hereditary galactokinase deficiency	0
chenopodium quinoas	spontaneous abortion	0
common foxgloves	chronic headaches	0
vital nutrients	sciatic neuralgias	0
plantago seed	hepatitis e	0
crave chocolate	infant obesity	0
kiwi fruits	brain vascular accidents	0
sauerkraut	acute confusional migraines	0
baby carrots	ciliary neuralgias	0
sweeten	adenovirus	0
food poisonings	malignant epithelial neoplasms	0
quinoa	marie struempell disease	0
aÃ§ai berries	male pattern baldness	0
brassica juncea	gall bladder disease	0
solanum dulcamaras	udp-galactose-4-epimerase deficiency disease	0
brown rice	galactosemia iii	0
fed beef	bses (bovine spongiform encephalopathy)	0
portulaca oleracea	chronic obstructive lung disease	0
phytonutrient-rich food	parkinsonian disorders	0
phaseolus	thyroid adenomas	0
mustard plants	gingivitide	0
trigonella foenum-graecums	non-epileptic convulsion	0
nitrate-rich vegetables	bladder cancer	0
english plantain	gastric acid reflux	0
cereal	recrudescence	0
chewing gum	amyloidosis	0
agent orange	obesity in adolescence	0
raphanus sativus	burkitts lymphoma virus	0
cocoa powders	cancer of brain	0
pine nuts	prostatic intraepithelial neoplasias	0
anana	insulin dependent diabetes mellitus 1	0
cabbage	endometriose	0
radish	testicular cancer	0
frozen spinach	diverticulum	0
morinda citrifolia	esophageal neoplasms	0
milk chocolate	hortons syndrome	0
flaked coconut	spindle-cell carcinomas	0
persea	ruptured appendicitis	0
atropa belladonnas	copd	0
powdered sugar	microcystic meningioma	0
zinger tea	social anxiety disorders	0
red meat	crushing skull injuries	0
tea hibiscus	neoplasia	0
agave	muscle spasm	0
toxic plants	episodic cluster headaches	0
kombucha teas	nonhodgkin's lymphoma	0
incorporate cloves	retro-ocular headaches	0
swordfish	dermatozoic delusions	0
kohlrabi	schizophrenia	0
abelmoschus esculentus	tussive syncope	0
citrus reticulata	infant botulisms	0
illicium verums	pneumonitis	0
soy beverage	small cleaved-cell lymphoma	0
anti-inflammatory plant	coma	0
cinnamomum verum	experimental lung inflammation	0
cocoa	leucocythaemia	0
psyllium	bovine lymphosarcomas	0
sugar substitutes	social anxiety disorder	0
healthier meat	starvation	0
berberis	obesity virus	0
cherry plum trees	malignant epithelial tumors	0
white bread	decreased cancer	0
pepper	infectious diseases	0
dried peas	lactose intolerance	0
crab apple	pseudotumor cerebri	0
vitamin pills	age-related maculopathy	0
fruit juice	burn	0
mother cells	brain disorder	0
althea officinalis	muscular spasm	0
shiitake mushrooms	congenital abnormalities	0
pea	ovarian neoplasm	0
consumer protection scientific committee on food	hemicrania migraine	0
caryophyllus	elevated cholesterols	0
healthy foods	pancreatitide	0
term vegetable	parkinson's disease	0
chinese cinnamon	chronic b-cell leukemias	0
dioscorea opposita	pulmonary thromboembolisms	0
deep-fried foods	convulsive seizures	0
peanut butter	brief reactive psychosis	0
willow tree	bovine spongiform encephalitis	0
rosa	barrett's esophagus	0
purple rice	parasagittal meningioma	0
aspartame	auricular fibrillation	0
mentha piperita	lyme arthritis	0
century plant	airsickness	0
decrease meat	tremor	0
food additive	jakob creutzfeldt syndrome	0
eragrostus	spatial memory disorder	0
unfiltered coffee	multiple sclerosis	0
healthy snacks	degenerative intervertebral disc	0
breakfast cereals	cancer of rectum	0
hot sauce	reticuloendotheliosis virus	0
dietary supplement	substance-induced organic mental disorders	0
curcuma longa	oxygen deficiency	0
fructose corn	idiopathic proctocolitis	0
smoked foods	food borne diseases	0
contamination meat	polyp	0
dietary protein	neurologic degenerative diseases	0
dairy yogurt	syncopal episodes	0
nightshade	juvenile-onset diabetes mellitus	0
chenopodium quinoa	water borne hepatitis	0
medicago sativa	myocardial infarctions	0
lemon	mottled enamel	0
dietary soybean proteins	diverticulum	0
pistil	painful diabetic neuropathies	0
linum usitatissimums	bone cancer	0
seafood	tonsil neoplasm	0
brazil nut tree	human t-cell leukemia virus type iii	0
rhubarb	barrett syndrome	0
tv dinners	headache syndrome	0
red delicious apples	cardiac disease	0
safflower	vulvar neoplasm	0
syrup	lymphoplasmacytoid lymphoma	0
texturized vegetable proteins	zoonotic infections	0
roselle	fibrosis	0
dress	occipital trauma	0
java plum trees	retained surgical item	0
nutraceutical	cancer of the vagina	0
narrow-leaved plantain	vertebrogenic pain syndromes	0
carrot	a v dissociation	0
sweetleaf	intracranial neoplasms	0
phaseolus vulgari	gastric cancers	0
soy yogurt	preterm births	0
euterpe oleracea mart.s	horton's syndrome	0
ocimum basilicum	drop attacks	0
chicken salad	dental disease	0
peach trees	hemolytic-uremic syndrome	0
oryza	postviral fatigue syndrome	0
baby formula	early detection of cancer	0
wolfberry	sexual dysfunction	0
pimpinella anisum	sleep wake disorder	0
dinner time	human t cell leukemia virus type iii	0
cycad	acute inflammatory polyradiculoneuropathies	0
eugenia cumini	brain diseases	0
zedoary zedoarias	insomnia disorders	0
ready-prepared food	craniocerebral trauma	0
sea vegetable	sleep initiation and maintenance disorders	0
rubus	darkness tremor	0
whiting	epileptic seizure	0
trigonella	esophageal cancers	0
stryphnodendron	reticulum cell sarcoma	0
acai berries	mottled enamel	0
potato chips	sensory seizure	0
maraschino cherry	tumor viruses	0
commercial milk	hhv-4	0
component spices	chronic fatigue-fibromyalgia syndromes	0
mentha x piperita	peripheral artery diseases	0
squash seeds	liver injury	0
hypericum	breast fibrocystic changes	0
national meat	upper respiratory tract infections	0
meal times	lung diseases	0
eggplant	benign meningiomas	0
canned foods	male sub fertility	0
callerya	intervertebral disk degeneration	0
blueberry plant	bone neoplasm	0
paprika	cluster headache	0
chinese yams	alopecia cicatrisata	0
cherry plum tree	fibroid uterus	0
lemon verbena	prostate cancers	0
solanum lycopersicum	skin cancers	0
acer	bowel disease	0
solanum tuberosum	tonsil neoplasms	0
fatty foods	benign neoplasms	1
carbonated mineral waters	fibromyositis-fibromyalgia syndrome	0
indian laburnum	transient insomnia	0
anticancer plant	brain benign neoplasm	0
wisconsin milk	meningiomatosis	0
tomato juice	multiple meningioma	0
nicotiana tabacum	necrotizing fascitides	0
measuring food	thyroid cancers	0
saffron crocus	avitaminose	0
corn	mental disorder	0
mangifera indica	somatotropin hypersecretion syndromes (acromegaly)	0
lima beans	central obesities	0
raw poultry	hepatitis	0
vaccinium bracteatums	disc degeneration	0
soy bean curd	uterine fibroid	0
dietary supplementations	influenza in humans	1
leek	cancer of the testes	0
fries	social anhedonia	0
green grapes	episodic cluster headache	0
tachigalia	rectum neoplasms	0
baptisia	endometrium cancers	0
nettle tea	sneeze	0
zea	renal calculus	0
nonus	idiopathic proctocolitis	0
beef	age related bone loss	0
pimpinella anisums	arthropathy	0
nuclear power plants	amnesia-memory loss	0
saint johns wort	diabetic mononeuropathy simplices	0
olive	landry-guillain-barre syndrome	0
skim milk	senile osteoporoses	0
plant aril	rectum neoplasm	1
legume family	atherosclerosis	0
prunis communis	retained surgical sponges	0
high-fat meal	muscle tenderness	0
entree	persistent tremor	0
different seed	congenital hypothyroidism	0
jambolan plum tree	pancreas cancers	0
baked potato	common cold	0
mirobalanus embilicas	intervertebral disc degenerations	0
aÃ§ai berry	atherosclerosis	0
cow's milk	inhibit cancer	0
prunus cerasifera	autosomal dominant parkinsonism	0
steamer	tumor	0
pudding	breast cystic diseases	0
gala apples	flatulence	0
deep-fry foods	colorectal neoplasms	0
club soda	brain benign neoplasm	0
pistachio nut trees	child obesity	0
fortify milk	granulomatous enteritis	0
sparkling water	classic galactosemias	0
spice turmeric	ph1 negative myelogenous leukemia	0
broccoli raab	neoplasm metastases	0
sorrel	esophagus neoplasms	0
mandarin orange trees	feminization	0
afzelia	human papillomavirus viruses	0
bergamot	cancer of the liver	0
organic foods	baldness	0
concord grape	pulmonary inflammation	0
mirobalanus embilica	aphthous ulcer	0
pimenta officinali	insulin dependent diabetes mellitus	0
white mallows	temporary amnesia	0
marijuana	non-hodgkin lymphoma	0
marjoram plants	urinary bladder cancer	0
weed	diabetic polyneuropathy	0
extracted fruit	foodborne botulisms	0
gooseberry	hemangiopericytic meningiomas	0
soda pop	severe gh insensitivity	0
supper	benign neoplasms	1
mustard plant	mammalgia	0
syzygium	myelomatosis	0
curcuma zedoarias	emphysema	0
dried yeast	pulmonary inflammation	0
fast foods	htlv-iii	0
cannabis indicas	focal seizure	0
brown sugar	human t-lymphotropic virus type iii	0
acid-binding vegetables	phage	0
tisane	mottled enamel	0
collard	neurotic anxiety states	0
elephant garlic	syncopal vertigo	0
trace minerals	carcinomatosis	0
maguey	temporal region traumas	0
baby formulas	sciatica	0
cayenne	kidney neoplasm	0
sunchoke	chronic infectious mononucleosis-like syndrome	0
ephedra	type 1 diabetes	0
cucumber	cancer of stomach	0
orange tree	retained surgical instrument	0
unfertilized eggs	acquired immune deficiency syndrome	0
rheum tanguticum	testicular cancers	0
thymus vulgaris	spinal cord disorder	0
pummelo tree	varicose veins	0
chamomile	study cancer	0
triticum turgidum subsp. durum	prediabetic state	0
filtered coffee	deafness	0
assai palm berries	cardiac failure	0
red tea	chronic headaches	0
bitter nightshades	phage	0
citron trees	carcinoma	1
pimenta diocia	gale deficiency	0
pimenta diocias	a-v dissociation	0
carbonated mineral water	guillaine barre syndrome	0
use sweeteners	trochanteric fractures	0
althaea	inflammatory bowel disease 1	0
herbal teas	cough	1
goji berry plants	kidney stone	0
trompillo	secondary insomnia	0
malus	tumorigenese	0
nicotiana tabacums	marsh fever	0
herr	senile paranoid dementia	0
happy meal	bovine leukemias	0
thymus vulgari	well differentiated lymphocytic lymphoma	0
origanum majorana	manic-depressive psychoses	0
marsh mallow	cll lymphoplasmacytoid lymphomas	0
yolk	food-borne diseases	0
red rice	back pain	0
dietary fat	dysfunction	1
sweet orange	thermal hypesthesias	0
bacon	todds paralysis	0
chia seeds	abdominal pains	0
california avocado	fibrous meningiomas	0
drinking water	olfactory groove meningioma	0
fat foods	fibrocystic changes of breast	0
corn oil	prediabetic state	0
green lentils	uterine cervical neoplasm	0
biometal	cancer of tongue	0
fake meat	brain conditions	0
good soybeans	utp hexose 1 phosphate uridylyltransferase deficiency	0
liquorice	non epileptic convulsion	0
olea	meningiomatose	0
chicken meat	parkinson's disease	0
antioxidant food	disc degenerations	0
roundup-ready soybeans	dementia	0
orange	kanner syndrome	0
red onions	galactosemia iii	0
teff	low-grade lymphoma	0
fresh meat	degenerative disease	0
poultry products	intraventricular meningioma	0
drug administration united states food	feminization	0
coco	childhood onset obesity	0
unrefined plant	penile neoplasm	0
mentha spicatas	steatosis of liver	0
goji berries	barretts esophagus	0
goji berry plant	reticulolymphosarcoma	0
cleistocalyx	uterine fibroids	0
holy basils	rna tumor viruses	0
root	pustular psoriasis of palms and soles	0
prebiotic	severe congenital microcephalies	0
frozen broccoli	nafld	0
ice cream	auriculo-ventricular dissociation	0
dessert	persistent tremor	0
garden radish	numbness	0
rubus glaucus	testicular neoplasm	0
smoked food	wound botulisms	0
hordeum vulgare	massive tremor	0
food pyramid	fusiform aneurysm	0
true nut	drop attacks	0
syzygium jambos	acne	0
calendula officinalis	muscle soreness	0
processed meat	hemorrhage	0
adding blueberries	premature aging	0
anacardium	creutzfeldt-jakob disease	0
jam	hypoxia	0
drinking milk	granulomatous enteritis	0
margarine	endocrine breast disease	0
areca catechu	darkness tremor	0
pumpkin	a v dissociation	0
orange trees	inappropriate growth hormone secretion syndrome (acromegaly)	0
black currants	dental fluoroses	0
junk foods	cva (cerebrovascular accident)	0
onion	degenerative intervertebral disks	0
food and drug administration	basal cell epitheliomas	0
cannabis	high-grade lymphomas	0
kawa	penile neoplasm	0
breast milks	insomnia	0
ocimum basilicums	intraepithelial prostatic neoplasia	0
diospyro	reticulum-cell sarcoma	0
ground beef	food-borne diseases	0
ground ginger	tumor virus	0
peppermint	prostatic cancer	0
irritable bowel kiwi fruit	gastric ulcer	0
food poisoning	muscle tenderness	0
uncooked food	tonsillar neoplasm	0
split peas	eye disease	0
portulaca	breast pain	0
organ meats	deaf mutism	0
foodstuff	spindle cell sarcoma	0
foeniculum vulgares	cancer of vulva	0
breakfast time	uveitide	0
juglans regia	prostate neoplasm	0
jasmine tea	hypermelanosis	0
mastictree	cancer of the skin	0
liquor	varice	0
antioxidant foods	parietal region trauma	0
golden raisins	galactose 1 phosphate uridyl transferase deficiency disease	0
dried cranberries	intracranial cns disorder	0
salmonella-infected eggs	bipolar depression	0
juglan	breast disease	0
legume pod	pulmonary thromboembolisms	0
aÃ§aÃ­ berry	myelogenous leukemia	0
nutriceutical	bovine leukoses	0
almond oil	influenza in humans	0
pecan trees	visceral obesity	0
plum	nephrolith	0
raw tomatoes	ankylosing spondyloarthritides	0
alpine strawberries	dermatozoic delusions	0
drinking orange	tick bite	0
organic milk	human t-cell leukemia virus type iii	0
food companies	cancer of the bladder	0
dog rose berries	hypercholesterolemia	0
amomum cardamomum	hysterical blindness	0
atropa belladonna	starvation	0
avocado	secondary insomnia	0
bibhitaki fruit	bronchiolitide	0
origanum vulgare	postoperative nausea and vomiting	0
andean blackberries	sinusitis	0
endive	heat stroke	0
vaccinium bracteatum	plasmodium infection	0
red delicious	cephalgia syndrome	0
fat milk	utp-hexose-1-phosphate uridylyltransferase deficiency disease	0
healthiest vegetable	cardiac sudden death	0
ground meat	male sub-fertility	0
watermelon	tumorigenese	0
cinnamomum zeylanicum	acute inflammatory demyelinating polyradiculoneuropathy	0
oxen meat	cancer of vagina	0
yoghurt	senile osteoporoses	0
sea bilberries	ciliary neuralgia	0
capparis	obesity virus	0
millet	pharyngitis	0
red wine	muscle cramp	0
apium graveolens var. rapaceum	paratuberculose	0
almond milk	hansen's disease	0
raphanus	lymphatic sarcomas	0
apricot trees	osteoarthrose	0
dietary supplements	bone fractures	0
chili	arthrose	0
laciniate nightshade	lyme arthritis	0
turmeric	gustatory seizure	0
pimenta officinalis	osteoporosis	0
licorice root	infantile obesity	0
mastic tree	non hodgkin lymphoma	0
club sodas	occipital region traumas	0
indian corn	celiac sprue	0
cola	lichen ruber planus	0
beet	rectal neoplasms	0
wild yam	deglutitional syncopes	0
basil	kill cancer	0
red lentils	uterine cancer	0
dinner	pulmonary disorder	0
bell peppers	multiple myeloma	0
natto	occipital trauma	0
vitis	type 1 diabetes	0
copaifera	bovine leukemia virus	0
new york coalition for healthy school food	prion-induced disorder	0
marsh mallows	bipolar disorders	0
cocoa butter	lou gehrig disease	0
ginger ale	liver dysfunction	0
citrus x paradisi	strains and sprains	0
processing meat	dizziness	0
euterpe precatoria	idiopathic intracranial hypertension	0
scallion	ache	0
aquatic food	experimental parkinson disease	0
humulus lupulus	emphysema	0
celeriac	dissociative amnesia	0
lycium	cervical migraine syndromes	0
pinto bean	high-grade lymphoma	0
pie	carsickness	0
powdered ginger	subacute spongiform encephalopathy	0
soy cheese	constrictive bronchiolitides	0
mealtime	celiac disease	0
food company	excess cancer	0
purple cabbage	bses (bovine spongiform encephalopathy)	0
dried plums	high-grade lymphoma	0
mussel	campylobacter infections	0
bertholletia	arterial dysfunction	0
burrito	childhood obesity	0
bok choy	fibroatheromatous plaques	0
ilex paraguariensis	intraepithelial prostatic neoplasias	0
mentha	carcinoma in situ	0
curcuma longas	intermittent tremors	0
brassica	mammalgia	0
tap water	lou-gehrigs disease	0
mother cell	cancer of thyroid	0
cured meats	encephalon disease	0
carica papaya	type i diabetes mellitus	0
rose berries	aortic aneurysm	0
alpine strawberry	cancer of the tongue	0
hot peppers	water stress	0
fresh basil	drug hypersensitivities	0
holy basil	lou-gehrigs disease	0
cooked meat	ankylosing spondyloarthritis	0
healthiest nuts	psychophysiological insomnia	0
caper	bacteria-eating virus	0
papaya	child obesity	0
gum acacia	thrombosis	0
citrullus	penis neoplasm	0
cocoa plant	hiccough	0
prenatal vitamins	aphthae	0
retail meat	low back ache	0
infant formulas	vulva cancer	0
black teas	hepatic neoplasm	1
vegetarianism	precordial catch	0
sugar substitute	poultry viruses	0
sugary foods	parkinsonism dementia complex of guam amyotrophic lateral sclerosis	0
undercooked meat	prostate neoplasms	0
ocimum tenuiflorum	cjd (creutzfeldt-jakob disease)	0
cultivated oat	generalized seizures	0
healthy snack	leukemogenic virus	0
healthiest beverage	pituitary dwarfism ii	0
sweetened cereal	horton's syndrome	0
sugar water	atrioventricular dissociations	0
maple	anal ulcers	0
fruit juices	horton syndrome	0
eating fruits	cephalgia syndrome	0
arecas	colorectal neoplasms	0
pear	transmissible dementia	0
probiotic	age-related maculopathies	0
salmonella food	osteoarthrosis deformans	0
sweetening agents	ph1-negative myelogenous leukemias	0
flowering shrub	chest pain	0
not-necessarily-so-healthy foods	neuritic plaque	0
raphanus raphanistrum	mild cognitive impairments	0
psidium guajava	infectious mononucleosis viruses	0
carrot juice	myocardial failure	0
soft drinks	disrupted in b-cell malignancy	0
corn syrup	microglandular adenoses	0
haritaki fruit	renal failure	0
teosinte	gale deficiency	0
rheum	seasickness	0
elettaria	rectum neoplasm	0
spaghetti	chicken viruses	0
zingiber officinales	endometrium carcinomas	0
dietary plant protein	reticuloendotheliosis viruses	0
colocasia	vulva neoplasms	0
frying meat	cerebral convexity meningiomas	0
white rice	brain tumors	0
cannabi	tonsillar neoplasm	0
granny smith apples	muscle pains	0
alfalfa sprout	acute inflammatory polyneuropathies	0
include flaxseed	philadelphia negative myeloid leukemia	0
eugenia aromatica	hypertension	0
american meat	splitting pain	0
brain-invasive pork	thyroid cancers	0
egg	carcinogenese	0
black beans	allergic reaction	0
oyster mushroom	hot flashes	0
morning meal	coad	0
big apples	chicken viruses	0
healthiest beverages	prostate disease	0
roughage	cardiogenic syncope	0
seltzer waters	fight cancer	0
rabbit meat	brain benign neoplasms	0
garcinia mangostana	human herpesvirus 4	0
arachis hypogaea	mild cognitive impairments	0
solanum tuberosums	human papillomavirus viruses	0
hibiscus	membranous cataract	0
syzygium cumini	arterial fatty streak	0
assai palm	foodborne illnesses	0
sushi	age related osteoporosis	0
avenas	bleed	0
radicchio	atrophy	0
hickory tree	episodic cluster headaches	0
glycyrrhiza	severe mental disorder	0
chinook salmon	chronic disease	0
allium porrum	dementia with amyotrophic lateral sclerosis	0
chervil	well-differentiated lymphocytic lymphoma	0
sour cream	vertiginous seizures	0
sweet almonds	pill rolling tremor	0
spinach	galactose 1 phosphate uridyltransferase deficiency	0
venison	deficiency disease	0
coffee	corpse	0
monkfish	chronic airflow obstruction	0
whole wheat	diabetic polyneuropathies	0
fig	bacteriophage	0
rheum rhaponticum	acne	0
infects apples	visceral obesities	0
triticum aestivum	uterine cancers	0
citrus fruit	bladder tumor	0
milk thistle	memory losses	0
citrus grandis	colorectal cancer	0
phyllanthus emblicas	gall bladder diseases	0
dark chocolate	breast malignant tumors	0
shiitake mushroom	atopic diseases	0
frier	infertility	0
sausage	acquired immunologic deficiency syndrome	0
caffeinated coffee	paroxysmal atrial fibrillations	0
cooked meats	todd's paralysis	0
stevia rebaudianas	cancer of rectum	0
processed apples	diverticulitide	0
new candy	human flu	0
prunus salicinas	mucous colitides	0
licorice	colitis	0
cultivated radish	brain cancer	0
java plum tree	kanners syndrome	0
vaccinium myrtillus	fatty liver	0
tepary bean	cancer of the lung	0
rice milk	tonic seizure	0
flammulina	bilateral headaches	0
eugenia jambolana	craniocerebral injuries	0
hickory trees	forehead traumas	0
sesame	b12 deficiency	0
mustard oil	penile cancers	0
opium poppy	upper respiratory infections	0
bad foods	diabetic mononeuropathy simplex	0
soy protein	multiple head injuries	0
raw cranberries	vitamin deficiencies	0
vegetable oil	bechterew's disease	0
chinese rhubarb	coad	0
hashish	steatohepatitis	0
sparkling waters	wound botulism	0
citrus-based fruits	substance dependence	0
plantago psyllium	artery disease	0
natural vitamin	iron overload	0
coriander	philadelphia-negative myeloid leukemia	0
trigonella foenum-graecum	back pain	0
soya milk	low back pain	0
coriandrum	cardiovascular strokes	0
herb	hydrophobia	0
caryophyllus aromaticus	chronic infectious mononucleosis-like syndrome	0
nonfat meal	ph1-negative myelogenous leukemia	0
sweet marjorams	protein deficiencies	0
amlas	secondary insomnia	0
milk	atrioventricular dissociation	0
high fructose maize syrup	atrophy	0