
black coffee	malignant brain neoplasms	0
dried yeast	barrett's syndrome	0
linum usitatissimums	diffuse undifferentiated lymphoma	0
term vegetable	esophageal cancer	0
lucerne	head trauma	0
contaminated foods	cancer of the testis	0
chinese rhubarb	pancreatitis	0
dried apples	coronary heart disease	0
ephedra	tick bites	0
ground beef	visceral steatoses	0
purple potatoes	udp galactose 4 epimerase deficiency	0
potato chips	porcine endogenous retroviruses	0
zea mays	diabetic asymmetric polyneuropathies	0
kola nuts	secondary insomnia	0
frier	toxico infectious botulism	0
chewing gum	diverticulitide	0
andropogon nardus	parasagittal meningiomas	0
nuclear power plants	basal cell epithelioma	0
diospyros digynas	somatotropin hypersecretion syndrome (acromegaly)	0
coconut oil	painful diabetic neuropathies	0
ginger ale	galt deficiencies	0
carica papaya	drug allergies	0
soy food	postoperative emesis	0
baby formulas	infantile obesity	1
pickled vegetables	muscle pain	0
white tea	hansen's disease	0
soy proteins	disorders of initiating and maintaining sleep	0
egg	atherosclerose	0
stevia rebaudianas	cot deaths	0
cooked broccoli	neurocysticercose	0
nightshade	sudden cardiac death	0
curcuma longa	respiratory tract cancer	0
not-necessarily-so-healthy foods	deep venous thromboses	0
soybean proteins	osteoarthritis	1
thousand foods	situational syncopes	0
include fennel	pancreas cancer	0
gum acacia	dripped virus	0
silybum marianums	malignant primary brain neoplasms	0
corn oil	neurologic degenerative diseases	0
decrease meat	airsickness	0
jell-o	upper respiratory tract infections	0
dioscorea batatas	premenstrual syndromes	0
crab apple	broken bone	0
overpriced vitamin	low back pains	0
zea	human papillomavirus virus	0
steamer	preterm births	0
triticum turgidum subsp. durum	gall stone	0
common bean plants	tonsillar neoplasms	0
amlas	hiatal hernias	0
eugenia jambolana	lou-gehrigs disease	0
boiled broccoli	craniocerebral trauma	0
haritaki fruit	chronic airflow obstructions	0
coffee	brain disorder	0
althaea	paraesophageal hernias	0
eating food	degenerative neurologic disorder	0
mangosteen	chromosome 6 linked autosomal recessive parkinsonism	0
trigonella	prostatic intraepithelial neoplasia	0
retail poultry	widespread chronic pains	0
foxglove	familial dementias	0
skim milk	low-grade b-cell malignancy	0
trace element	peanut hypersensitivity	0
processed food	bse (bovine spongiform encephalopathy)	0
trigonella foenum-graecum	bronchiolitide	0
healthiest fruits	endometrium cancers	0
mackerel	substance-related disorders	0
soy	disk degradation	0
brew	parkinson disease	0
brewed coffee	non b hepatitis enterically transmitted non a	0
food allergies	brain conditions	0
yam	angioblastic meningiomas	0
chenopodium quinoas	gastro oesophageal reflux	0
corn oils	cluster headache syndrome	0
fagopyrum esculentum	prostatic adenoma	0
plant kingdom	adolescent gynecomastia	0
chocolate pudding	sleep initiation and maintenance disorders	0
prunus amygdalus	common bile duct calculi	0
chinese cassia	deafness	0
food companies	alzheimer’s disease	0
bergamot	nonhodgkin lymphoma	0
healthiest beverage	lung cancers	0
safflower	psychogenic parasitosis	0
paella	shock	0
horse nettle	oncovirinae	0
nicotiana tabacums	halitosis	0
andean blackberries	ph1 negative myeloid leukemia	0
cooked carrots	brain disease	0
dietary sugars	small noncleaved-cell lymphomas	0
dried cranberries	heat strokes	0
tea leaves	sleep-related neurogenic tachypnea	0
curry powder	fatigue	0
abelmoschus esculentus	bacterial vaginoses	0
table salt	sciatica	0
avena sativa	subwakefullness syndromes	0
soup	joint pains	0
mangiferas	muscle pains	0
alcohol	uterine fibroids	0
solanum dulcamaras	auriculo-ventricular dissociation	0
noncaloric sweetener	hirsutism	0
cold-steeping tea	pustular psoriasis of palms and soles	0
mentha spicata	xanthomatous meningioma	0
saccharomyces cerevisiae	vertebrogenic pain syndrome	0
bran flakes	obesity in adolescence	0
blueberry plants	avian leukosis/sarcoma virus	0
glycyrrhiza glabra	leukemia virus	0
crave chocolate	cervix cancers	0
coca cola	bses (bovine spongiform encephalopathy)	0
bhang	intraventricular meningioma	0
mandarin orange tree	open head injuries	0
cultivated oat	stokes adams syncope	0
mastictree	fibromyositis-fibromyalgia syndrome	0
linseed	ph1-negative myelogenous leukemia	0
specific foods	gnathostomiasis	0
feather meal	acquired immuno-deficiency syndromes	0
fava beans	smell disorder	0
common foxglove	senile osteoporoses	0
fenugreek seed	psychosis	0
msg	sleep initiation dysfunction	0
cumin	drop attack	0
gmo soybeans	head injury	0
aubergine	intraepithelial prostatic neoplasias	0
dietary protein	rupture	0
chestnut	cancer of the colon	0
japanese plum	poultry viruses	0
sweeten	single seizure	0
healthiest apple	breast tumors	0
concord grapes	cretinism	0
aspalathus linearis	benign intracranial hypertension	0
pepper	migraine variant	0
cheese	sliding hiatal hernia	0
coriandrum sativum	infectious virus	0
grape seeds	johne's disease	0
oryza	benign essential tremor	0
common olive tree	viral infection	0
delonix	intermediate grade lymphoma	0
brain-invasive pork	inflammatory bowel disease 1	0
pummelo trees	bronchiolitis	0
solanum tuberosums	persistent tremor	0
scallion	congenital abnormality	0
arecas	senile tremor	0
toxic plant	johne's disease	0
coriander	gluten enteropathies	0
food supplements	parkinsonian diseases	0
barberry	gehrig disease	0
virgin olive	cattle leukemia virus	0
hamburger	lou gehrig's disease	0
organic milk	infertility	0
restructured meat	lyme borreliosis	0
eugenia malaccensis	diffuse well differentiated lymphocytic lymphoma	0
split peas	bladder neoplasms	0
preserved foods	chronic airflow obstruction	0
ceratonia	micturition syncope	0
pease	ciguatera poisonings	0
wild celeries	degenerative arthritides	0
maize oil	human papillomavirus viruses	0
contaminated meat	male infertility	0
triticum durum	contusion	0
cucumis melos	tubal abortions	0
sunfish	generalized seizures	0
licorice root	pancreatic cancer	0
hibiscus sabdariffa	basal cell carcinoma	0
dairy products	male breast tumors	0
dietary fibers	vertiginous seizures	0
erythroxylon	myeloma-multiple	0
liquorice	male breast neoplasms	0
turmeric root	complete hearing loss	0
olive family	esophagitide	0
so-called vegetable	preterm births	0
areca catechu	painful diabetic neuropathies	0
swiss chard	cerebrovascular apoplexy	0
collard greens	cancer of the vulva	0
plantago seed	respiratory infections	0
spinach	cancer of bladder	0
corn sugar	non-alcoholic fatty liver disease	0
restrict food	uterine neoplasm	0
sea bilberries	acute strokes	0
horsemeat	anthrax	0
eating eggs	juvenile parkinson disease	0
piper nigrum	chronic infectious mononucleosis-like syndrome	0
baked potato	darkness tremor	0
caramel	intervertebral disk degenerations	0
digitalis	tumor viruses	0
punicaceae	bilateral sciaticas	0
sweet orange	reproductive sterility	0
narrow leaved plantain	diverticulum	0
hummus	pneumonitide	0
jalapeno pepper	acromegaly	0
roundup-ready soybeans	marie-struempell disease	0
cultivated radish	cancer of vagina	0
pyrus	childhood onset obesity	0
alpine strawberries	als (amyotrophic lateral sclerosis)	0
natural vitamin	painful diabetic neuropathy	0
deep-fry foods	amaurose	0
brazil nut tree	iritide	0
amaranth	liver neoplasm	0
soy bean	severe mental disorders	0
gala apples	muscle sorenesses	0
low vitamin	ph1-negative myelogenous leukemia	0
curcuma longas	male sterility	0
barley coffee	tying disease	0
nicotiana	breast tumors	0
justicia adhatoda	amnesia-memory loss	0
lipomul	aphthous ulcer	0
oregano	anemia	0
soy beverage	udp-galactose-4-epimerase deficiency disease	0
lycium	rectal cancer	0
laudable legume	joint pains	0
applesauce	postoperative nausea	0
plant embryos	prostate neoplasms	1
poultry products	endocrine breast disease	0
powdered sugar	brain disorder	0
cymbopogon nardus	liver steatoses	0
black teas	soft tissue sarcomas	0
prosopis	intraorbital meningioma	0
seafood	mixed cell lymphoma	0
sweet basils	diabetes mellitus complications	0
narrow-leaved plantain	heartburn	0
kava	cardiac death	0
avoid peanuts	diffuse mixed-cell lymphomas	0
component spices	phlebothrombose	0
different seed	pregnancy-induced diabetes	0
bell pepper	develop cancer	0
bread mold	senile tremors	0
pithecolobium	diffuse undifferentiated lymphoma	0
horse nettles	common bile duct gallstones	0
chilli peppers	intermediate-grade lymphomas	0
pistachio nut trees	gastric neoplasms	0
sweetener	chronic cystic mastitis	0
plant-based foods	diabetic mononeuropathies	0
smoked food	fibroid	0
club sodas	vaginal cancer	0
coriandrum sativums	tonsil neoplasms	0
sea vegetables	eczema	0
lemon balms	diabetic autonomic neuropathy	0
octopus	syncopal episode	0
oolong tea	reducing cancer	0
banana	generalized spasm	0
garlic sauce	meningioma	0
black sapote	post traumatic osteoporosis	0
prunus salicinas	galactosemia 3s	0
diospyro	primary brain neoplasm	0
oreo	small cell lymphoma	0
mealtime	somatosensory seizure	0
solanum	cancer of the cervix	0
dioscorea	inflammatory disease	0
apple tree	pseudopelade	0
noni fruit	higher cancer	0
sugar	senile plaques	0
wheat brans	endometrioma	0
nonfat meal	drug addiction	0
areca catechus	non-hodgkin's lymphoma	0
whortleberry	lower back pains	0
snacktime	pregnancy-induced diabetes	0
purple cabbage	bewilderment	0
infects apples	ischemia	0
chlorella	massive tremor	0
rice milk	sleep related neurogenic tachypnea	0
tangerine tree	gall bladder disease	0
black sapotes	preinvasive carcinoma	0
marsh mallows	abdominal pain	0
official vitamin	todds paralysis	0
daucus carota	gluten enteropathy	0
food additive	low-grade lymphomas	0
whole wheat	arrhythmia	0
rye	sleep initiation and maintenance disorders	0
java plum tree	udpglucose 4-epimerase deficiency disease	0
no coffee	wheat allergies	0
euterpe precatoria	lobar pneumonias	0
cinnamomum cassia	gluten-sensitive enteropathy	0
cereal grains	thyroid neoplasm	0
syzygium	tactile amnesia	0
cappari	food-borne diseases	0
food company	neurological condition	0
spicy food	parkinsonism dementia complex of guam amyotrophic lateral sclerosis	0
ocimum tenuiflorum	burkitt herpesvirus	0
onion	kidney calculus	0
acer saccharums	substance-related disorders	0
food supplement	testicular neoplasm	0
eating broccoli	ovarian cancers	0
food coloring	vaginal neoplasm	0
treat	diabetic amyotrophies	0
yolk	insulin-dependent diabetes mellitus 1	0
triticum spelta	human papillomavirus viruses hpv	0
oryza sativa	growth hormone insensitivity syndrome	0
orange juice	coronary heart disease	0
hop	vaginal cancer	0
goji berry	myelogenous leukemia	0
taraxacum	thyroid adenomas	0
lactuca sativa	postoperative nausea and vomiting	0
filbert	bewilderment	0
red pepper	auricular fibrillations	0
carbonated water	minor head injury	0
confection	urticarias	0
orange	small cleaved-cell lymphoma	0
colorful foods	spinal meningioma	0
tisane	inflammatory polyneuropathy acute	0
elephant garlic	overeat	0
chinook salmon	nervous system degenerative diseases	0
tepary beans	utp hexose-1-phosphate uridylyltransferase deficiency	0
lycopersicon esculentum	atrial fibrillations	0
snack foods	craniocerebral injury	0
green beans	substance dependence	0
green grapes	cognitive impairments	0
hibiscus tea	inflammatory polyneuropathy acute	0
açaí berries	severe mental disorder	0
fryer	bruise	0
mangifera	macular degenerations	0
tomato juice	als (amyotrophic lateral sclerosis)	0
red rice	galactosemia iiis	0
barley	testis neoplasms	0
black walnuts	foodborne illnesses	0
tomato sauce	deep vein thrombosis	0
higher vegetable	diabetic complications	0
beef	cardiac arrhythmias	0
maize oils	new variant creutzfeldt-jakob disease	0
eugenia sandwicensis	dermatozoic delusions	0
nutritional yeast	liver steatoses	0
rose berries	unhealthy conditions	0
alcoholic beverage	endocrine breast diseases	0
dioscorea opposita	adenosis of breast	0
big meals	insulin deficiency	0
aquatic food	infectious disease	0
nut bars	diabetic autonomic neuropathy	0
frosting	pulmonary neoplasm	0
citrullus	intention tremor	0
zucchini	sub-fertility	0
uncooked foods	esophageal cancers	0
actual licorice	oncogenesis	0
new candy	acute inflammatory polyradiculoneuropathies	0
opium poppy	cognitive impairment	0
golden delicious apples	infectious mononucleosis viruses	0
olive	parkinsonism dementia complex of guam amyotrophic lateral sclerosis	0
turnip	mental deterioration	0
apium graveolens var. rapaceum	cirrhosis	0
stem vegetables	ductal carcinomas	0
true nut	myelomatose	0
solanum dulcamara	pneumonitide	0
almond trees	penile neoplasms	0
herb	tonsillar cancers	0
shoot	neuritic plaque	0
oregano plants	colonic neoplasms	0
carya	muscular cramps	0
sea-food	painful menstruations	0
triticum turgidum	drop attacks	0
pinto bean	varix	0
silken tofu	auditory seizures	0
different fruits	migraine variant	0
lemon trees	cancer of vagina	0
psidium guajavas	microcystic meningioma	0
macadamia nuts	airsickness	0
dried blueberries	migraine variant	0
healthiest snack	vaginal discharge	0
eating nuts	anosmia	0
humulus	virus infection	0
jalapeno	diabetes complications	0
apium graveolens var. dulce	membranous cataracts	0
apple juice	superficial head injuries	0
lens culinari	felv	0
anti-inflammatory plant	iritis	0
new york coalition for healthy school food	cognitive decline	0
goji berries	human papilloma viruses	0
green peas	diabetic polyneuropathies	0
prunus salicina	chronic airflow obstruction	0
human milk	epstein-barr virus	0
origanum vulgare	post-traumatic osteoporosis	0
norovirus food	chronic illness	0
juglans regia	cysticercose	0
wheatgrass	paralysis agitans	0
lens plant	skin disease	0
amygdalus communis	primary brain neoplasms	0
uncooked food	uterus neoplasm	0
food additives	saccular aneurysm	0
food supplementations	phlebothrombosis	0
cooked meat	t virus	0
convenience foods	skin neoplasm	0
own vitamin	prostate cancers	0
fennel	pulmonary thromboembolisms	0
maple syrup	malignant tumor of urinary bladder	0
lunch times	male impotence	0
maple	back pain	0
animal-based foods	hormonal dysfunction	0
real chocolate	convulsive seizures	0
fermented foods	delusional parasitosis	0
white potatoes	age related bone loss	0
star anises	stroke	0
chamomile tea	fibrosis	0
crab apples	basal cell nevus syndrome	0
vitis	microcephaly	0
purslane	galt deficiency	0
chinese cinnamon	kidney insufficiencies	0
tepary bean	brain vascular accident	0
oatmeal	ache	0
punica granatums	huntingtons disease	0
illicium verum	meningiomatosis	0
cilantro	food borne illnesses	0
pimenta diocia	colicky pains	0
halibut	migraine disorder	0
caffeinated coffee	scorbutus	0
shan yao	cancer of brain	0
pistacia	ciliary neuralgias	0
healthy foods	starvation	1
kombucha tea	cancer of the tonsil	0
vaccinium angustifolium	hirsutism	0
saint johnswort	mouth cancers	0
indian laburnum	spongiform encephalopathies	0
mustard plants	endometrial neoplasms	0
fermented cabbage	bacteria-eating viruses	0
whipped cream	communicable disease	0
coco	chronic b cell leukemia	0
plum tree	convulsive seizure	0
common bean plant	acquired immunodeficiency syndromes	0
food and drug administration	polymyositis	0
soda waters	sclerosis	0
eating fruits	breast disease	0
pithecellobium	lymphoplasmacytoid lymphoma	0
colophospermum	retro-ocular headache	0
maraschino cherry	ketosis-prone diabetes mellitus	0
herr	lower back pains	0
sweetleaf	penile cancer	0
frying meat	cerebrovascular apoplexy	0
jerusalem artichokes	sleep related neurogenic tachypnea	0
organic food	galactosemia 2	0
american meat	hepatic failure	0
longevity legumes	itch	0
hemlock	asthma	0
burrito	bacteria-eating viruses	0
monitoring food	breast malignant neoplasm	0
arachis	rectal neoplasm	0
spaghetti	disseminated sclerosis	0
star anise	avian leukosis/sarcoma virus	0
low-sodium diet	somatotropin (acromegaly) hypersecretion syndromes	0
atropa belladonna	artery disease	0
edible grain	lower back pains	0
healthy nuts	ph1-negative myelogenous leukemia	0
shiitake	auriculo-ventricular dissociations	0
black rice	drop attack	0
flammulina velutipes	chronic airflow obstruction	0
solanum melongena	degenerative arthritides	0
dog rose berries	age-related memory disorders	0
domestic fowls	deafness	0
fenugreek seeds	endometrium cancer	0
ice cream	brain cancer	0
sweet pepper	hypertension	0
healthiest foods	airsickness	0
diospyros digyna	small lymphocytic lymphoma	0
shiitake mushrooms	gastric acid reflux disease	0
solanum laciniatum	inhibit cancer	0
soy protein	gestational diabetes mellitus	0
chili peppers	uterus neoplasm	0
almond	creutzfeldt jacob disease	0
cucumis melo	painful diabetic neuropathy	0
broccoli	reticuloendotheliosis viruses	0
yoghurt	pseudopelade	0
porphyra	familial dementias	0
fresh meat	chronic b-lymphocytic leukemias	0
berberi	perioral tremors	0
individual food	uterine cervical cancers	0
leek	disseminated sclerosis	0
digitalis lanata	stomach cancers	0
salmonella-infected eggs	confusional states	0
iv vitamin	rna tumor viruses	0
sweet almond	barrett's esophagus	0
organ meats	androgenic alopecias	0
peppermint oil	sore throat	0
pomegranate	sudden cardiac arrest	0
worldwide fruit	chronic fatigue syndrome	0
biometal	visceral steatosis	0
cooked tomatoes	common cancer	0
herbal teas	ph1-negative myelogenous leukemias	0
billion eggs	parkinsonism dementia complex of guam amyotrophic lateral sclerosis	0
persimmon	prostatic intraepithelial neoplasias	0
red onions	hereditary essential tremor	0
specific nuts	prion induced disorder	0
citrus medica	fibrocystic mastopathy	0
rooibo	rectal cancer	0
acer negundos	small noncleaved-cell lymphoma	0
phaseolus acutifolius	cancer of vulva	0
multivitamin	prediabete	0
fast foods	anaplastic carcinoma	0
humulus lupulus	vagina neoplasms	0
eat chocolate	infantile autism	0
eggplant	feline leukemia viruses	0
horsebean	diabetic mononeuropathy simplex	0
vaccinium bracteatums	post-traumatic osteoporoses	0
persea americana	senile plaque	0
horse bean	cystic disease of breast	0
marsh mallow	fibroatheromatous plaques	0
pimenta officinalis	malignant meningioma	0
cycad	inflammatory bowel disease 1	0
sparkling water	rectal cancers	0
jambolan plum trees	ekbom delusional parasitosis	0
dietary soybean proteins	starvation	0
peach tree	schilling type myeloid leukemia	0
anise seed	hemorrhoid	0
wild celery	ovary neoplasm	0
kidney beans	palmoplantaris pustulosis	0
potassium-rich foods	lactose intolerance	0
adhatoda vasica	massive tremor	0
cocoa plants	long sleeper syndromes	0
afzelia	mink encephalopathy virus	0
betel	acquired deafness	0
milk protein	primary insomnia	0
grape juice	pruritis	0
cocktail	nafld	0
plant zygote	angioblastic meningioma	0
rabbit meat	diabetic asymmetric polyneuropathies	0
cannabis	epithelioid sarcoma	0
citrus aurantiifolias	congenital myxedema	0
soy yogurt	newborn gynecomastia	0
whale meat	familial guillain-barre syndrome	0
cinnamomum verum	small lymphocytic lymphomas	0
allspice	acute strokes	0
piper methysticums	udp-galactose-4-epimerase deficiency	0
rheum tanguticum	breast malignant neoplasm	0
mirobalanus embilica	cancer-causing viruses	0
probiotic	sneezing	0
foeniculum	low back pains	0
lavender	cough	0
blueberry plant	water stress	0
narrow-leaved plantains	johne's disease	0
elettaria cardamomums	social anhedonias	0
pimpinella anisum	microcystic meningioma	0
justicia	posterior fossa meningioma	0
low meat	malignant epithelial tumors	0
chervil	philadelphia-negative myeloid leukemia	0
allium cepa	physical sufferings	0
teff	diverticulitis	0
plant zygotes	prostatic neoplasm	1
nut butters	gastroenteritide	0
pimenta officinali	cardiovascular disease	0
brown rice	rash	0
citrus limon	elevated cholesterols	0
include apples	bipolar affective psychoses	0
psyllium	childhood obesity	0
garcinia mangostana	crohn disease	0
orange tree	lactose intolerance	0
anana	mixed lymphoma	0
laciniate nightshade	sleep wake disorders	0
ginger	foodborne diseases	0
coconut	premature birth	0
nonus	osteoporose	0
poultry meat	chronic pains	0
red lentils	impaired sensation	0
brinjal	substance induced organic mental disorders	0
french bean plant	primary brain tumor	0
artificial sweetener	colon neoplasm	0
chard	uterine cervical neoplasm	0
mustard seeds	long sleeper syndrome	0
rooibos tea	lung neoplasm	0
celebration meal	disorder	0
drink	nonalcoholic steatohepatitides	1
whole grain	uterine fibroids	0
miso	peanut allergy	0
baker's yeast	kill cancer	0
plant arils	brain benign neoplasm	0
lemongrass	transmissible dementia	0
dress	small and large cleaved-cell lymphoma	0
agent orange	lung neoplasm	0
ananas	crohn disease	0
pistachio	hemicrania migraines	0
eggnog	juvenile parkinson disease	0
milk proteins	leprosy	0
taking vitamin	subfertility	0
tea plant	amnestic state	0
currant	sterility	0
animal-based vitamin	confusional states	0
white bread	dwarfism	0
peach trees	sudden cardiac arrests	0
cynara scolymus	foodborne botulism	0
faba beans	body weight	0
emphasize plant	galactosemia iii	0
mock meats	mechanical low back pain	0
rose hips	early infantile autism	0
apple	leukemogenic virus	0
tap water	acquired immuno-deficiency syndrome	0
vaccinium macrocarpons	benign neoplasm	1
pomelo trees	postoperative nausea and vomiting	0
oat	testicular cancers	0
fagopyrum	vertex headaches	0
sorrel	fighting cancer	0
citrus grandis	goiter	0
collard	endometrium cancer	0
lime	mixed lymphocytic histiocytic lymphoma	0
caper	primary brain neoplasm	0
melissa	extreme hearing loss	0
dark meat	pancreatic neoplasms	0
decaf	tonic-clonic seizures	0
syrup	human t-cell lymphotropic virus type iii	0
turkey meat	bronchiolitis	0
recommend tea	cancer of the liver	0
anticancer plant	anxiety disorders	0
camomile	osteoporosis	0
preserved food	malignant tumor of urinary bladder	0
whole grains	huntingtons disease	0
fruit and vegetable juices	gluten-sensitive enteropathy	0
green teas	chronic gum disease	0
placenta	lymphoma	0
red yeast rice	pulmonary neoplasms	0
frozen cranberries	muscle tremor	0
bean sprouts	rectal cancer	0
beet greens	dermatosis	0
foodstuff	norovirus	0
nutrient-dense foods	allergic reaction	0
vaccinium uliginosum	spindle cell sarcoma	0
legume pods	renal cancers	0
chinese yams	fibrocystic mastopathy	0
soft drinks	impotence	0
rye bread	arterial fatty streak	0
poppy seeds	periorbital headaches	0
international nut	hair losses	0
poppy	thinness	0
energy drink	hyperventilation syncope	0
pork	degenerative diseases	0
guava	limb cramp	0
illicium anisatums	food borne illnesses	0
fatty meal	thrombus	0
mashed potatoes	e-b viruses	0
raw poultry	oral cancers	0
kava kava	contusion	0
alfalfa sprouts	chronic diseases	0
triticum	ms (multiple sclerosis)	0
holy basils	age-related macular degeneration	0
cinnamon	cerebrovascular accident	0
regular carrots	herpesvirus	0
cayenne peppers	testicular neoplasms	0
mango	intervertebral disk degenerations	0
frozen fruit	multiple myelomas	0
lens culinaris	guam form of amyotrophic lateral sclerosis	0
herbal tea	hepatic failure	0
diabetic diet	crushing pain	0
capparis	artery disease	0
acai berry	endometriose	0
açai berries	feline lymphoma virus	0
cherry plum tree	nonalcoholic fatty livers	0
soy foods	stokes adams syncope	0
plant embryo	parietal region traumas	0
fresh fruits	olfactory seizures	0
avena	congenital myxedema	0
vaccinium corymbosum	creutzfeldt jacob disease	0
warm milk	skin neoplasms	0
veggie	generalized spasm	0
trompillo	postpartum sterility	0
no-calorie sweeteners	pulmonary disease	0
emblica officinalis	leucocythemia	0
dressing	confusion	0
pimenta diocias	bacteria-eating viruses	0
low-fat diet	bilateral sciatica	0
philadelphia cream cheese	mammary cancer	0
sugar maples	neuritic plaque	0
granny smith apples	spinal cord diseases	0
bitter orange tree	senile osteoporoses	0
ribes nigrum	t viruses	0
olive trees	premenstrual syndromes	0
chilli pepper	intermittent tremors	0
breakfast	penile neoplasms	0
agaricaceae	carcinomatose	0
black raspberries	hydrophobia	0
gluten-free diet	vagina neoplasm	0
lemon	infection	0
stevia	mild neurocognitive disorder	0
oolong	drug dependence	0
carbonated beverage	foodborne diseases	0
baking chocolate	nutritional disease	0
calendula officinali	congenital defect	0
sweet potatoes	aids viruses	0
suggesting apple	somatotropin hypersecretion (acromegaly) syndrome	0
ovary	disc degradation	0
pecan	pseudotumor cerebri	0
euterpe edulis	periorbital headaches	0
ketchup	cancer of prostate	0
malabar nut	intertrochanteric fractures	0
pomegranate fruit	anal ulcers	0
tea hibiscus	horton syndrome	0
cucumber	tonsil neoplasms	0
juiced broccoli	lung disease	0
wild radish	myelogenous leukemia	0
psidium	minor head injury	0
filtered coffee	bone fractures	0
cayenne pepper	kanner syndrome	0
coleslaw	arthralgia	0
spinacia oleracea	vaginal discharge	0
chinese food	nonhodgkin lymphoma	0
table sugar	a v dissociation	0
proteus mirabilis	somatosensory seizures	0
isoglucose	tying disease	0
curcuma zedoarias	hepatitis e	0
sugar water	tonsil neoplasms	0
crabapple	small noncleaved-cell lymphoma	0
ceylon cinnamon	chromosome 6-linked autosomal recessive parkinsonism	0
empty calorie foods	generalized headaches	0
citrus bergamias	pneumonitis	0
beetroot	bipolar disorders	0
entree	gasser syndrome	0
vinegar	ph1-negative myelogenous leukemia	0
pineapple	dermatozoic delusion	0
dietary plant protein	hepatocellular cancers	0
processed apples	type i diabetes mellitus	0
paprika	leanness	0
fuji apples	neoplasia	0
assai palms	substance-induced organic mental disorders	0
neutraceutical	water-borne hepatitis	0
syzygium jambos	prostatic intraepithelial neoplasm	0
tuna fish	androgenic alopecias	0
acid-binding vegetables	human t cell lymphotropic virus type iii	0
almond tree	low-grade b-cell malignancy	0
wheat	environmental cancer	0
emblica officinali	retained surgical needles	0
fried foods	cancer of endometrium	0
bellis	galactose 1 phosphate uridyl transferase deficiency disease	0
fatty foods	thyroid carcinoma	0
solanum lycopersicum	eczematous dermatitis	0
frying foods	b cell leukemia	0
olive tree	thyroid adenomas	0
milk chocolate	toxico-infectious botulism	0
cuminum	age-related maculopathy	0
corylus	vertiginous seizures	0
lentil	vulva cancer	0
papaver	leiomyoma	0
healthy fruit	chronic daily headaches	0
japanese plums	post traumatic osteoporosis	1
parsley	virus	0
fresh ginger	human mammary carcinoma	0
macadamia nut	lead poisonings	0
mangifera indica	semirhythmic tremors	0
pleurotus	vulvar neoplasms	0
potato	poisoning	1
dairy eggs	heart blocks	0
experience food	substance use disorder	0
ultra-processed food	disorientation	0
fennel seeds	basal cell epithelioma	0
plant aril	female infertility	0
sugar maple	sexual dysfunction	0
jasmine tea	familial parkinson disease	0
vicia fabas	post-traumatic osteoporosis	0
zingiber officinales	paraesophageal hernias	0
citrus	brief reactive psychoses	0
rubus idaeus	superficial head injuries	0
peanut butter	guillain-barre syndrome	0
century plant	well-differentiated lymphocytic lymphoma	0
illicium anisatum	manic disorders	0
caryophyllus	male sexual impotence	0
vegetable juices	spinal meningiomas	0
milkshake	cancer of vagina	0
eugenia jambos	vaginal neoplasm	0
radish	tumor viruses	0
cupcake	infection	0
include flaxseed	drug allergies	0
plantago psyllium	cephalgia syndromes	0
eragrostis	sharp headaches	0
brassica nigra	meningotheliomatous meningiomas	0
tobacco	polyp	0
plant capsules	migratory pain	1
marjoram plant	testicular neoplasms	0
infant formulas	disc degeneration	0
melissa officinalis	upper respiratory tract infections	0
breast milk	light headedness	0
cassia	cluster headache	0
acer negundo	common bile duct gall stones	0
indian laburnums	head traumas	0
carthamus tinctorius	arrythmia	0
alfalfa	testis neoplasms	0
plantago lanceolata	hydrophobia	0
ribe	alopecia	0
dietary supplements	tactile hypesthesia	0
squash seeds	increase cancer	0
citron trees	utp hexose 1 phosphate uridylyltransferase deficiency disease	0
avocado fruit	darkness tremor	0
cicer arietinum	breast diseases	0
tarragon	syncopal vertigos	0
juglan	joint pains	0
illicium	mucous colitides	0
antioxidant-rich food	backache	0
tomato	cramp	0
raw cranberries	galactose-1-phosphate uridyltransferase deficiencies	0
mustard greens	neurodegenerative diseases	0
breakfast times	sharp headache	0
refined olive	abdominal migraine	0
antioxidant food	fibromyalgia fibromyositis syndrome	0
vegetable oil	recurrence	0
cacao bean	cerebral strokes	0
pea family	block cancer	0
white rice	dna injuries	0
intoxicant	philadelphia-negative myeloid leukemia	0
moose meat	peanut allergies	0
chile peppers	diffuse undifferentiated lymphoma	0
foeniculum vulgare	somatotropin (acromegaly) hypersecretion syndrome	0
pizza	gerd	0
zedoary zedoaria	colonic cancers	0
brussel sprout	lymphocytic lymphomas	0
hemp	zoonotic infectious disease	0
breakfast cereals	intractable headache	0
soy bean curds	increased cancer	0
white meat	muscular spasm	0
cardamon	micturition syncope	0
pimpinella	liver steatoses	0
sugar-sweetened beverages	tumor	0
last meal	cognitive declines	0
amomum cardamomums	carcinogenese	0
low-calorie diet	central nervous system cysticercosis	0
wine	ocular headaches	0
grecian foxgloves	primary brain neoplasms	0
high fructose maize syrup	somatotropin hypersecretion (acromegaly) syndrome	0
handling food	infectious mononucleosis viruses	0
dietary sucrose	brain malignant neoplasms	0
osmanthus tea	pulmonary embolisms	0
triticum vulgare	idiopathic polymyositis	0
flax	tonic-clonic seizure	0
happy meal	ciliary neuralgias	0
breakfast time	diabetic mononeuropathy	0
linum	mixed lymphocytic-histiocytic lymphomas	0
mustard	testicular tumors	0
papaya	liver neoplasms	0
prunus persica	scorbutus	0
boiled eggs	texidor twinge	0
white mallow	muscle tremor	0
incorporates cloves	confusional state	0
cream cheese	prediabete	0
prunus domestica	determination of death	0
thymus	ekbom delusory parasitosis	0
cassia tree	male breast tumor	0
petroselinum	horton's syndrome	0
apricot tree	leukemia	0
kiwi fruits	memory deficit	0
crocus sativus	small non-cleaved-cell lymphoma	0
sunflower seeds	dental plaque	0
juglans nigra	pulmonary embolisms	0
maize	retained surgical items	0
stuff	ph1-negative myelogenous leukemia	0
healthiest beverages	acute confusional migraines	0
wheat bran	back pains	0
whiting	pregnancy-induced diabetes	0
pistachio nut tree	peanut allergy	0
adhatoda	kidney calculus	0
morel	brain cancers	0
sandwich	autosomal dominant juvenile parkinson disease	0
allium sativum	impaired sensation	0
dairy product	cardiac sudden death	0
bilberry	endothelial dysfunction	0
andean blackberry	colorectal carcinomas	0
fava bean	migraine headaches	0
green lentils	muscle sorenesses	0
frozen broccoli	high-grade lymphomas	0
vegetarianism	respiratory tract infections	0
healthy snack	hemolytic uremic syndrome	0
eating almonds	fibromyalgia fibromyositis syndrome	0
kaffir lime	pneumonitide	0
poultry	esophageal neoplasms	0
marshmallow	melanoma	0
secale cereale	polyradiculoneuritis	0
coriandrum	endometrial carcinomas	0
holy basil	textiloma	0
citrus sinenses	psychogenic parasitoses	0
soybean	penile neoplasms	0
ocimum basilicum	polymyositis	0
citrus bergamia	sharp headaches	0
eat flax	gustatory seizures	0
clathrotropis	birth defects	0
eugenia cumini	tubal abortion	0
mesquite	alzheimer’s disease	0
seltzer water	juvenile onset diabetes mellitus	0
prebiotic	acquired immunodeficiency syndrome	0
ice creams	horton syndrome	0
pudding	primary fibromyalgia	0
dried plums	inflammatory polyneuropathy acutes	0
sushi	diabetic asymmetric polyneuropathy	0
willow tree	central nervous system cysticercosis	0
food manufacturers	et-nanbh	0
citrus fruits	basal cell carcinomas	0
lemon balm	cognitive dysfunctions	0
morning meals	blood clots	0
organic foods	convulsive seizures	0
flaxseed	human papillomavirus virus	0
conventional food	inappropriate growth hormone secretion syndrome (acromegaly)	0
sugar substitute	venous thrombosis	0
dasheen	somatosensory seizure	0
raw food	poultry viruses	0
sparkling waters	orthostasis	0
fruit-shaped marshmallows	pulmonary thromboembolism	0
kohlrabi	abdominal migraine	0
sustenance	human mammary carcinoma	0
glycine max	heart attacks	0
meal time	bewilderment	1
saffron	monoblastic leukemia	0
carbonated drink	passive tremors	0
bad foods	arterial fatty streak	0
vaccinium bracteatum	cardiac diseases	0
national pork	age related macular degeneration	0
fries	strains and sprains	0
nutraceutical	semirhythmic tremors	0
salmonella food	post-ictal confusion	0
salad	occipital trauma	0
taro	stomach cancers	0
artichoke	psychophysiological insomnia	0
ground ginger	metabolic acidosis	0
antioxidant-rich foods	dental fluorosis	0
horse beans	subacute spongiform encephalopathy	0
vegetable proteins	bipolar disorder	0
cardamom	colorectal tumors	0
norus	birth weights	0
bagel	cacosmia	0
citrus hystrix	common colds	0
blueberry	ovary neoplasms	0
ephedras	mammary cancers	0
olive oils	enzootic bovine leukoses	0
ground flax	behavior disorders	0
coconut milk	atrioventricular dissociation	0
california avocado	sid	0
nettle tea	anal ulcers	0
artificial sweeteners	hypermelanose	0
drug administration united states food	symmetric diabetic proximal motor neuropathy	0
sunchoke	drug use disorder	0
solanum laciniatums	cervix cancer	0
carica	vulvar neoplasms	0
bt corn	age related macular degeneration	0
drink milk	kidney calculus	0
nettle	childhood onset obesity	0
ready prepared foods	new variant creutzfeldt-jakob disease	0
goji berry plant	low grade lymphoma	0
euterpe oleracea	cardiovascular conditions	0
amla	syndrome	0
algarrobo	rectum cancers	0
eupatorium rebaudianums	rebound insomnia	0
handling meat	small lymphocytic lymphomas	0
added nuts	gallbladder diseases	0
cocoanut	cardiac failure	0
brown sugar	colorectal tumor	0
sour fruit	todd's paralysis	0
trace elements	carcinogenesis	0
unfiltered coffee	aortic aneurysm	0
infant formula	anaplastic carcinomas	0
squid	continuous tremors	0
peanut	diabetic polyneuropathies	0
kava kavas	barrett syndrome	0
fast food	parkinsonism	0
crocus	substance abuses	0
carya illinoenses	complications of diabetes mellitus	0
brassica napus	abdominal cramp	0
common olive trees	coarse tremors	0
curry	birth defect	0
sweet marjoram	inflammation	0
endive	rebound insomnia	0
crataegus monogynas	left-sided heart failure	0
citrus reticulatas	effort syncopes	0
abelmoschus	fibrocystic disease of breast	0
solanum tuberosum	early-onset parkinsonism	0
suggesting fruit	juvenile parkinsonism	0
inadequate fruit	cellulite	0
dietary proteins	barrett esophagus	0
squashe	esophagitis	0
cocoa	jakob creutzfeldt disease	0
soy bean curd	gluten enteropathy	0
canned fruit	acute inflammatory polyneuropathy	0
cider	ovarian cancers	0
ranking foods	benign neoplasm	0
butternut squash	olfactory groove meningioma	0
fragaria vesca	udp-galactose-4-epimerase deficiencies	0
offal	ekbom psychogenic parasitosis	0
arugula	vertebrogenic pain syndrome	0
turmeric	spongiform encephalopathies	0
bread	breast disease	0
mangifera indicas	brain cancers	0
citrus maxima	deep-vein thrombosis	0
citrus x paradisi	basal cell carcinomas	0
golden raisins	undifferentiated carcinoma	0
citronella	genital wart	0
trace minerals	hemorrhoid	0
rubus	endometrial neoplasm	0
organ	huntingtons disease	0
thymus vulgaris	amnesia	0
salt-free diet	birth defect	0
sea food	olfactory seizures	0
betel nut	parodontosis	0
cured meats	age related memory disorders	0
extracted fruit	deficiency disease	0
seed	different cancer	0
dragon fruit	acute monocytic leukemia	0
melissa officinali	non-b hepatitis enterically-transmitted non-a	0
navy beans	human papillomavirus virus	0
dinner time	experimental lung inflammation	0
fig	premenstrual syndromes	0
dietary fat	aortic aneurysms	0
smoked foods	tumor of rete testis	0
alpine strawberry	pill rolling tremors	0
hibiscus	endemic cretinism	0
silybum marianum	severe congenital microcephalies	0
dried foods	reactive confusion	0
flaked coconut	dementia	0
food pyramid	paraesophageal hiatal hernias	0
nuclear power plant	intention tremor	0
rosa	physical sufferings	1
carbonated mineral water	spatial memory disorder	0
vaccinium myrtillus	ulcer	0
psidium guajava	palmoplantaris pustulosis	0
healthier meat	diabetic complication	0
soy cheese	chronic obstructive airway disease	0
snack food	confusional states	0
honey	ulcer	0
romaine	lactose intolerance	0
vegetable protein	human papillomavirus viruses	0
flounder	cjd (creutzfeldt jakob disease)	0
opium poppies	retained surgical tools	0
chewing gums	diffuse mixed-cell lymphoma	0
quinoa	polymyositide	0
celery root	acute inflammatory demyelinating polyradiculoneuropathy	0
raisin bran	b12 deficiency	0
indian gooseberries	chronic cluster headaches	0
dioscorea polystachya	pustular psoriasis of palms and soles	0
find pork	influenza in humans	0
flesh foods	crushing skull injuries	0
ready soybeans	breast malignant tumor	0
dietary supplementations	galactokinase deficiency diseases	0
legume family	johne disease	0
garcinia mangostanas	abdominal pain	0
poisonous plant	blindness	0
sugary foods	epilepsy	0
anti-inflammatory foods	amyotrophic lateral sclerosis parkinsonism dementia complex 1	0
origanum	tying disease	0
bell peppers	low grade lymphoma	0
purine-rich plant	gastro-oesophageal reflux	0
sea bilberry	eczematous dermatitis	0
jam	vertex headache	0
sauerkraut	acidose	0
arginine-rich foods	physical anhedonias	0
alcoholic beverages	hiatus hernia	0
dinner	semantic memory disorders	0
beverage	gastro-oesophageal reflux	1
unhealthy food	cancer of the vulva	0
dripping	jacksonian seizure	0
hot pepper	secondary fibromyalgia	0
carrot juice	gnathostomiasis	0
anise	zoonotic infectious disease	0
natto	leukemogenic virus	0
carica papayas	steatohepatitis	0
cleistocalyx	familial atrial fibrillations	0
jelly	cancer of breast	0
kavas	mixed-cell lymphomas	0
scrambled eggs	celiac disease	0
cereal grain	brittle diabetes mellitus	0
daily fruit	somatosensory seizure	0
sea vegetable	lymphatic sarcoma	0
mastic trees	intraventricular meningiomas	0
granny smith	chronic fatigue syndrome	0
ilex paraguariensis	coma	0
cacao	meningotheliomatous meningioma	0
roselle	gnathostoma infection	0
alfalfa sprout	acquired immunodeficiency syndrome virus	0
baby spinach	arterial fatty streaks	0
hibiscus cannabinus	juvenile parkinsonism	0
reason food	childhood onset obesity	0
beet	premature aging	0
rhubarb	plasma cell myeloma	0
topical ginger	cardiovascular strokes	0
citrus fruit	sliding esophageal hernias	0
neu5gc-rich food	intermediate-grade lymphoma	0
raw foods	pediatric cancers	0
healthier foods	endometrium carcinoma	0
euterpe	chronic infectious mononucleosis like syndrome	0
floret	involuntary quiver	0
french bean plants	malignant meningiomas	0
raw meat	semirhythmic tremors	0
bacon	deficiency diseases	0
syzygium malaccense	type c oncovirus	0
wort	osteoporose	0
monkfish	throat cancer	0
sesame oil	small cell lymphoma	0
vaccinium ashei	reverse cancer	0
pie	neurocysticercose	0
agave	prediabete	0
dried food	myalgic encephalomyelitis	0
atropa belladonnas	deficiency diseases	0
vital nutrients	bone neoplasms	0
high-fat meal	acute inflammatory polyradiculoneuropathies	0
apium graveolens	fibroatheromatous plaques	0
phyllanthus emblica	study cancer	0
mentha spicatas	rest tremor	0
veal	reversing chronic disease	0
pleurotus ostreatus	monocytic leukemia	0
yellow vegetables	kill cancer	0
pinto beans	degenerative intervertebral disks	0
copaifera	back pains	0
mirobalanus embilicas	reticuloendotheliosis virus	0
citron tree	sudden infant death syndrome	0
candy bars	atrophy	0
green onions	flatulence	0
cranberry	granulomatous enteritis	0
honeybush tea	intermediate-grade lymphomas	0
petroselinum crispum	cancer of the kidney	0
soda pop	premenstrual tensions	0
green peppers	amaurose	0
jambolan plum tree	lassitude	0
licorice	fibromyositis-fibromyalgia syndromes	0
plaice	bovine lymphosarcomas	0
papaver somniferum	infant gynecomastia	0
pimiento	chronic pain	0
avocado	cancer of bladder	0
lemon grasses	cancer of testis	0
mandarin orange trees	diabetes complications	0
orange trees	open head injury	0
hazelnut	dental fluoroses	0
vaccinium macrocarpon	anxiety disorders	0
pimpinella anisums	macular degenerations	0
althaea officinalis	hypercholesteremia	0
good soybeans	celiac sprue	0
purple grape	acne vulgaris	0
drinking tea	mixed lymphocytic-histiocytic lymphoma	0
calling eggs	muscle pain	0
cabbage	breast cystic diseases	0
wolfberry	benign neoplasms	0
chanterelle	diabetes complication	0
soy beans	heart blocks	0
squash plant	landry guillain barre syndrome	0
marijuana	temporary amnesia	0
hashish	diffuse small cleaved cell lymphoma	0
medicago sativa	rickets	0
red meats	renal failures	0
areca	primary insomnia	0
replenish nutrients	acute cerebrovascular accident	0
fruit juice	memory loss	0
calendula officinalis	cancer of breast	0
cocoa plant	ciguatera fish poisonings	0
strawberry	breast fibrocystic disease	0
curcuma	cephalalgia	0
indian gooseberry	non-b hepatitis enterically-transmitted non-a	0
safflower oils	parkinsons disease	0
trigonella foenum graecum	minor head injuries	0
citrus sinensis	pulmonary disorder	0
ilex paraguarienses	social phobia	0
sausage	brain conditions	0
cocoa powder	drug dependence	0
cocos nucifera	rodent ulcer	0
dried apple	plasma cell myeloma	0
persea	rete testis tumors	0
banana plants	hiatus hernia	0
reindeer meat	diverticulitide	0
calendula	familial guillain-barre syndrome	0
apricot trees	meningotheliomatous meningioma	0
white wine	cognitive retention disorders	0
drinking water	brittle diabetes mellitus	0
durum wheats	olfactory groove meningiomas	0
processed meat	prostate cancer	1
anise tea	action tremor	0
chinese cassias	intracranial meningioma	0
theobroma cacao	memory deficit	0
raphanus raphanistrum	malignant tumor of urinary bladder	0
lamb chops	todd's paralysis	0
red tea	heart disease	0
food colors	gastroenteritide	0
rice	generalized spasm	0
thymus plant	cancer of endometrium	0
ready-to-eat meal	chronic illnesses	0
organic plants	gluten-sensitive enteropathies	0
elettaria	ciguatera fish poisoning	0
broth	bladder neoplasm	0
dinnertime	encephalon diseases	0
citrus medicas	experimental parkinson disease	0
monosodium glutamate	intracranial cns disorders	0
oyster mushroom	gale deficiency	0
measuring food	pneumonia	0
spice turmeric	sleep-related neurogenic tachypnea	0
flavourer	sudden cardiac death	0
capsicum annuum	idiopathic polymyositides	0
cannabis indica	continuous tremors	0
unfertilized eggs	food-borne diseases	0
milk thistles	guillain-barre syndrome	0
hot sauce	intermediate-grade lymphoma	0
black walnut	liver cancer	0
celery	marek's disease virus	0
mussel	presyncope	0
secale	udpglucose 4-epimerase deficiency disease	0
romaine lettuce	non b hepatitis epidemic non a	0
ready-to-eat meals	cephalgia syndromes	0
steak	central nervous system cysticercosis	0
deep-fried foods	premature births	0
big food	colon neoplasms	0
contamination meat	proliferative bronchiolitides	0
ficus	renal cancers	0
sticker	congenital defect	0
ready-prepared food	udp galactose 4 epimerase deficiency disease	0
chamomile	mammary cancers	0
raphanus	rabies	0
pecan trees	adolescent gynecomastia	0
dried fruits	overeat	0
cannabis sativa	diabetes mellitus complication	0
sugar substitutes	liver disease	0
carbonated waters	anoxemia	0
clove	atrial fibrillation	0
kidney bean	creutzfeldt jakob syndrome	0
snack	kill cancer	0
laciniate nightshades	tubal abortions	0
seville orange tree	obesity	0
acaí berries	child obesity	0
morning meal	human influenzas	0
tea	hyperventilation syncopes	0
black pepper	exanthema	0
butter milk	uterine cervical cancers	0
drinking milk	intermediate-grade lymphoma	0
powdered ginger	spinal cord disease	0
macadamia	varice	0
coconut water	ischemic heart diseases	0
zinger tea	sea sickness	0
processed foods	testis cancers	0
digitalis purpurea	human cancer	0
cooking oil	bruise	0
kawa kawas	aids viruses	0
sesame oils	galt deficiency	0
little meat	bovine lymphosarcoma	0
soy milk	bse (bovine spongiform encephalopathy)	0
purple rice	bacterial vaginosis	0
retail meat	fifth phacomatoses	0
lard	breast fibrocystic changes	0
thymus vulgari	cardiac failure	0
majorana hortensis	leucocythaemia	0
soy sauce	pneumonitide	0
bok choy	intractable headache	0
plantago indica	cerebrovascular accidents	0
rutabaga	light headedness	0
prosopi	cirrhosis	0
hordeum	hirsutism	0
kenaf	familial creutzfeldt-jakob diseases	0
mint	food-borne disease	0
cannabis sativas	breast diseases	0
phaseolus vulgari	iron deficiency	0
baptisia	diffuse small cleaved-cell lymphoma	0
arachis hypogaea	alactasia	0
chenopodium quinoa	common bile duct gall stones	0
grecian foxglove	anosmia	0
prenatal vitamins	non alcoholic fatty liver disease	0
bean sprout	bladder neoplasms	0
hemp plant	effort syncope	0
kale	philadelphia-negative myeloid leukemias	0
rubus fruticosus	diffuse small cleaved cell lymphoma	0
baby carrots	mucous colitides	0
buckwheat	diffuse small cleaved cell lymphoma	0
green tea	temporal region traumas	1
piper methysticum	feminization	0
tachigalia	endometrium carcinomas	0
anchovy	virus disease	0
crataegus monogyna	diabetic polyneuropathies	0
exotic fruit	amnesia	0
basil	liver neoplasm	0
weekly meat	infantile botulism	0
ready-prepared foods	penile neoplasm	0
cucurbita	creutzfeldt-jakob disease	0
ground meat	thyroid carcinoma	0
pumpkin	cholera	0
phyllanthus emblicas	brain cancer	0
ale	polyradiculoneuritide	0
fresh basil	morning sickness	0
callerya	age-related bone loss	0
betel nuts	cognitive dysfunction	0
portulaca oleraceas	autoimmune disease	0
pistacia vera	mptp induced experimental parkinsonism	0
black beans	bladder cancers	0
watermelon	fibromyositis-fibromyalgia syndrome	0
dried apricots	cancer of the kidney	0
musa	lymphadenopathy-associated viruses	0
stevia rebaudiana	rectum cancer	0
illicium verums	limb tremor	0
wild yam	physical sufferings	0
gluten	galactosemia 2s	0
prunus cerasifera	lower back pains	0
venison	ulcerative colitis type inflammatory bowel disease	0
olea europaea	cardiac death	1
flammulina	uveitide	0
dinner times	fights cancer	0
pasta	v cjd (variant creutzfeldt jakob disease)	0
syzygium aromaticum	small lymphocytic lymphoma	0
animal food	mastitis	0
persea americanas	cancer-causing viruses	0
drinking orange	fibroadenoma	0
malus	neurocysticercose	0
texturized soy proteins	colitide	0
trigonella foenum-graecums	convulsive syncope	0
four nuts	fibromyalgia-fibromyositis syndrome	0
cooking meat	neoplasia	0
big apples	polymyositis	0
cocos nuciferas	birth defects	0
healthy food	autistic disorder	0
cocoa powders	weight reductions	0
olea	polyarthralgia	0
commercial milk	carcinogenesis	0
triticum aestivum	cystic disease of breast	0
daily nut	rabies viruses	0
garden radish	hepatic neoplasms	0
thymus plants	orthostatic headaches	0
porgy	osteoarthrose	0
woodland strawberry	deficiency diseases	0
cantaloupe	primary malignant brain neoplasms	0
aloe	rectal tumors	0
nut bar	gastro-oesophageal reflux	0
fat foods	brain cysticercosis	0
crunch berries	spiral fractures	0
chili pepper	secretory meningioma	0
eating meat	breast malignant neoplasms	0
cider vinegar	diabetes-related complication	0
brussels sprouts	human papillomavirus viruses hpv	0
black currant	coad	0
little saffron	diffuse lymphocytic lymphoma	0
food allergy	decreased cancer	0
watercress	oncogenic virus	0
english plantain	chronic airflow obstructions	0
ganja	parkinsonian syndromes	0
lens plants	zoonosis	0
meal	coronary diseases	0
cola nitida	forehead trauma	0
white pepper	small noncleaved-cell lymphomas	0
phaseolus vulgaris	darkness tremors	0
pomegranate seeds	autistic disorders	0
crataegus	carcinoma	0
fructose corn	sea sickness	0
assai palm	small round-structured viruses	0
vitis vinifera	cerebral convexity meningiomas	0
elettaria cardamomum	barrett epithelium	0
antioxidant fruits	non-hodgkin's lymphoma	0
largest meal	gastro oesophageal reflux	0
sour orange trees	uveitide	0
lemon grass	malignant meningiomas	0
hordeum vulgare	carotid sinus syncope	0
kangaroo meat	intracranial meningiomas	0
cuminum cyminums	abdominal aortic aneurysms	0
prunis communis	neurologic degenerative disease	0
whole grain cereals	lyme disease	0
nicotiana tabacum	prostatic hyperplasia	0
popular fruits	varice	0
nori	transmissible dementia	0
no meat	adenosis of breast	0
dog rose	cancer of liver	0
high-fiber food	rhabdomyolysis	0
poroporo	non-b hepatitis enterically-transmitted non-a	0
cannabis indicas	leucocythaemia	0
pea	malignant melanoma	0
swordfish	ph1-negative myelogenous leukemia	0
cassia cinnamon	colonic cancers	0
red cabbage	newborn gynecomastia	0
foeniculum vulgares	t viruses	0
english plantains	dims (disorders of initiating and maintaining sleep)	0
pomelo tree	penis neoplasm	0
corn syrup	disk degradation	0
red delicious	hiatus hernia	0
cortland	iron overload	0
guacamole	food-borne diseases	0
citrus grandi	degenerative arthritis	1
cymbopogon	cervical migraine syndrome	0
cinnamomum trees	foreign bodies	0
dried fruit	galactokinase deficiency diseases	0
flax seed	heart block	0
phaseolus	tongue cancers	0
fagopyrum sagittatum	cognitive declines	0
hypericum perforatum	back ache	0
raw alfalfa	syncope	0
antioxidant vitamin	acute inflammatory polyradiculoneuropathy	0
grouper	spatial memory disorder	0
linum usitatissimum	colicky pain	0
marjoram	histamine cephalgia	0
wild bananas	cysticercose	0
thyme	testicular neoplasms	0
gravy	spinal cord diseases	0
blossom	baldness	0
chicken salad	lactose intolerance	0
flower	bone neoplasms	0
high-fructose corn	psychosis	0
chocolate	prostatic cancers	0
cinnamomum zeylanicum	pulmonary thromboembolism	0
trace mineral	membranous cataracts	0
candy bar	juvenile parkinsonism	0
lavandula angustifolia	cystic breast disease	0
myristica fragrans	bilateral headache	0
seville orange trees	angiomatous meningiomas	0
health food	amyotrophic lateral sclerosis-parkinsonism-dementia complex 1	0
espresso	campylobacter infection	0
flavoring	inflammatory disease	0
chile pepper	chronic fatigue fibromyalgia syndrome	0
kawa	high cholesterol levels	0
eugenia aromatica	steatohepatitis	0
whole grain cereal	periadenitis mucosa necrotica recurrens	0
yogurt	recurrent brain tumor	0
potable water	sciatic neuralgia	0
spearmint	early onset parkinsonism	0
walnut oil	amyloidosis	0
peach	degenerative neurologic disorder	0
frequent meals	bipolar depression	0
dietary plant proteins	cancer of the endometrium	0
soda pops	premenstrual syndrome	0
fagopyrum tataricum	dementia with amyotrophic lateral sclerosis	0
sour cream	prediabetic states	0
edible grains	mania	0
vitamin	malignant melanoma	1
euterpe oleracea mart.s	involutional osteoporosis	0
century plants	myocardial infarcts	0
cassia fistula	pyrexia	0
mint tea	myocardial infarct	0
indian corn	brain malignant neoplasms	0
margarine	reticulum-cell sarcomas	0
berry	iron overload	0
store licorice	pulmonary thromboembolisms	0
marihuana	texidor's twinge	0
coca	udp-galactose-4-epimerase deficiencies	0
incorporate cloves	deep-venous thrombosis	0
golden glow	benign essential tremors	0
maguey	semantic memory disorder	0
wisconsin milk	retro-ocular headaches	0
pine nuts	cerebrovascular accident	0
family vegetables	cancer of penis	0
soya milk	male breast cancer	0
pummelo tree	fibrocystic mastopathy	0
goji berry plants	biliary calculi	0
nut	nonalcoholic fatty livers	0
broad beans	marie struempell disease	0
allium porrum	acute inflammatory polyneuropathies	0
white mallows	common bile duct gall stones	0
common fruits	low back aches	0
anacardium occidentales	joint pains	0
citrus-based fruits	cervical migraine syndromes	0
carbonated mineral waters	prostatic intraepithelial neoplasm	0
plantago ovata	male breast tumors	0
bitter orange trees	breast carcinoma	1
lycium chinense	feline lymphoma virus	0
syzygium sandwicense	prevent and reverse heart disease	0
actual fruit	confusional states	0
chinese yam	human herpesvirus 4	0
common plant	cervical migraine syndromes	0
foie gras	malignant melanoma	0
marjoram plants	head pain	0
chinese cinnamons	hypoxia	0
cookie	secondary fibromyalgia	0
java plum trees	phlebothrombose	0
anacardium occidentale	insomnia	0
french fries	chronic illness	0
yeast rice	alopecia cicatrisatas	0
artificial butter	intraepithelial neoplasms	0
pistil	subwakefullness syndromes	0
grapefruit juice	intermittent tremors	0
portulaca oleracae	drop attack	0
bertholletia	androgenic alopecia	0
banana plant	viral infections	0
buttermilk	miscarriage	0
vaccinium virgatum	substance use disorders	0
dried pomegranate	head injury	0
health nuts	dissociative amnesias	0
plant-based nutrients	galactosemia iiis	0
tv dinners	autosomal dominant. juvenile parkinson disease	0
cocoa butter	impotence	0
mentha x piperita	stomach cancers	0
milk thistle	carcinomatose	0
faba bean	iron deficiency	0
vegetable juice	sliding hiatal hernias	0
brassica	mouth neoplasms	0
crowberry	acute autoimmune neuropathy	0
acai berries	strains and sprains	0
box elders	growth hormone insensitivity syndrome	0
horsenettle	contagious pustular dermatitis	0
andira	cerebrovascular accident	1
oyster mushrooms	fibroatheromatous plaques	0
oxen meat	lou gehrig disease	0
new vitamin	cancer of cervix	0
hickory nuts	parkinsonism-dementia complex of guam amyotrophic lateral sclerosis	0
beta vulgaris	thyroid adenoma	0
lunchtime	sid	0
texturized soy protein	bronchiolitide	0
lemon tree	syndrome	1
tofu	pancreas neoplasm	0
dried peas	foodborne disease	0
decaffeinated tea	cot deaths	0
english walnut	enzootic bovine leukoses	0
brewage	fine tremors	0
weed	a v dissociation	0
jalapeno peppers	starvation	0
citrus aurantiums	intention tremors	0
sweet foods	familial dementia	0
sockeye salmon	udpglucose 4-epimerase deficiency disease	0
cashew	skin neoplasm	0
raisin	vulvar cancers	0
corn	epstein barr virus	0
origanum onites	urinary bladder neoplasm	0
added sweeteners	fibrosis	0
sour orange tree	breast disease	0
drink tea	pulmonary thromboembolisms	0
pear	high-grade lymphoma	0
snail meat	muscle disease	0
chocolate bars	female sub fertility	0
cinnamomum aromaticum	grippe	0
morinda citrifolia	diabetic autonomic neuropathy	0
no noni	mental disorders	0
seltzer waters	apneas	0
capsicum	cognitive dysfunctions	0
rheum	posterior compartment low back pain	0
okra	eye disease	0
bitter nightshades	todd paralysis	0
canned food	postural low back pain	0
cuminum cyminum	hypoesthesia	0
leafy vegetables	brain tumor	0
sesame	autosomal recessive juvenile parkinson disease	0
garlic	saturnine tremor	0
cured meat	new variant creutzfeldt jakob disease	0
millet	uterine neoplasms	0
carrot	canker sores	0
malus domestica	myelogenous leukemia	0
concord grape	diabetes complication	0
eden foods	joint pain	0
cranberry sauce	migratory pains	0
fake meat	secretory meningiomas	0
brassica juncea	essential tremors	0
roasted almonds	udp-galactose-4-epimerase deficiency diseases	0
stryphnodendron	uterine neoplasms	0
nutmeg	breast dysplasia	0
citrus aurantiifolia	left-sided heart failure	0
fabaceae	human papillomavirus viruses hpv	0
sweet basil	hansens disease	0
density foods	ankylosing spondyloarthritis	0
glucose-fructose syrup	hernia	0
cicer arietinums	alopecia cicatrisatas	0
pureed apples	primary brain neoplasms	0
seven nutrients	degenerative neurologic diseases	0
so-called meat	multiple myeloma	0
breakfast cereal	guam disease	0
raphanus sativus	retained surgical sponge	0
chai tea	low back pains	0
acer saccharum	congenital hypothyroidism	0
guibourtia	microglandular adenosis	0
cruciferous vegetable	polyradiculoneuropathy	0
almond oil	atypical cluster headache	0
punica granatum	disorders of initiating and maintaining sleep	0
dessert	autosomal recessive juvenile parkinson disease 2	0
rowanberry	barrett's esophagus	0
high fructose corn syrup	pancreatic cancer	0
plant capsule	generalized spasms	0
lunch time	autosomal dominant parkinsonism	0
liquor	joint disease	0
high-phytate foods	mucous colitides	0
consumer protection scientific committee on food	wound botulisms	0
mother cells	steatohepatitide	0
sweetening agent	autosomal dominant juvenile parkinson disease	0
irritable bowel kiwi fruit	car sickness	0
leaf lettuce	primary brain neoplasm	0
ultra-processed foods	neurodegenerative disease	0
cassia trees	prostatic hyperplasia	0
earl grey tea	johne disease	0
cranberry juice	carotid sinus syncopes	0
raspberry	benign essential tremor	0
baby formula	necrotizing fasciitis	0
brazil nuts	pruritus	0
domestic fowl	episodic cluster headaches	0
cow's milk	intermittent tremor	0
diabetic diets	basal cell carcinomas	0
cherry plum trees	variant creutzfeldt jakob disease	0
cereal	clear cell meningioma	0
soy cheeses	prostatic adenomas	0
healthiest nuts	phlebothrombosis	0
chewing fruit	abdominal migraine	0
walnut	posterior fossa meningiomas	0
rosehip	abdominal migraines	0
canned foods	schizophrenia	0
poppy seed	gingivitis	0
brewing tea	wheat hypersensitivities	0
pea families	pancreatic cancer	0
radicchio	brain malignant neoplasm	0
sprout	crohns disease	0
tangerine trees	inappropriate gh secretion syndrome (acromegaly)	0
saint johns wort	tumor of rete testis	0
chili	classic galactosemia	0
national meat	prion-induced disorder	0
vitamin pills	tongue neoplasm	0
bean	nanism	0
garbanzo	cirrhosis	0
holy basil tea	prostatitis	0
morinda	udp-galactose-4-epimerase deficiency diseases	0
woodland strawberries	marsh fever	0
malabar-nut	neonatal tremor	0
toronja	cancer of tonsil	0
cultivated oats	type 1 diabetes	0
group foods	postural low back pain	0
chipotle	breast malignant neoplasm	0
carduus marianus	food hypersensitivity	0
target vitamin	lymphosarcoma	0
specific cheeses	physical sufferings	0
dietary supplement	allergic reactions	0
sweetening agents	dental fluoroses	0
berberis	texidor twinge	0
processing meat	tongue cancers	0
spice saffron	non-epileptic convulsions	0
syzygium jambolanum	psammomatous meningioma	0
common foxgloves	mad cow disease	0
chewed coca	malignant tumor of breast	0
foenumgraecum	disorientation	0
plantain	non hodgkin's lymphoma	0
tulsi tea	increased cancer	0
aspartame	vestibular seizure	1
milk	sarcopenia	0
black currants	birth weights	0
breast milks	periodontal diseases	0
chamomile oil	overeat	0
supper	coronary heart diseases	0
oats	prion diseases	0
prettiest fruit	occipital trauma	0
mayo	suppuration	0
cucumis sativus	social phobias	0
ocimum basilicums	amnesia-memory losses	0
salami	intertrochanteric fractures	0
acer	urinary tract infections	0
acacia tree	acute stroke	0
cannabi	head pain	0
dairy yogurt	guillaine-barre syndrome	0
high-fructose maize syrup	brain malignant neoplasm	0
plum	acute coryza	0
bottled water	cancer of endometrium	0
poisonous plants	presyncope	0
rooibos	zoonosis	0
olive oil	muscular rheumatism	0
know nuts	vitamin deficiency	0
jelly beans	gastro esophageal reflux	0
blackberry	brain conditions	0
junk foods	familial creutzfeldt jakob disease	0
red wine	plasma-cell myeloma	0
larder	heat stroke	0
fat milk	male sterility	0
black tea	fibromyalgia-fibromyositis syndrome	0
colocasia	postural syncope	0
sardine	short sleep phenotype	0
chia seeds	hereditary essential tremor	0
vicia faba	urticarias	0
cassia fistulas	hemicrania migraines	0
phytonutrient-rich food	flatulence	0
saint john's wort	dermatozoic delusion	0
oregano plant	adenomatous polyp	0
almond milk	progressive disorder	0
prunus armeniaca	food-borne illnesses	0
cruciferous foods	feline leukemia viruses	0
cayenne	campylobacter infections	0
belladonna	splitting pain	0
mushroom	atopic diseases	0
eupatorium rebaudianum	rectal tumors	0
pickled foods	benign neoplasm	0
roughage	anosmia	0
dangerous plants	esophagus cancers	0
junk food	tonsil neoplasm	0
grilled meat	blood clot	0
artificially-flavored corn	hemicrania migraines	0
fruit juices	megacolon	0
lavandula	lymphocytic leukemia	0
carbonated drinks	colonic cancer	0
pecan tree	pancreas neoplasms	0
açaí berry	parkinson’s disease	0
carbonated beverages	lung inflammations	0
kiwi	fetal iodine deficiency disorder	0
fortify milk	barrett metaplasia	0
rose	uterine fibroma	0
adding blueberries	atrial fibrillations	0
grape	gluten enteropathies	0
cauliflower	polyp	0
low fruit	tactile amnesia	0
hypericum perforatums	benign essential tremor	0
broccoli raab	cancer of skin	0
popcorn	osteoporose	0
solanum melongenas	colon neoplasms	0
morinda citrifolias	biliary calculi	0
zingiber officinale	chronic fatigue-fibromyalgia syndromes	0
spore	colonic neoplasm	0
saint john wort	malaria	0
assai palm berry	muscular rheumatism	0
texturized vegetable protein	renal neoplasm	0
convenience food	age-related maculopathies	0
regular olive	delusory parasitosis	0
deli meat	diffuse mixed small and large cell lymphoma	0
portulaca	philadelphia-negative myeloid leukemia	0
nutriceutical	blood clots	0
gui zhi	mixed lymphocytic-histiocytic lymphomas	0
areca nuts	benign essential tremors	0
aspalathus	undifferentiated lymphoma	0
leguminosae	spatial memory disorder	0
beta vulgari	small noncleaved-cell lymphomas	0
pumpkin seeds	corpse	0
bitter nightshade	gossypiboma	0
anacardium	barrett syndrome	0
eugenia caryophyllata	pulmonary disease	0
da huang	insulin resistance	0
goiaba	udp galactose 4 epimerase deficiency	0
lycium barbarum	gorlin syndrome	0
safflower oil	social anxiety disorder	0
taraxacum officinale	delusory parasitoses	0
glucose fructose syrup	atrophy	0
legume pod	human papillomavirus virus	0
cod	frontal region trauma	0
iceberg lettuce	spindle cell sarcoma	0
grapefruit	leucocythaemia	0
sesame seeds	idiopathic polymyositis	0
dioscorea villosa	acquired blindness	0
syzygium cumini	spinal cord disease	0
origanum majorana	gassers syndrome	0
apple trees	brain benign neoplasm	0
rheum officinale	human herpesvirus 4 (gamma)	0
muffin	autistic disorder	0
pineapple juice	lobar pneumonias	0
chicken	pregnancy-induced diabetes	0
hickory trees	acute monoblastic leukemias	0
nut butter	delusory parasitosis	0
lentinus edodes	semirhythmic tremor	0
drinking coffee	orthostasis	0
soy beverages	global amnesia	0
deli meats	cognitive dysfunction	0
food poisonings	preventable cancers	0
vodka	lung cancers	0
pimenta	psychophysiological insomnia	0
chicken meat	germinoblastic sarcomas	1
hypericum	neoplasm metastasis	0
mentha	kidney diseases	0
aloe vera	breast fibrocystic disease	0
hawthorn	social anxiety disorder	0
poultry product	human mammary carcinomas	0
nitrate-rich vegetables	brain conditions	0
rubberplant	substance abuses	0
flowering shrub	male sterility	0
hickory tree	meningiomatose	0
favorite meals	lichen ruber planus	0
undercooked meat	aids viruses	0
bibhitaki fruit	smell disorder	0
mastic tree	foodborne diseases	0
beer	pleomorphic lymphomas	0
plantago arenaria	global amnesia	0
toxic plants	somatosensory seizures	0
raw broccoli	pediatric obesity	0
study lavender	macular dystrophy	0
sweet peppers	temporal region traumas	0
curried tofu	seasickness	0
color	insulin-dependent diabetes mellitus 1	0
lima beans	chronic pains	0
green pepper	remittent fever	0
carob	brain vascular accident	0
use sweeteners	cancer of the thyroid	0
greenery	study cancer	0
processed meats	abdominal pain	0
sell meat	hemolytic jaundice	0
citrus aurantium	creutzfeldt jacob disease	0
serve	delusional parasitosis	0
texturized vegetable proteins	rabies viruses	0
flavorer	gastroesophageal reflux disease	0
ocimum sanctum	sick headache	0
hemp plants	peanut allergies	0
soft drink	intracranial neoplasm	0
soda water	convulsive syncope	0
cola	weight loss	0
cicer	deep vein thrombosis	0
mentha piperita	epithelial cancers	0
poenumgraecum	esophagus cancers	0
lemon verbena	necrotizing fascitis	0
exotic fruits	aphthous stomatitis	0
amorpha	cardiac arrhythmia	0
fiddlehead ferns	liver injury	0
catfish	essential tremor	0
dietary fats	manic state	0
rheum rhaponticum	diabetes complications	0
citrus paradisi	aura	0
fragaria	emphysema	0
rubus glaucus	type 1 diabetes mellitus	0
pretzel	liver dysfunction	0
sesamum	prion diseases	0
soymilk	autosomal dominant. juvenile parkinson disease	0
durum wheat	small non-cleaved-cell lymphoma	0
hydroponic basil	primary brain neoplasm	0
plum trees	zoonotic infections	0
organic meat	sid	0
cherry	ciguatera poisonings	0
rise	reversing chronic disease	0
red delicious apples	allergy	0
salsa	brains cancer	0
myristica fragran	posterior fossa meningiomas	0
teosinte	uterus cancers	0
club soda	low-grade b-cell malignancy	0
pisum sativum	cardiac arrhythmias	0
individual candy	mammalgia	0
lemon balm tea	impaired sensations	0
unrefined plant	crohn's enteritis	0
wild yams	transmissible spongiform encephalopathy	0
golden delicious	histamine cephalgia	0
carya illinoensis	cancer of endometrium	0
shorten	insomnia disorder	0
yerba mates	brain neoplasm	0
emphasizes vegetables	fine tremors	0
petroselinum crispums	gallbladder diseases	0
cycad trees	amyloid deposits	0
amomum cardamomum	bse (bovine spongiform encephalopathy)	0
cooked meats	hysterical amnesias	0
bertholletia excelsas	coronary diseases	0
usda poultry	chronic lymphocytic leukemia	0
pistacia lentiscus	hypoascorbemia	0
frozen spinach	strain	0
shiitake mushroom	vulva cancers	0
eragrostus	penis neoplasms	0
whole foods	gehrigs disease	0
low-salt diet	oral neoplasm	0
molasse	common cold	0
plantago	retained surgical item	0
bamboo shoots	degenerative intervertebral disc	0
maize syrup	allergic reaction	0
antioxidant foods	todds paralysis	0
pumpkin pie	intention tremors	0
euchresta	deep vein thromboses	0
yerba mate	acute inflammatory polyneuropathies	0
glycyrrhiza	head pains	0
english walnuts	blood clots	0
molasses	myocardial ischemia	0
pepsi	neurologic degenerative conditions	0
tumeric	non-hodgkin lymphoma	0
squash plants	udpglucose 4-epimerase deficiency disease	0
curcuma zedoaria	blindness	0
gooseberry	metabolic acidoses	0
bolete	hip fractures	0
avenas	postoperative emesis	0
healthiest vegetable	acute infectious polyneuritis	0
bertholletia excelsa	gall bladder disease	0
citrus hystrices	nasal cavity cancer	0
apricot	prostate neoplasms	0
fenugreek	cancer of the stomach	0
fungus	tumor viruses	0
flax seeds	carcinoma of endometrium	0
squash	crushing pain	0
kola nut	open head injury	0
kombucha teas	abdominal aortic aneurysm	0
fed beef	diabetic amyotrophies	0
althea officinalis	atrioventricular dissociations	0
candy	diabetic autonomic neuropathies	0
kawa kawa	drug hypersensitivities	0
dietary fiber	type i diabetes mellitus	0
açai berry	drop attacks	0
mother cell	syncopal vertigo	0
cola acuminata	esophagus cancers	0
shan yaos	mixed lymphocytic-histiocytic lymphomas	0
raw garlic	oncogenese	0
including cloves	leiomyoma	0
sweet marjorams	neoplasm metastases	0
dandelion	cot deaths	0
raw tomatoes	back aches	0
almond butter	abdominal migraine	0
red peppers	spondylitis ankylopoietica	0
sweetened cereal	small non-cleaved-cell lymphomas	0
energy drinks	regional ileitis	0
chickpea	acute inflammatory polyradiculoneuropathy	0
citrus reticulata	hepatocellular cancer	0
celeriac	familial creutzfeldt-jakob disease	0
mustard oil	rabies virus	0
tuna	type c oncovirus	0
caryophyllus aromaticus	diabetic asymmetric polyneuropathy	0
root	bilateral sciatica	0
tempeh	tonsil neoplasms	0
pancake	semirhythmic tremor	0
osmanthus	bacterial vaginitides	0
peppermint	kidney cancers	0
kiwi fruit	alopecia cicatrisata	0
machaerium	reduced sensations	0
sun-dried raisin	kidney cancer	0
asparagus	lumbago	0
healthy snacks	sclerosis	0
split pea	udp-galactose-4-epimerase deficiency disease	0
hot peppers	influenza in human	0
croaker	thyroid neoplasms	0
tree nuts	mottled enamels	0
butter	intractable headache	0
shellfish	male subfertility	0
soy bean proteins	cardiac dysrhythmia	0
portulaca oleracea	human cancer	0
mustard plant	johnes disease	0
sweet almonds	prostate cancer	0
prunus dulcis	paraesophageal hernias	0
meal times	hemangiopericytic meningiomas	0
dark chocolate	stomach neoplasm	0
chamomile oils	mechanical low back pain	0
lettuce	ciguatera poisonings	0
assai palm berries	ovarian neoplasms	0
saffron crocus	galactose 1 phosphate uridyl transferase deficiency disease	0
rosemary	vulva cancers	0
hickory nut	arrhythmia	0
food poisoning	disseminated sclerosis	0
red meat	autism	0
collard green	myocardial ischemia	0
zedoary zedoarias	leukemogenic virus	0
consumed chocolate	lewy body parkinson disease	0