
norovirus food	bovine leukemia	0
anti-inflammatory foods	brain disorder	0
chinese cassias	inflammatory bowel disease 1	0
linum usitatissimums	paraesophageal hiatal hernia	0
pumpkin pie	chest pain	0
dried fruit	epithelial cancers	0
carica	barretts esophagus	0
goiaba	rodent ulcer	0
sea vegetable	breast cystic disease	0
illicium	brain benign neoplasm	0
rheum officinale	necrotizing fascitis	0
grape juice	male infertility	0
chinese yam	feminization	0
cooked carrots	nontropical sprue	0
brazil nut tree	precordial catch syndrome	0
rose	suppuration	0
dinner	bilateral sciaticas	0
milk protein	feline lymphoma viruses	0
low-fat diet	disc degeneration	0
split peas	persistent atrial fibrillations	0
english walnut	medical conditions	0
canned food	human herpesvirus 4	0
java plum trees	chronic fatigue-fibromyalgia syndrome	0
wine	alopecia cicatrisata	0
lard	epithelioid sarcomas	0
chai tea	lung inflammation	0
rise	nontropical sprue	0
turmeric root	throbbing headache	0
sea bilberry	postural syncope	0
chlorella	cerebrovascular accidents	0
pickled foods	spiral fractures	0
coriandrum sativums	inappropriate growth hormone secretion syndrome (acromegaly)	0
vegetable oil	renal calculi	0
eggnog	vulva cancers	0
assai palm berry	enzootic bovine leukoses	0
citrus aurantiifolia	venereal warts	0
fermented foods	transmissible dementias	0
opium poppies	ocular headaches	0
flavorer	focal seizure	0
marsh mallow	diabetes complication	0
healthiest beverage	penis neoplasm	0
black tea	e-b virus	0
contamination meat	auditory seizure	0
conventional food	non-hodgkin lymphoma	0
citrus hystrix	rest tremor	0
crataegus monogynas	gall stone	0
sea food	heat strokes	0
butter	splitting pains	0
silybum marianums	situational syncope	0
cinnamomum trees	diabetes mellitus complication	0
rubus idaeus	colonic neoplasms	1
cannabis	spondylitis ankylopoietica	0
crab apples	cancer of stomach	0
grape	aortic aneurysm	0
apium graveolens var. rapaceum	xanthomatous meningioma	0
morning meal	foodborne disease	0
chinese cassia	parkinsonism	0
mustard plants	bone fracture	0
hickory trees	colonic neoplasm	0
fortify milk	canker sore	0
eugenia malaccensis	meningioma	0
citrus reticulatas	chromosome 6-linked autosomal recessive parkinsonism	0
applesauce	viral diseases	0
apricot	breast cancers	0
pistil	non b hepatitis epidemic non a	0
fatty meal	protein deficiencies	0
mirobalanus embilicas	barretts syndrome	0
refined olive	retained surgical items	0
brewed coffee	tussive syncopes	0
cucumis sativus	bacterial infection	0
cookie	occipital region traumas	0
philadelphia cream cheese	schizophreniform disorders	0
warm milk	effort syncopes	0
corn oils	auditory seizure	0
chewing gums	disseminated sclerosis	0
soft drink	galactose 1 phosphate uridyltransferase deficiency	0
chinese food	testis cancer	0
pomegranate fruit	irritable bowel syndromes	0
cicer arietinums	bowel disease	0
frequent meals	cancer of the endometrium	0
breakfast cereals	neurological condition	0
dressing	familial dementias	0
watermelon	inner ear cancer	0
peppermint oil	head traumas	0
cannabis sativa	cancer of the kidney	0
commercial milk	endometrial carcinomas	0
sesame oils	numbness	0
narrow-leaved plantains	age related maculopathy	0
chilli peppers	human t-cell lymphotropic virus type iii	0
plant-based foods	phlebothrombosis	0
fake meat	endemic cretinism	0
celeriac	fibrosis	0
added sweeteners	crushing skull injuries	0
raw cranberries	idiopathic parkinson's disease	0
fuji apples	senile plaque	0
plant aril	galactose-1-phosphate uridyl-transferase deficiency disease	0
miso	vaginal discharges	0
olive tree	smell disorders	0
jambolan plum trees	substance use disorders	0
soy beans	tick bites	0
purple rice	parkinsonian syndrome	0
milk chocolate	intractable headache	0
breakfast	spindle cell sarcoma	0
oregano	kanner syndrome	0
no coffee	inflammatory bowel diseases	0
family vegetables	wound botulism	0
gui zhi	colorectal carcinoma	0
secale	phlebothrombosis	0
fresh basil	jacksonian seizure	0
coca	myocardial infarcts	0
cocoa plant	angiomatous meningiomas	0
processed foods	intracranial meningioma	0
syzygium malaccense	thyroid neoplasm	0
black walnuts	growth hormone receptor defect	0
red rice	pediatric cancers	0
colorful foods	olfactory groove meningioma	0
coconut	intermediate-grade lymphomas	0
soda waters	carotid sinus syncope	0
citron trees	inflammatory polyneuropathy acute	0
organic foods	marsh fever	0
persimmon	insomnia disorder	0
eupatorium rebaudianums	sleep wake disorders	0
agent orange	retained surgical tool	0
sweetleaf	menstrual pains	0
origanum vulgare	zoonotic diseases	0
horse nettles	pulmonary thromboembolism	0
peanut	johnes disease	0
raphanus	utp hexose 1 phosphate uridylyltransferase deficiency disease	0
baby formula	weight loss	0
porphyra	b-cell chronic lymphocytic leukemia	0
citrus medica	adenovirus	0
triticum vulgare	udp-galactose-4-epimerase deficiency	0
allium sativum	breast tumors	0
margarine	autism	0
cider vinegar	basal cell epitheliomas	0
horse beans	joint diseases	0
fabaceae	lung inflammation	0
include fennel	lewy body parkinson's disease	0
beta vulgari	lens opacities	0
baby spinach	histamine cephalgias	0
biometal	throbbing headaches	0
carica papaya	insomnia	0
cassia fistula	lymphadenopathy-associated viruses	0
healthiest fruits	clonic seizures	0
preserved food	mouth neoplasms	0
fagopyrum	galactokinase deficiency diseases	0
prunus salicina	heart attacks	0
inadequate fruit	wheat allergies	0
diospyro	lead poisoning	0
bilberry	amnesia memory loss	0
grapefruit juice	headache syndrome	0
alcohol	idiopathic intracranial hypertension	0
soybean	polyradiculoneuritide	0
cocoa powders	voice box cancer	0
vaccinium uliginosum	galactosemia iii	0
oregano plants	hypoesthesia	0
cauliflower	coronary heart disease	0
areca catechu	human t cell lymphotropic virus type iii	0
food company	memory losses	0
triticum turgidum	galt deficiency	0
sparkling water	cerebral convexity meningioma	0
sea vegetables	painful menstruation	0
carya illinoenses	angioblastic meningioma	0
tempeh	chicken embryo lethal orphan virus	0
antioxidant foods	legal blindness	0
soy	galactosemia 2	0
cabbage	age related osteoporosis	0
baptisia	tumor	1
contaminated foods	human mammary carcinomas	0
anise tea	idiopathic polymyositides	0
cucumis melo	creutzfeldt jakob syndrome	0
betel	charcot disease	0
peanut butter	dairy product intolerance	0
restrict food	ciguatera poisonings	0
taro	polyp	0
vaccinium bracteatum	water stress	0
organ meats	clonic seizure	0
rowanberry	colon cancer	0
not-necessarily-so-healthy foods	deficiency diseases	0
cola acuminata	nonhodgkins lymphoma	0
lemon trees	prostatic neoplasms	0
carbonated mineral waters	diffuse lymphoma	0
golden glow	olfactory seizure	0
food manufacturers	developed cancer	0
soy proteins	common bile duct gallstones	0
undercooked meat	seasickness	0
marjoram	rabies virus	0
dioscorea polystachya	cataract	0
wild celeries	laron type dwarfism i	0
yerba mate	atopic disease	0
jerusalem artichokes	obesity virus	0
olea europaea	norwalk like viruses	0
pisum sativum	pediatric cancers	0
plant arils	paraesophageal hernias	0
crocus sativus	deep-vein thrombosis	0
dried yeast	osteoarthrosis deformans	0
plantago arenaria	ekbom delusional parasitosis	0
green grapes	pulmonary diseases	0
acer	lymphadenopathy associated virus	0
ocimum tenuiflorum	uterine cervical cancer	0
chewed coca	upper respiratory infections	0
glycyrrhiza	regional ileitides	0
lentinus edodes	acquired immunologic deficiency syndrome	0
high-fructose corn	muscle tremors	0
cooking meat	limb cramps	0
vaccinium myrtillus	epithelioid sarcomas	0
walnut	convulsive syncopes	0
horsenettle	e-b viruses	0
new york coalition for healthy school food	extreme hearing loss	0
acer negundos	somatotropin hypersecretion (acromegaly) syndrome	0
canned fruit	parodontose	0
swordfish	chromosome 6-linked autosomal recessive parkinsonism	0
lycium chinense	chicken embryo lethal orphan virus	0
retail poultry	bacterial infections	0
crabapple	pulmonary disease	0
maize oil	acute cerebrovascular accidents	0
red meat	intractable headache	0
hemlock	sliding esophageal hernias	0
legume pod	low-grade b-cell malignancy	0
vegetable juices	bone fractures	0
garlic	saturnine tremors	0
nut bars	hepatocellular cancer	0
boiled eggs	colon cancers	0
dried food	decreased cancer	0
big apples	retained surgical item	0
happy meal	laron dwarfism	0
added nuts	galactose 1 phosphate uridylyltransferase deficiency	0
syzygium aromaticum	male sexual impotence	0
foodstuff	liver neoplasms	0
rubus fruticosus	bacterial vaginosis	0
rooibos	manic states	0
triticum	small cleaved-cell lymphoma	0
calendula	sharp headache	0
chanterelle	fibrous meningiomas	0
find pork	acute inflammatory polyradiculoneuropathies	0
different seed	mastodynia	0
abelmoschus	vaginal neoplasms	0
horsemeat	dissociative amnesia	0
feather meal	common bile duct gall stones	0
solanum	pulmonary thromboembolism	0
horsebean	blood clot	0
yolk	abdominal pain	0
whale meat	renal neoplasm	0
espresso	hiv	0
tea plant	high-grade lymphomas	0
fenugreek seed	colorectal carcinoma	0
burrito	air sickness	0
apple trees	psammomatous meningioma	0
ready-prepared foods	epilepsy	0
sour orange tree	viral infections	0
frozen broccoli	mixed lymphocytic histiocytic lymphoma	0
soy beverage	hemorrhage	0
hot pepper	gastroesophageal reflux	0
soy protein	cancer of the testes	0
wolfberry	prostatic cancers	0
corn sugar	iron deficiency	0
secale cereale	parkinsonian diseases	0
know nuts	myalgic encephalomyelitis	0
little saffron	nonalcoholic steatohepatitides	0
assai palm berries	stomach ulcer	0
sesame oil	generalized headaches	0
english plantains	fibrous meningioma	0
colocasia	diffuse myofascial pain syndrome	0
mentha x piperita	atherosclerotic plaques	0
anise seed	oral disease	0
psidium	iron deficiency	0
anana	philadelphia-negative myeloid leukemias	0
mentha piperita	osteoporose	0
soda pops	cancer of the esophagus	0
silybum marianum	spindle cell carcinoma	0
solanum laciniatums	autosomal dominant juvenile parkinson disease	0
trigonella foenum-graecum	transmissible dementias	0
bad foods	crushing pains	0
black pepper	resting tremors	0
pinto beans	peanut allergy	0
edible grains	near-death experience	0
pasta	ekbom delusional parasitoses	0
cinnamomum aromaticum	spontaneous abortion	0
solanum tuberosums	hyperemesis gravidarum	0
official vitamin	cancer of pancreas	0
kaffir lime	status migrainosus	0
alfalfa sprout	static tremors	0
roundup-ready soybeans	galactosemia	0
fryer	ovary cancer	0
oreo	b cell leukemia	0
bamboo shoots	light-headedness	0
antioxidant-rich food	non-hodgkin's lymphoma	0
junk foods	ciliary neuralgia	0
croaker	reticulum-cell sarcoma	0
snack foods	clear cell meningiomas	0
lima beans	frontal region traumas	0
cherry plum tree	chronic fatigue syndrome	0
dioscorea batatas	small-cell lymphomas	0
arginine-rich foods	oncovirinae	0
pimenta diocias	manic disorder	0
scrambled eggs	generalized headaches	0
mashed potatoes	preinvasive carcinoma	0
butter milk	prediabete	0
althaea officinalis	phage	0
zedoary zedoarias	myocardial infarct	0
pinto bean	urinary bladder neoplasms	0
fat milk	gastroesophageal reflux	0
salsa	osteoporosis	0
bell pepper	infant gynecomastia	0
crab apple	parkinsonism dementia complex of guam amyotrophic lateral sclerosis	0
ilex paraguarienses	female infertility	0
halibut	cluster headache syndrome	0
turkey meat	amyotrophic lateral sclerosis-parkinsonism-dementia complex 1	0
yam	paraesophageal hiatal hernias	0
peach tree	syncope	0
tobacco	developed cancer	0
plantain	hiccup	0
acaí berries	saturnine tremor	0
snail meat	prostatic cancer	0
leaf lettuce	limb tremor	0
cola	prostate cancer	0
thyme	osteoarthrosis deformans	0
nutraceutical	fibrositis	1
willow tree	periodontal diseases	0
sticker	vaginal discharges	0
eugenia caryophyllata	kanner syndrome	0
bran flakes	hereditary essential tremor	0
caffeinated coffee	lav-htlv-iii	0
vitis vinifera	rickets	0
eragrostus	acute inflammatory demyelinating polyradiculoneuropathy	0
raw foods	smell disorder	0
chinook salmon	tick bites	0
pomelo trees	gall stone	0
paprika	cephalalgia	0
tachigalia	gut dysfunction	0
fruit juices	torsion fractures	0
cymbopogon nardus	atheromatous plaques	0
fiddlehead ferns	physical anhedonias	0
indian corn	reducing cancer	0
norus	laron dwarfism	0
portulaca oleracea	serious disease	0
papaya	leprosy	0
papaver	alzheimer’s disease	0
ovary	muscular cramp	0
candy	atheroma	0
adding blueberries	weight reductions	0
emblica officinali	crohn's disease	0
international nut	deglutitional syncopes	0
citrus fruit	obesity virus	0
deep-fried foods	amnesia memory loss	0
pummelo trees	kidney cancers	0
eragrostis	sprue	0
healthiest foods	prostatic neoplasm	0
retail meat	ekbom dermatozoic delusion	0
almond milk	fibroatheroma	0
big meals	sleeplessness	0
carya	aphthous ulcers	0
eating meat	ankylosing spondylitis	0
flax seeds	cluster headache	0
humulus lupulus	congenital myxedema	0
origanum majorana	inhibit cancer	0
bread mold	early awakening	0
origanum onites	intermittent tremors	0
toxic plants	sub-fertility	0
apium graveolens var. dulce	asymmetric diabetic proximal motor neuropathy	0
concord grape	lav-htlv-iii	0
amomum cardamomums	body weights	0
pea	cancer of liver	0
antioxidant food	bipolar affective psychoses	0
convenience foods	chronic b lymphocytic leukemia	0
petroselinum	perioral tremors	0
dietary supplements	muscle pains	0
carbonated water	postoperative emeses	0
lemon grass	gastro-oesophageal reflux	0
mandarin orange tree	jakob creutzfeldt disease	0
goji berry plants	impaired sensations	0
citrus fruits	epimerase deficiency galactosemia	0
vaccinium macrocarpon	craniocerebral injury	0
common bean plant	cerebrovascular accidents	0
jalapeno	torsion fracture	0
natural vitamin	type i diabetes mellitus	0
oolong tea	mixed lymphoma	0
plum	microglandular adenoses	0
chestnut	vitamin deficiencies	0
chocolate	chromosome 6 linked autosomal recessive parkinsonism	0
mastictree	rectal cancers	0
malus domestica	intermediate-grade lymphoma	0
carrot	bronchiolitis	0
medicago sativa	prostate neoplasm	0
box elders	physical suffering	0
artichoke	disc degenerations	0
bottled water	diffuse mixed-cell lymphoma	0
sunfish	galk deficiencies	0
veggie	atheromatous plaques	0
jasmine tea	atypical cluster headache	0
andira	small noncleaved-cell lymphoma	0
regular olive	steatosis of liver	0
cardamon	physical anhedonias	0
mealtime	osteoarthritide	0
red onions	mucous colitis	0
pea family	aortic aneurysms	0
apium graveolens	papillary meningiomas	0
capparis	neurologic degenerative diseases	0
thymus plants	rna tumor viruses	0
dairy products	paroxysmal atrial fibrillation	0
dried apple	pharyngitide	0
poenumgraecum	anxiety disorder	0
sorrel	open head injury	0
linseed	micturition syncope	0
marsh mallows	gorlin-goltz syndrome	0
milk thistles	mad cow diseases	0
vitis	cancer of penis	0
lemon	left-sided heart failure	0
pleurotus	pregnancy pernicious vomiting	0
raw food	malignant brain neoplasm	0
hibiscus	primary brain tumor	0
convenience food	vulva cancers	0
watercress	dizzyness	0
sweetening agents	psychogenic parasitosis	0
restructured meat	aphthous ulcers	0
raw broccoli	rectal cancer	0
granny smith	atrioventricular dissociation	0
blueberry plants	retained surgical instruments	0
emphasizes vegetables	endometrial neoplasm	0
ground meat	somatotropin hypersecretion (acromegaly) syndrome	0
ice creams	drug use disorders	1
fenugreek seeds	low backaches	0
allium porrum	different cancer	0
rheum tanguticum	dehydration	0
foenumgraecum	textiloma	0
tap water	heart decompensation	0
osmanthus	anthrax	0
maple syrup	sprue	0
portulaca oleracae	brain disorder	0
cultivated oats	open head injury	0
theobroma cacao	physical sufferings	0
drink tea	rna tumor virus	0
diabetic diets	premenstrual syndromes	0
citrus grandi	resting tremor	0
vinegar	limb cramps	0
lunch time	hyperemesis gravidarum	0
daily fruit	diabetes mellitus complication	0
prunus armeniaca	landry guillain barre syndrome	0
chinese cinnamons	convulsive seizures	0
iv vitamin	acute monocytic leukemias	0
soy foods	disc degenerations	0
red wine	cancer viruses	0
afzelia	male sub fertility	0
supper	anaplastic carcinomas	0
cherry plum trees	tactile hypesthesias	0
euterpe	gossypiboma	0
saint johnswort	uterus cancer	0
calendula officinali	wheat allergies	0
black currants	polymyositis	0
sun-dried raisin	pus	0
carbonated beverage	chronic headaches	0
zea mays	senile plaque	0
healthier foods	anticancer	0
acer negundo	auriculo-ventricular dissociations	0
food and drug administration	diffuse small cleaved cell lymphoma	0
ganja	uterine neoplasms	0
pithecolobium	syncopal episodes	0
plant zygotes	eczematous dermatitis	0
individual food	galactose epimerase deficiency	0
avocado fruit	biliary calculi	0
cycad	zoonotic infection	0
black walnut	vaginal neoplasm	0
healthiest snack	broken bone	0
mentha spicata	fibroadenoma	0
agave	graves disease	0
filtered coffee	limb cramps	0
pithecellobium	ciliary neuralgias	0
maize	biliary calculi	0
chewing fruit	influenza	0
experience food	sudden-onset diabetes mellitus	0
cooked meats	fibroid tumor	0
bagel	hypermelanose	0
shoot	congenital defects	0
fragaria vesca	endometrioma	0
apricot tree	paroxysmal atrial fibrillation	0
romaine lettuce	bipolar disorders	0
apple juice	vulva neoplasm	0
dairy eggs	craniocerebral trauma	0
dietary supplement	spinal meningiomas	0
white rice	nonspecific vaginitis	0
little meat	cervical migraine syndromes	0
nutmeg	prostate disease	0
curcuma zedoaria	intervertebral disk degeneration	0
marjoram plants	viral infection	0
good soybeans	nasal cavity cancer	0
snack	mental disorders	0
dark meat	endometrium cancer	0
eden foods	abdominal cramp	0
squid	vulva cancers	0
mustard	psychogenic parasitosis	0
cheese	spiral fractures	0
mussel	sleep initiation dysfunctions	0
ribe	ankylosing spondyloarthritis	0
pecan tree	hepatitis e	0
lime	diabetic amyotrophies	0
plant capsule	episodic cluster headaches	0
almond trees	substance abuses	0
flammulina	lyme arthritis	0
arachis hypogaea	dyschezia	0
soy bean	diabetes-related complication	0
monosodium glutamate	polyradiculoneuritis	0
individual candy	endothelial dysfunction	0
euchresta	human influenzas	0
paella	basal cell nevus syndrome	0
cocos nuciferas	limb cramps	0
justicia	respiratory tract infection	0
amygdalus communis	alopecia cicatrisata	0
cod	lichen ruber planus	0
club sodas	penis cancer	0
betel nut	olfaction disorders	0
solanum tuberosum	head trauma	0
last meal	iodine deficiency	0
potato	feline lymphoma virus	0
apricot trees	macular degenerations	0
group foods	sleeplessness	0
oyster mushroom	sub-fertility	0
millet	inappropriate gh secretion syndrome (acromegaly)	0
brassica	microcephaly	0
soy bean proteins	diabetes mellitus complications	0
dragon fruit	parkinsonism dementia complex of guam amyotrophic lateral sclerosis	0
dietary fiber	germinoblastic sarcoma	0
adhatoda vasica	schizoaffective disorders	0
barberry	intraepithelial neoplasms	0
four nuts	anaplastic carcinoma	0
cassia cinnamon	hair losses	0
ocimum basilicum	gale deficiency	0
sardine	benign prostatic hypertrophy	0
eggplant	irritable colon	0
onion	plasma-cell myeloma	0
high fructose maize syrup	malignant brain neoplasm	0
glucose-fructose syrup	male pattern baldness	0
marjoram plant	hiatal hernia	0
poroporo	delusory parasitosis	0
american meat	abdominal obesities	0
high-fructose maize syrup	reduced sensations	0
salt-free diet	cellulite	0
tepary bean	colonic cancer	0
ready prepared foods	blood cancer	0
popcorn	galactose-1-phosphate uridylyltransferase deficiencies	0
tuna fish	gnathostomiasis	0
swiss chard	generalized headache	0
malabar-nut	sliding esophageal hernias	0
white mallow	paraesophageal hiatal hernias	0
soup	proteinuria	0
salami	malignant melanoma	0
food allergy	small round-structured viruses	0
kangaroo meat	secondary insomnia	0
multivitamin	norovirus	0
poppy	microglandular adenoses	0
aspartame	apoplexy	0
turmeric	inflammatory polyneuropathy acutes	0
use sweeteners	chronic daily headache	0
black raspberries	carotid sinus syncopes	0
frozen fruit	forehead trauma	0
leguminosae	aphthous ulcer	0
citrus sinensis	nonalcoholic steatohepatitides	0
crowberry	graves disease	0
sweeten	osteoarthrosis deformans	0
dried pomegranate	atypical cluster headache	0
cocoa butter	visual seizures	0
nicotiana	male breast tumors	0
atropa belladonna	pharyngitide	0
brinjal	subacute spongiform encephalopathy	0
spaghetti	diabetic mononeuropathies	0
tea leaves	endometrium carcinomas	0
lentil	mental deterioration	0
prunus amygdalus	small cell lymphoma	0
dietary proteins	growth hormone receptor deficiency	0
mesquite	cerebral strokes	0
raisin	cancer of kidney	0
cherry	galactokinase deficiencies	0
seville orange tree	common bile duct gall stones	0
beetroot	ovarian neoplasms	0
brewing tea	monoblastic leukemia	0
ocimum basilicums	non hodgkin's lymphoma	0
floret	hepatitis	0
saffron	spongiform encephalopathies	0
cucurbita	acute fulminating multiple sclerosis	0
table salt	lichen rubra planus	0
chile pepper	diabetic amyotrophies	0
decaffeinated tea	sarcoma	0
marihuana	periodontal diseases	0
solanum lycopersicum	acidosis	0
white wine	osteoarthrosis	0
eat chocolate	hemolytic uremic syndrome	0
soda water	sliding esophageal hernias	0
garbanzo	essential tremors	0
pecan trees	intertrochanteric fractures	0
wild bananas	oncogenic virus	0
lemongrass	cerebral convexity meningiomas	0
reason food	male breast tumors	0
beef	brain disease	0
empty calorie foods	retroviridae	0
low-calorie diet	dna injury	0
hibiscus tea	acute inflammatory polyradiculoneuropathy	0
carya illinoensis	subacute spongiform encephalopathies	0
dried cranberries	diffuse mixed cell lymphoma	0
carbonated drinks	bladder tumors	0
sea bilberries	temporal region trauma	0
berry	nonhodgkins lymphoma	1
specific foods	nerve tremor	0
unhealthy food	blood cancers	0
cold-steeping tea	pancreatic cancers	0
kawa	bovine leukemia virus	0
safflower	degenerative neurologic diseases	0
citrus sinenses	polyphagia	0
milk thistle	nonalcoholic fatty livers	0
cereal	acute stroke	1
celery root	thyroid cancers	0
leafy vegetables	gustatory seizure	0
purple potatoes	chronic cystic mastitis	0
dairy product	amyloid deposits	0
eating broccoli	progressive disorder	0
measuring food	deglutitional syncopes	0
cranberry sauce	oncogenesis	0
nuclear power plant	diabetes complications	0
component spices	guillain-barre syndrome	0
specific cheeses	b cell chronic lymphocytic leukemia	0
golden raisins	laron syndrome	0
coco	chronic pains	0
soda pop	hypercapnia	0
apple tree	back aches	0
cantaloupe	cancer of skin	0
sweet basil	bipolar disorder	0
prettiest fruit	paraesophageal hiatal hernia	0
gum acacia	light headedness	0
noni fruit	crushing pain	0
exotic fruit	joint pain	0
digitalis	growth hormone receptor defect	0
hickory tree	prostatic hypertrophy	0
sweetening agent	diabetic complication	0
flesh foods	cephalgia	0
candy bars	fine tremor	0
ephedra	prostate cancers	0
raphanus raphanistrum	contagious pustular dermatitides	0
sweet almonds	coronary disease	0
chili peppers	basal cell carcinoma	0
banana plants	abdominal migraines	0
bibhitaki fruit	human t-lymphotropic virus type iii	0
chinese rhubarb	a v dissociation	0
chenopodium quinoa	hypercapnia	0
plum trees	meningotheliomatous meningioma	0
nonfat meal	biliary calculi	0
frosting	autosomal recessive parkinsonism	0
consumer protection scientific committee on food	intraepithelial carcinoma	0
lens plants	endometrial cancer	0
cinnamomum verum	ph1 negative myelogenous leukemia	0
safflower oils	tussive syncope	0
açai berry	bovine lymphomas	0
woodland strawberry	genital warts	0
syzygium cumini	guam disease	0
frozen cranberries	periorbital headache	0
cannabis indicas	low-grade lymphomas	0
ready soybeans	epimerase deficiency galactosemia	0
foeniculum vulgares	penile cancer	0
eugenia jambos	cephalgia syndrome	0
dietary plant protein	tactile hypesthesias	0
bt corn	fifth phacomatoses	0
sugary foods	esophageal neoplasms	0
whole grain cereals	headache syndromes	0
drinking milk	senile plaque	0
flammulina velutipes	food-borne illnesses	0
lemon tree	schizophrenic disorder	0
squash seeds	somatotropin hypersecretion (acromegaly) syndrome	0
da huang	sleep-related neurogenic tachypneas	0
bitter orange tree	prostate disease	0
animal-based vitamin	human t cell lymphotropic virus type iii	0
incorporate cloves	joint diseases	0
syrup	angioblastic meningiomas	0
vaccinium virgatum	campylobacter infections	0
infant formulas	lou gehrig disease	0
fresh fruits	unhealthy conditions	0
poultry products	head pains	0
unfertilized eggs	thermal hypesthesia	0
cola nitida	atrophy	0
low vitamin	lower back pains	0
scallion	breast neoplasm	0
club soda	chronic illness	0
unfiltered coffee	metastatic cancer	0
acer saccharums	oral neoplasm	0
ready-prepared food	parkinsonism-dementia complex of guam amyotrophic lateral sclerosis	0
hibiscus cannabinus	senile osteoporoses	0
goji berry	regional enteritis	0
sugar substitutes	autoimmune diabetes	0
maize syrup	chronic fatigue and immune dysfunction syndrome	0
chamomile oils	endometrioma	0
nutriceutical	age-related osteoporoses	0
raw tomatoes	bacteriophage	0
roasted almonds	sarcoma	0
triticum aestivum	hemicrania migraines	0
dietary sugars	bovine leukosis	0
piper nigrum	superficial head injuries	0
narrow-leaved plantain	idiopathic parkinson disease	0
billion eggs	hypercapnia	0
bread	grippe	0
meal times	appendicitis	0
coca cola	leucocythaemia	0
stem vegetables	celiac sprue	0
broad beans	rectum cancer	0
lavender	urinary bladder neoplasms	0
phaseolus acutifolius	parkinsonian disorders	0
dried apples	familial creutzfeldt-jakob diseases	0
isoglucose	degenerative intervertebral discs	0
low-salt diet	virus disease	0
dried foods	symptom clusters	0
mint	infantile autism	0
tv dinners	abdominal cramp	0
japanese plum	rectal cancer	0
own vitamin	asthma	0
hot peppers	age-related memory disorders	0
sweet orange	mammalgia	0
fat foods	liver steatosis	0
punica granatum	cervical cancer	0
mock meats	insulin deficiency	0
amomum cardamomum	spasm	0
mangifera	parkinson's disease	0
color	senile osteoporoses	0
squash	rectal tumors	0
euterpe oleracea	headache syndromes	0
foeniculum vulgare	cancer of breast	0
wisconsin milk	reticulosarcoma	0
chicken salad	parkinsonian disorders	0
prunus cerasifera	galactose 1 phosphate uridyl transferase deficiency disease	0
nitrate-rich vegetables	oxygen deficiency	0
drinking water	pancreas neoplasm	0
shiitake mushrooms	increase cancer	0
thousand foods	tonic seizures	0
alfalfa	fatty liver disease	0
purslane	global amnesia	0
white meat	bipolar affective psychosis	0
plant-based nutrients	recurrent low back pain	0
yogurt	cattle leukemia virus	0
spicy food	degenerative arthritis	0
dietary fibers	cancer of esophagus	1
tumeric	inflammatory polyneuropathy acutes	0
strawberry	fine tremors	0
healthy fruit	paratuberculose	0
plantago ovata	craniocerebral injury	0
flaxseed	deficiency diseases	0
dietary protein	acute cerebrovascular accidents	0
muffin	male infertility	0
potato chips	global amnesia	0
low fruit	degenerative neurologic disorders	0
contaminated meat	olfaction disorders	0
topical ginger	acquired immune deficiency syndrome virus	0
juglans nigra	carsickness	0
deli meats	persistent atrial fibrillations	0
brown rice	prostate cancers	0
flax	pregnancy-induced diabetes	0
açaí berries	schilling-type myeloid leukemia	0
ready-to-eat meals	primary brain neoplasms	0
agaricaceae	action tremors	0
alpine strawberries	hereditary essential tremor	0
mother cell	acute confusional migraines	0
artificial sweetener	spondylarthritis ankylopoietica	0
solanum melongenas	intermediate grade lymphoma	0
digitalis lanata	contagious pustular dermatitides	0
white mallows	manic states	0
kava kavas	neuralgic migraines	0
fagopyrum esculentum	gynecomastia	0
beverage	heart blocks	0
plant embryo	deep-vein thromboses	0
marshmallow	situational syncopes	0
monitoring food	ankylosing spondyloarthritides	0
sugar maples	cardiovascular stroke	0
spinach	cervical migraine syndromes	0
lemon verbena	chronic cluster headaches	0
food allergies	lung neoplasms	0
hamburger	experimental parkinsonisms	0
drinking coffee	diffuse mixed-cell lymphomas	0
colophospermum	neoplasm metastasis	0
uncooked food	urticarias	0
pimpinella anisum	cerebral convexity meningioma	0
anacardium occidentale	autosomal recessive juvenile parkinsonism	0
pancake	high blood pressure	0
papaver somniferum	terminal cancer	0
blueberry plant	disk degenerations	0
sweet pepper	morning sickness	0
soy food	saccular aneurysm	0
food poisoning	copd	0
prebiotic	kidney neoplasms	0
pretzel	texidor's twinge	0
breakfast cereal	hypermelanose	0
lycium	light headedness	0
kombucha tea	inflammatory disease	0
tangerine trees	anhedonia	0
saint johns wort	diabetic neuropathy	0
snacktime	micturition syncopes	0
thymus vulgari	periorbital headaches	0
myristica fragran	galt deficiencies	0
guibourtia	lactose malabsorption	0
dinner time	low-grade b-cell malignancy	0
ultra-processed food	granulomatous enteritis	0
dangerous plants	bovine spongiform encephalopathy	0
shorten	disk degenerations	0
kohlrabi	autosomal recesssive juvenile parkinsonism	0
ale	diffuse lymphoma	0
delonix	microglandular adenoses	0
wild radish	familial guillain-barre syndrome	0
purple grape	crushing skull injuries	0
plant zygote	vitamin deficiencies	0
smoked food	amyotrophic lateral sclerosis	0
sour orange trees	mixed lymphoma	0
cassia	stokes-adams syncopes	0
diospyros digynas	posterior fossa meningiomas	0
stevia	crib death	0
offal	static tremors	0
jelly beans	bipolar depression	0
eat flax	aphthous stomatitis	0
glycine max	endometrium carcinoma	0
noncaloric sweetener	galactosemia	0
pomegranate seeds	paraesophageal hiatal hernia	0
parsley	degenerative neurologic disorder	0
açaí berry	prostatic hypertrophy	0
curried tofu	deep vein thrombosis	0
pimenta officinali	mammary cancers	0
radish	iddm	0
anise	benign prostatic hypertrophy	0
durum wheat	ekbom psychogenic parasitoses	0
shan yao	mixed lymphomas	0
neutraceutical	schizoaffective disorders	0
star anise	plasma cell myeloma	0
prunis communis	malignant melanoma	0
include apples	infant obesity	0
arachis	human flu	0
chenopodium quinoas	premature birth	0
treat	leprosy	0
herb	water-borne hepatitides	0
beet	rodent ulcers	0
roselle	rodent ulcers	0
probiotic	craniocerebral injuries	0
white potatoes	autosomal dominant. juvenile parkinson disease	0
zingiber officinales	aortic aneurysm	0
yellow vegetables	cancer of the kidney	0
texturized vegetable proteins	pregnancy pernicious vomiting	0
sockeye salmon	morning sickness	0
justicia adhatoda	bses (bovine spongiform encephalopathy)	0
alcoholic beverage	ciguatera poisoning	0
hickory nuts	thyroid carcinomas	0
kiwi fruits	ulcerative colitis	0
infant formula	horton syndrome	0
snack food	human papillomavirus viruses	0
exotic fruits	peripheral artery diseases	0
glucose fructose syrup	physical sufferings	0
sugar water	malignant epithelial neoplasm	0
teff	chronic b-cell leukemia	0
foie gras	uterine cervical cancer	0
morning meals	bone cancer	0
green peas	water-borne hepatitides	0
filbert	social anxiety disorder	0
grouper	somatotropin hypersecretion syndrome (acromegaly)	0
cacao	food hypersensitivities	0
hydroponic basil	human mammary neoplasm	0
mastic trees	experimental parkinson diseases	0
fennel seeds	barrett esophagus	0
frozen spinach	birth defect	0
radicchio	itch	0
food poisonings	congestive heart failure	0
aloe	mastitis	0
vaccinium ashei	trochanteric fractures	0
decaf	barrett syndrome	0
ephedras	sick headaches	0
arecas	muscle tremor	0
dried fruits	ovarian neoplasm	0
lens plant	deafness	0
plum tree	semirhythmic tremor	0
stevia rebaudiana	nervous system degenerative diseases	0
no noni	symmetric diabetic proximal motor neuropathy	0
trace minerals	cerebral strokes	0
nonus	bladder tumor	0
chocolate pudding	reducing cancer	0
lunchtime	endotoxemia	0
smoked foods	mouth and tooth diseases	0
pistacia	urinary bladder cancer	0
carbonated drink	foodborne diseases	0
animal-based foods	tussive syncopes	0
mustard plant	lung cancer	0
mentha	amyloidosis	0
drink	stomatognathic diseases	0
kale	miscarriage	0
nettle	weight reduction	0
mandarin orange trees	infant botulism	0
cleistocalyx	stokes-adams syncope	0
acacia tree	arthritis	0
mint tea	degenerative arthritis	0
citrus paradisi	paraesophageal hiatal hernia	0
lycium barbarum	fights cancer	0
healthy nuts	tonsil neoplasms	0
poppy seed	premature births	0
monkfish	adenoviridae	0
cymbopogon	malignant meningiomas	0
potassium-rich foods	lens opacity	0
texturized soy protein	transmissible spongiform encephalopathies	0
health food	colorectal carcinomas	0
digitalis purpurea	cardiovascular conditions	0
sweet foods	uterine fibromas	0
common foxgloves	unilateral headaches	0
blueberry	drug habituation	0
maple	stomach cancers	0
morinda citrifolia	intervertebral disk degenerations	0
milk proteins	macular degeneration	0
green tea	delusory parasitoses	0
including cloves	fibromyositis-fibromyalgia syndromes	0
hordeum vulgare	early diagnosis of cancer	0
baby formulas	atrial fibrillation	0
calendula officinalis	ciguatera	0
bolete	zoonosis	0
clove	burkitt lymphoma virus	0
red meats	aphthous ulcers	0
fast food	deep venous thromboses	0
grecian foxglove	lou gehrig's disease	0
carthamus tinctorius	painful menstruation	0
soy beverages	human t cell leukemia virus type iii	0
tuna	upper respiratory infections	0
rosa	kanner syndrome	0
holy basils	fibromyositis-fibromyalgia syndromes	0
nettle tea	deficiency disease	0
faba beans	marek's disease virus	0
usda poultry	bleed	0
black beans	cough	0
ground beef	burning pains	0
breast milks	polyarthralgia	0
garlic sauce	diabetic autonomic neuropathies	0
seafood	chronic insomnia	0
earl grey tea	brain tumors	0
caryophyllus	chronic airflow obstruction	0
citrus aurantiums	plasmodium infection	0
collard	human mammary neoplasm	0
shellfish	lymphadenopathy-associated viruses	0
oatmeal	subacute spongiform encephalopathy	0
anticancer plant	craniocerebral injury	0
dried blueberries	idiopathic intracranial hypertension	0
century plants	acquired immune deficiency syndrome virus	0
irritable bowel kiwi fruit	penile neoplasm	0
anacardium	impaired sensations	0
sparkling waters	parkinsonism-dementia complex of guam amyotrophic lateral sclerosis	0
pistachio	prion-induced disorders	0
hypericum	cystic disease of breast	0
atropa belladonnas	lichen planus	0
quinoa	iron overload	0
infects apples	water-borne hepatitides	0
cycad trees	carcinogenesis	0
recommend tea	acidosis	0
breakfast times	feline leukemia virus	0
handling meat	degenerative arthritis	0
anti-inflammatory plant	sleep initiation dysfunctions	0
junk food	primary fibromyalgia	0
triticum spelta	insomnia	0
dripping	nonalcoholic steatohepatitides	0
cumin	male pattern baldness	0
dinner times	hypercholesterolemia	1
currant	kidney insufficiency	0
adhatoda	sciatica	0
cassia trees	spinal meningiomas	0
dessert	non b hepatitis enterically transmitted non a	0
seed	membranous cataract	0
pistacia vera	leucocythemia	0
phaseolus vulgari	sudden cardiac death	0
shiitake	intracranial neoplasm	0
solanum dulcamaras	kidney neoplasm	0
soy bean curd	fissure in ano	0
prunus salicinas	drug use disorder	0
osmanthus tea	parkinsonian syndrome	0
cannabi	corpse	0
elettaria cardamomums	cow disease	0
granny smith apples	soft tissue sarcoma	0
food pyramid	vagina neoplasm	0
aspalathus linearis	peanut allergy	0
toxic plant	creutzfeldt jakob syndrome	0
rooibos tea	penis neoplasms	0
woodland strawberries	thyroid carcinoma	0
wheatgrass	fusiform aneurysm	0
diabetic diet	deep-venous thrombosis	0
rheum	kidney insufficiency	0
garcinia mangostanas	reticulum cell sarcoma	0
golden delicious apples	ovarian neoplasms	0
mayo	bilateral headache	0
melissa officinalis	landry guillain barre syndrome	0
citrus medicas	complete hearing loss	0
green pepper	suppuration	0
french fries	udpglucose 4-epimerase deficiency disease	0
rheum rhaponticum	gall bladder disease	0
pineapple	liver steatosis	0
eating eggs	recurrent low back pain	0
chard	a v dissociation	0
indian laburnums	colicky pains	0
phyllanthus emblicas	involutional osteoporosis	0
dark chocolate	papillomaviridae	0
prunus persica	penile cancers	0
macadamia nuts	bladder cancer	0
dasheen	national cancer	0
steak	rhabdomyolys	0
allium cepa	ph1 negative myelogenous leukemia	0
green lentils	drug use disorder	0
calling eggs	hiccup	0
flavoring	sprain	0
tangerine tree	wart	0
seltzer waters	pyrose	0
no meat	amyloid deposit	0
dietary fats	auricular fibrillations	0
alpine strawberry	reducing cancer	0
grapefruit	ph1 negative myeloid leukemia	0
poultry product	vitamin deficiencies	0
dietary plant proteins	angiomatous meningiomas	0
hummus	common bile duct biliary calculi	0
antioxidant fruits	testis cancers	0
bertholletia excelsas	esophageal neoplasms	0
healthy foods	neuritic plaque	0
mangifera indica	colonic cancers	0
althaea	myelopathy	0
citrus x paradisi	prostate cancer	0
vicia faba	convulsive seizures	0
sweet marjorams	encephalopathy	0
vital nutrients	parodontose	0
tomato sauce	familial tremor	0
food additive	nonalcoholic fatty livers	0
clathrotropis	atrioventricular dissociation	0
rubberplant	prostatic neoplasm	0
lens culinari	cancer of stomach	0
andropogon nardus	varice	0
persea	acute monoblastic leukemia	0
proteus mirabilis	amyloidosis	0
mangifera indicas	fever	0
eugenia jambolana	kidney insufficiency	0
cinnamomum cassia	right-sided heart failure	0
corn syrup	bacterial infection	0
lactuca sativa	uterus neoplasms	0
sesame	nerve tremor	0
actual licorice	global amnesias	0
lemon balms	macular dystrophy	0
carduus marianus	chronic lymphoblastic leukemia	0
corylus	drunkenness	0
citrullus	spinal meningiomas	0
handling food	rupture	0
hashish	cancer of breast	0
soy cheeses	arterial fatty streaks	0
whiting	exanthema	0
lemon grasses	left-sided heart failure	0
sweet almond	vaginal neoplasms	0
cocoa powder	colorectal carcinoma	0
citronella	epithelioid sarcoma	0
cream cheese	social phobias	0
citrus grandis	intermittent tremor	0
black teas	dysmenorrhea	0
banana	zoonotic infectious diseases	0
pizza	laron type dwarfism i	0
brassica nigra	age related maculopathy	0
fried foods	congenital hypothyroidism	0
durum wheats	heart attack	0
concord grapes	vestibular seizures	0
coconut milk	mesothelioma	0
vaccinium bracteatums	memory loss	0
goji berry plant	bilateral sciatica	0
raspberry	aphthae	0
lemon balm	burn	0
lavandula	atypical cluster headaches	0
nutritional yeast	colitis gravis	0
gala apples	salmonellosis	0
rose berries	pancreas neoplasms	0
poisonous plants	back pain with radiation	0
powdered sugar	huntington’s disease	0
syzygium jambos	autosomal dominant parkinsonism	0
oolong	childhood obesity	0
table sugar	udp-galactose-4-epimerase deficiencies	0
cultivated oat	kidney stones	0
dioscorea	intracranial meningioma	0
soymilk	wound botulism	0
red lentils	juvenile-onset diabetes	0
whole grain cereal	head injury	0
veal	amnesia	0
green teas	fifth phacomatoses	0
chili	colon neoplasm	0
plantago lanceolata	spinal cord disorder	0
fava beans	fusiform aneurysms	0
peppermint	esophageal reflux	0
preserved foods	gustatory seizure	0
bitter orange trees	higher cancer	0
brazil nuts	episodic cluster headaches	0
trigonella foenum-graecums	gale deficiencies	0
red cabbage	diabetes related complications	0
horse bean	complete blindness	0
herr	effort syncope	0
fermented cabbage	bowel disease	0
wort	endocrine breast diseases	0
elettaria	sliding esophageal hernias	0
solanum dulcamara	pyrose	0
amlas	acquired immunodeficiency syndrome virus	0
aubergine	uterus neoplasm	0
tarragon	breast neoplasms	0
curcuma	intermittent tremors	0
hazelnut	hyperthermia	0
barley	confusion	0
mustard oil	diabetes-related complications	0
rose hips	epstein-barr virus	0
jam	kill cancer	0
triticum turgidum subsp. durum	cancer of brain	0
cured meat	acquired immunodeficiency syndrome	0
artificially-flavored corn	age related maculopathies	0
chia seeds	galactose 1 phosphate uridylyltransferase deficiency	0
spice saffron	dental disease	0
citrus hystrices	mammary cancers	1
coriandrum sativum	polyarthritide	0
domestic fowl	vagina cancer	0
cashew	diffuse lymphocytic lymphoma	0
allspice	prostatic hyperplasia	0
eupatorium rebaudianum	tactile hypesthesia	0
guacamole	intermediate grade lymphoma	0
texturized soy proteins	liver steatosis	0
pickled vegetables	testicular neoplasms	0
herbal tea	cryptogenic epilepsies	0
punicaceae	manic disorders	0
processed meat	social phobias	0
areca catechus	bone neoplasms	0
cappari	hypolactasia	0
sesame seeds	syncope	0
vegetable protein	throat cancer	0
ginger ale	rheumatoid arthritis	0
soybean proteins	oral cancers	0
goji berries	uveitis	0
black coffee	aortic aneurysms	0
malabar nut	craniocerebral traumas	0
narrow leaved plantain	hypovolemic shock	0
acai berry	deaf mutism	0
steamer	memory loss	0
sugar	galactose-1-phosphate uridyltransferase deficiency	0
animal food	zoonotic disease	0
majorana hortensis	polyradiculoneuritis	0
ready-to-eat meal	ankylosing spondyloarthritis	0
whole wheat	osteoporosis	0
food colors	gale deficiencies	0
ice cream	deficiency disease	0
fruit juice	prostate cancers	0
morinda citrifolias	fibrositis	0
curry powder	unilateral headaches	0
dioscorea villosa	cadaver	0
energy drinks	mixed-cell lymphoma	0
thymus vulgaris	halitose	0
almond tree	inflammation	0
pear	human papillomavirus virus	0
deli meat	abdominal obesities	0
red pepper	primary brain tumor	0
fragaria	multiple myelomas	0
wheat bran	brain cancers	0
kombucha teas	peripheral autoimmune demyelinating disease	0
linum	open head injury	0
saint john wort	malignant epithelial neoplasm	0
cranberry	dyslipidemia	0
brown sugar	ph1-negative myeloid leukemia	0
prosopis	gastro esophageal reflux	0
sushi	cancer of the cervix	0
common olive tree	exudative bronchiolitis	0
nut bar	food hypersensitivities	0
national pork	muscle spasm	0
healthiest vegetable	postural syncopes	0
black currant	acquired immune deficiency syndrome	0
holy basil	gale deficiency	0
kiwi fruit	sudden onset diabetes mellitus	0
mushroom	cancer of testis	0
chipotle	infarction	0
hemp	juvenile parkinsonism	0
pummelo tree	spindle-cell carcinomas	1
cow's milk	bovine spongiform encephalopathy	0
rosehip	ankylosing spondylitis	0
green beans	prostate cancer	0
aspalathus	lymphadenopathy-associated viruses	0
rice	cancer of vulva	0
callerya	cat leukemia viruses	0
amaranth	paroxysmal atrial fibrillation	0
black rice	hepatic cancer	0
jambolan plum tree	rupture	0
vaccinium corymbosum	e-b virus	0
coconut oil	infarction	0
so-called vegetable	multiple myositis	0
faba bean	sterility	0
cooked meat	allergic reactions	0
decrease meat	galactose epimerase deficiency	0
citrus reticulata	water stress	0
flax seed	diffuse well-differentiated lymphocytic lymphoma	0
red delicious apples	colon cancer	0
caper	ulcerative colitis	0
kawa kawas	huntingtons disease	0
high-fat meal	leukovirus	0
cured meats	schizoaffective disorders	0
canned foods	cardiovascular stroke	0
raw poultry	juvenile onset diabetes mellitus	0
navy beans	a v dissociation	0
salad	malignant epithelial tumor	0
broth	cervix neoplasms	0
assai palm	autosomal dominant juvenile parkinson disease	0
pistacia lentiscus	colonic cancers	0
frying meat	intraventricular meningiomas	0
pyrus	back pains	0
sweet potatoes	parasagittal meningiomas	0
green onions	subacute spongiform encephalopathies	0
sugar-sweetened beverages	mental disorder	0
cupcake	breast cancers	0
rye	intraventricular meningioma	0
zedoary zedoaria	painful diabetic neuropathies	0
chicken	gnathostoma infections	0
anchovy	global amnesia	0
arugula	necrotizing fascitides	0
whortleberry	familial atrial fibrillation	0
juiced broccoli	diabetic complications	0
dress	periorbital headaches	0
olive family	ocular headache	0
french bean plant	udpglucose hexose 1 phosphate uridylyltransferase deficiency	0
legume family	orthostatic headache	0
fructose corn	temporal region traumas	0
flower	torsion fracture	0
red tea	renal calculus	0
trace element	fibrocystic changes of breast	0
vicia fabas	weight gains	0
morinda	diverticulitide	0
licorice root	short sleep phenotypes	0
roughage	tonic seizures	0
processing meat	hypovolemic shock	0
catfish	acute inflammatory polyradiculoneuropathy	0
linum usitatissimum	constrictive bronchiolitides	0
bean	bovine lymphosarcomas	0
fig	germinoblastic sarcomas	0
seltzer water	light-headedness	0
healthiest apple	intraorbital meningioma	0
processed food	diabetic retinopathy	0
orange juice	amyotrophic lateral sclerosis motor neuron disease	0
cocoa plants	sleep disorder	0
abelmoschus esculentus	gorlin goltz syndrome	0
common olive trees	persistent tremors	0
nicotiana tabacums	male impotence	0
whole grain	bone neoplasm	0
mangiferas	cystic breast disease	0
acid-binding vegetables	female sub-fertility	0
rubus	rectum cancer	0
healthy snack	short sleeper syndromes	0
flavourer	venereal wart	0
fast foods	diffuse lymphocytic lymphoma	0
romaine	paraesophageal hernia	0
lamb chops	proliferative bronchiolitides	0
plant capsules	stomach cancers	1
food supplementations	galactose 1 phosphate uridyltransferase deficiency	0
powdered ginger	crohn’s disease	0
cocos nucifera	deep venous thrombosis	0
food coloring	paroxysmal atrial fibrillation	0
plant embryos	transmissible dementia	0
persea americanas	cancer of stomach	0
yeast rice	cervical migraine syndromes	0
trigonella	high-grade lymphoma	0
kola nuts	inner ear cancer	0
black sapote	heart block	0
piper methysticums	idiopathic parkinson disease	0
hemp plant	cvas (cerebrovascular accident)	0
nuclear power plants	lymphatic sarcoma	0
olive trees	psychogenic parasitosis	0
hot sauce	sid	0
bhang	acute confusional migraines	0
yerba mates	sudden cardiac arrest	0
poultry meat	hypolactasia	0
processed apples	hiccup	0
macadamia	cancer of the ovary	0
red delicious	malignant epithelial neoplasms	0
kola nut	pruritus	0
regular carrots	johne's disease	0
citron tree	confusional states	0
lettuce	chronic b cell leukemia	0
pumpkin	parietal region trauma	0
cicer	viral infection	0
frier	postoperative nausea and vomiting	0
purine-rich plant	esophagitis	0
sugar substitute	infection	0
greenery	lou-gehrigs disease	0
japanese plums	postviral fatigue syndromes	0
bean sprouts	breast disease	0
citrus limon	oncogenese	0
candy bar	fibrosis	0
healthier meat	diverticulum	0
nut butters	aura	0
gravy	liver neoplasms	0
chile peppers	acne	0
thymus plant	new variant creutzfeldt jakob disease	0
ilex paraguariensis	parkinson disease 2	0
cruciferous vegetable	heart attack	0
asparagus	deep vein thrombosis	0
cucumis melos	cadaver	0
brain-invasive pork	kanner syndrome	0
placenta	gallbladder disease	0
amorpha	celiac disease	0
zingiber officinale	vulva cancer	0
trace elements	bovine leukoses	0
milk	premature aging	0
orange tree	motor seizures	0
pease	sciatic neuralgia	0
plantago seed	osteoarthritide	0
organic milk	tongue neoplasm	0
piper methysticum	vaginal neoplasms	0
oxen meat	bilateral headache	0
malus	short sleeper syndrome	0
jell-o	vertebrogenic pain syndrome	0
dietary soybean proteins	uterine cervical neoplasm	0
brassica napus	varicose vein	0
fruit-shaped marshmallows	cancer of rectum	0
organic plants	somatotropin hypersecretion (acromegaly) syndrome	0
celery	colicky pains	0
egg	dermatosis	0
pomelo tree	prostate disease	0
ground ginger	autosomal dominant parkinsonism	0
white bread	cancer-causing herpesvirus	0
larder	fifth phacomatoses	0
teosinte	acute inflammatory polyneuropathy	0
drink milk	jakob-creutzfeldt disease	0
iceberg lettuce	juvenile parkinsonism	0
sustenance	increase cancer	0
carbonated beverages	breast cancers	0
oat	peanut hypersensitivity	0
citrus	sneezing	0
red yeast rice	vulva neoplasms	0
soft drinks	insulin dependent diabetes mellitus	0
extracted fruit	retained surgical items	0
cannabis indica	fibromyalgia fibromyositis syndrome	0
sell meat	arthralgia	0
oregano plant	acquired immunologic deficiency syndrome	0
spearmint	perioral tremors	0
bok choy	retained surgical instruments	0
virgin olive	male breast enlargement	0
chinese cinnamon	clonic seizures	0
brewage	blindness	0
kava kava	carcinomatosis	0
alfalfa sprouts	fibrocystic changes of breast	0
nut butter	retained surgical instrument	0
consumed chocolate	virus infections	0
rhubarb	anoxia	0
stryphnodendron	ms (multiple sclerosis)	0
euterpe edulis	excess cancer	0
green peppers	carsickness	0
jelly	hemicrania	0
rabbit meat	weight gain	0
flaked coconut	chronic airflow obstruction	0
texturized vegetable protein	obesity virus	0
oyster mushrooms	pleomorphic lymphomas	0
jalapeno peppers	human t lymphotropic virus type iii	0
pimiento	social phobia	0
different fruits	pyrose	0
cassia tree	myelopathy	0
sweet peppers	ovarian cancer	0
mackerel	ph1 negative myeloid leukemia	0
real chocolate	bone neoplasm	0
prosopi	acute inflammatory polyneuropathies	0
portulaca oleraceas	spontaneous abortions	0
emphasize plant	auto-immune disease	0
baker's yeast	gluten sensitive enteropathy	0
carbonated mineral water	pyrexia	0
dried plums	metabolic acidosis	0
pumpkin seeds	porcine endogenous retroviruses	0
barley coffee	acquired immunodeficiency syndromes	0
euterpe oleracea mart.s	diabetic polyneuropathies	0
celebration meal	cancer of the testes	0
eugenia sandwicensis	limb tremor	0
confection	lymphocytic lymphomas	0
molasse	galactosemia 3s	0
so-called meat	cervical neoplasms	0
dioscorea opposita	chronic cluster headache	0
soy bean curds	cognitive impairments	1
longevity legumes	dissociative amnesia	0
illicium verums	rickets	0
suggesting fruit	gnathostomiase	0
dog rose	age-related memory disorders	0
mother cells	tussive syncopes	0
syzygium	myelopathy	0
leek	bladder disease	0
portulaca	wheat hypersensitivity	0
avenas	small lymphocytic lymphoma	0
healthy food	thyroid diseases	0
potable water	lymphocytic leukemia	0
corn oil	acute cerebrovascular accidents	0
lipomul	foodborne botulisms	0
peach trees	drug hypersensitivity	0
indian gooseberry	post-ictal confusion	0
avocado	gum disease	0
curcuma longas	alzheimer’s disease	0
blackberry	tonsillar cancer	0
lucerne	gehrigs disease	0
baking chocolate	amyotrophic lateral sclerosis-parkinsonism-dementia complex 1	0
zinger tea	colon cancer	0
cinnamomum zeylanicum	sinusitis	0
beta vulgaris	heart blocks	0
cruciferous foods	hyperthermia	0
brew	barretts esophagus	0
ficus	regional enteritis	0
psidium guajava	enzootic bovine leukosis	0
deep-fry foods	skin neoplasm	0
sweet marjoram	painful menstruation	0
almond	tongue cancers	0
pecan	cancer of the kidney	0
grecian foxgloves	intraventricular meningioma	0
cicer arietinum	parietal region traumas	0
lens culinaris	syndrome	0
root	amyloid deposits	0
anacardium occidentales	non alcoholic fatty liver disease	0
tulsi tea	widespread chronic pains	0
fries	alopecia	0
mastic tree	obesity in adolescence	0
store licorice	rodent ulcer	0
maraschino cherry	udpglucose hexose 1 phosphate uridylyltransferase deficiency	0
gluten	involutional osteoporosis	0
apple	endometrium cancers	0
seven nutrients	neurocysticercosis	0
bitter nightshade	prion-induced disorders	0
prunus domestica	experimental parkinsonisms	0
carob	dementia	0
carrot juice	pancreatic cancers	0
rice milk	eye disease	0
vegetable juice	prediabete	0
illicium anisatum	gastro-oesophageal reflux	0
natto	urinary bladder neoplasm	0
legume pods	colitis gravis	0
hickory nut	intestinal diseases	0
raw alfalfa	global amnesias	0
citrus aurantium	milk sugar intolerance	0
areca	serious disease	0
berberis	muscle tenderness	0
açai berries	galactokinase deficiency disease	0
molasses	hypoesthesia	0
cacao bean	prevent and reverse heart disease	0
capsicum annuum	breast malignant neoplasms	0
artificial sweeteners	dementia with amyotrophic lateral sclerosis	0
coffee	temporary amnesia	0
andean blackberry	gall bladder disease	0
psidium guajavas	foreign bodies	0
brussel sprout	rash	0
macadamia nut	right sided heart failure	0
coriandrum	autosomal recessive juvenile parkinson disease	0
star anises	sudden onset diabetes mellitus	0
emblica officinalis	central nervous system intracranial disorders	0
overpriced vitamin	myelomatose	0
juglan	dermatozoic delusion	0
common plant	stomach neoplasm	0
orange	lactose malabsorption	0
eating fruits	senile paranoid dementias	0
curcuma longa	impaired sensations	0
reindeer meat	lyssa	0
carbonated waters	zoonotic infection	0
crave chocolate	reversing chronic disease	0
food supplement	esophageal neoplasms	0
grilled meat	endometrium cancer	0
andean blackberries	uterine neoplasms	0
chicken meat	nerve tremors	0
chinese yams	postoperative nausea	0
frying foods	macular degenerations	0
incorporates cloves	hansens disease	0
squash plants	male infertility	0
white pepper	atherosclerosis	0
kenaf	sleep-related neurogenic tachypnea	0
common foxglove	ischemic heart disease	0
bean sprout	craniocerebral injuries	0
nori	mastitis	0
weekly meat	cervical migraine syndromes	0
alcoholic beverages	intertrochanteric fractures	0
jalapeno pepper	texidor's twinge	0
turnip	bovine spongiform encephalopathy	0
popular fruits	migratory pains	0
eugenia cumini	infantile obesity	0
human milk	diabetic polyneuropathy	0
gluten-free diet	zoonosis	0
breakfast time	xanthomatous meningiomas	0
safflower oil	small non cleaved cell lymphoma	0
musa	decreased cancer	0
pine nuts	cancer of stomach	0
lavandula angustifolia	halitosis	0
low meat	encephalon diseases	0
althea officinalis	plasmodium infections	0
kidney beans	primary insomnia	0
raw meat	intracranial neoplasms	0
favorite meals	corpse	0
haritaki fruit	convulsive seizures	0
beer	postural syncopes	0
cucumber	drug use disorder	0
crunch berries	human t-cell leukemia virus type iii	0
drug administration united states food	beriberi	0
squashe	uterine fibroid	0
bellis	bipolar depression	0
sprout	acute monoblastic leukemia	0
unrefined plant	diabetic mononeuropathy	0
thymus	pruritis	0
toronja	tonsil neoplasm	0
liquor	migraine	0
euterpe precatoria	neurologic degenerative condition	0
gmo soybeans	recurrent low back pain	0
baby carrots	subtrochanteric fractures	0
target vitamin	polyarthralgia	0
citrus maxima	benign brain neoplasm	0
nightshade	remittent fever	0
berberi	glaucoma	0
algarrobo	esophagitide	0
hawthorn	obesity virus	0
curry	acute myeloid leukemia	0
split pea	carcinoma in situ	0
pimpinella anisums	beriberi	0
buttermilk	age related bone loss	0
cooked broccoli	cancer of esophagus	0
almond butter	study cancer	0
citrus bergamia	uterine fibroids	0
crataegus	autoimmune disorders	0
cilantro	back ache	0
sunflower seeds	chronic lymphoblastic leukemias	0
squash plant	dyslipidemia	0
vegetarianism	cancer of the lung	0
weed	degenerative intervertebral discs	0
sunchoke	aphthous ulcer	0
chocolate bars	pill rolling tremors	0
trace mineral	cranial pains	0
hemp plants	crohn disease	0
entree	cancer of the vulva	0
serve	breast malignant tumor	1
laciniate nightshades	epileptic seizure	0
pea families	head pain	0
cocoanut	postoperative nausea	0
illicium anisatums	neurodegenerative disease	0
term vegetable	small noncleaved-cell lymphoma	0
new candy	gestational diabetes	0
processed meats	endometriose	0
maguey	post-traumatic osteoporoses	0
tofu	retained surgical needle	0
rutabaga	galactokinase deficiencies	0
food additives	parkinsonism	0
tree nuts	tremor	0
drinking tea	canker sores	0
olive	t virus	0
dietary supplementations	inherited human transmissible spongiform encephalopathies	0
cooking oil	neoplasm metastasis	0
opium poppy	parkinson’s disease	0
phytonutrient-rich food	arterial fatty streaks	0
mirobalanus embilica	atherosclerose	0
citrus bergamias	experimental parkinsonisms	0
golden delicious	protein deficiencies	0
olive oils	rachitide	0
cassia fistulas	schilling type myeloid leukemia	0
seville orange trees	diffuse mixed small and large cell lymphoma	0
daucus carota	resting tremors	0
whole grains	liver cancers	0
healthiest beverages	ph1-negative myeloid leukemia	0
taraxacum officinale	apneas	0
aquatic food	acute inflammatory demyelinating polyneuropathy	0
grape seeds	acute inflammatory demyelinating polyneuropathy	0
garden radish	basal cell nevus syndrome	0
areca nuts	bowel disease	0
healthy snacks	cephalalgia	0
tomato	neoplasm metastases	0
fenugreek	barrett metaplasia	0
low-sodium diet	feline leukemia virus	0
punica granatums	high cholesterol levels	0
coconut water	soft tissue sarcomas	0
raphanus sativus	cancer of the kidney	0
organic food	leiomyoma	0
myristica fragrans	episodic cluster headache	0
acer saccharum	growth hormone insensitivity syndrome	0
sesamum	prostatic hypertrophy	0
cereal grain	ekbom delusional parasitoses	0
common fruits	autistic disorder	0
cayenne peppers	neurodegenerative disease	0
raw garlic	ph1-negative myeloid leukemias	0
spinacia oleracea	diffuse myofascial pain syndrome	0
ketchup	intervertebral disc degenerations	0
chamomile tea	gingivitis	0
taraxacum	inflammatory bowel diseases	0
tepary beans	syncopal episode	0
pie	baldness	0
syzygium sandwicense	infarction	0
cider	gastro-esophageal reflux	0
new vitamin	male sub-fertility	0
soy cheese	increase cancer	0
saccharomyces cerevisiae	prostatic intraepithelial neoplasias	0
cayenne pepper	human t-lymphotropic virus type iii	0
food supplements	crohn's disease	0
java plum tree	mucous colitis	0
cocktail	splitting pains	0
cayenne	spinal cord diseases	0
moose meat	chronic lymphocytic leukemia	0
dietary fat	bone neoplasms	0
cortland	cystic disease of breast	0
cereal grains	carcinomatosis	0
whipped cream	kidney neoplasms	0
phyllanthus emblica	periorbital headache	0
chamomile	paratuberculose	0
walnut oil	fibromyalgia-fibromyositis syndrome	0
olive oil	fifth phacomatosis	0
bertholletia	chicken virus	0
dried apricots	pediatric cancers	0
foeniculum	milk sugar intolerance	0
stuff	acute monocytic leukemia	0
rosemary	pancreatic cancer	0
salmonella food	occipital region traumas	0
antioxidant-rich foods	cognitive dysfunction	0
syzygium jambolanum	clonic seizure	0
english walnuts	painful diabetic neuropathies	0
fagopyrum sagittatum	paraesophageal hernias	0
english plantain	malignant tumor of urinary bladder	0
cannabis sativas	penis neoplasm	0
ceylon cinnamon	cystic disease of breast	0
eating nuts	recrudescence	0
california avocado	mptp-induced experimental parkinsonism	0
eugenia aromatica	ankylosing spondylarthritis	0
purple cabbage	benign intracranial hypertension	0
petroselinum crispum	kidney insufficiencies	0
tomato juice	diabetic neuropathies	0
shan yaos	torsion fracture	0
nicotiana tabacum	hemangiopericytic meningiomas	0
baked potato	atrioventricular dissociation	0
erythroxylon	nonspecific vaginitis	0
acai berries	fibrous meningiomas	0
belladonna	congenital hypothyroidism	0
zea	kidney neoplasm	0
sweet basils	infectious disease	0
silken tofu	gastroenteritide	0
stevia rebaudianas	meningiomatosis	0
national meat	back aches	0
saffron crocus	bacterial vaginosis	0
bell peppers	bladder neoplasms	0
cuminum	skin disease	0
indian gooseberries	reproductive sterility	0
cinnamon	paralysis agitans	0
mustard greens	mild neurocognitive disorders	0
juglans regia	urinary tract infection	0
herbal teas	transitional meningioma	0
porgy	oncogenic virus	0
collard greens	royal free disease	0
solanum melongena	hypermelanose	0
banana plant	catarrh	0
domestic fowls	mastodynia	0
soy yogurt	guillain-barre syndrome	0
chili pepper	heart attack	0
fresh ginger	barrett's syndrome	0
sandwich	type i diabetes mellitus	0
hypericum perforatum	retained surgical needle	0
blossom	posterior fossa meningiomas	0
endive	asymmetric diabetic proximal motor neuropathy	0
ginger	seizure disorders	1
brussels sprouts	temporal region trauma	0
black sapotes	soft tissue sarcomas	0
broccoli raab	leukemia	0
pepsi	psychophysiological insomnia	0
health nuts	intraventricular meningiomas	0
cardamom	brain malignant neoplasms	0
raisin bran	continuous tremors	0
oryza sativa	substance induced organic mental disorders	0
yoghurt	diffuse lymphoma	0
plaice	atypical cluster headaches	0
flowering shrub	age-related macular degeneration	0
laciniate nightshade	parkinsonian diseases	0
edible grain	forehead trauma	0
bacon	t virus	0
plant kingdom	steatosis of liver	0
fennel	familial creutzfeldt jakob disease	0
pleurotus ostreatus	granulomatous enteritis	0
shiitake mushroom	convulsion	0
spore	extreme hearing loss	0
ananas	macular degeneration	0
honeybush tea	mptp-induced experimental parkinsonism	0
breast milk	vulva neoplasms	0
eating almonds	vitamin deficiencies	0
poppy seeds	subwakefullness syndromes	0
okra	tonsil neoplasm	0
diospyros digyna	substance abuse	0
eating food	continuous tremor	0
persea americana	coarse tremors	0
humulus	barretts syndrome	0
elettaria cardamomum	inflammatory polyneuropathy acutes	0
energy drink	age-related maculopathies	0
pimenta	abdominal migraine	0
vaccinium macrocarpons	germinoblastic sarcoma	0
octopus	vertex headaches	0
organic meat	cryptogenic epilepsies	0
milkshake	dental diseases	0
bitter nightshades	mixed-cell lymphomas	0
kidney bean	effort syncopes	0
basil	clonic seizures	0
wild yams	epimerase deficiency galactosemias	0
cuminum cyminum	mammary cancers	0
intoxicant	ciliary neuralgia	0
sugar maple	osteoarthrosis	0
fava bean	insulin-dependent diabetes mellitus	0
pomegranate	diabetic neuralgia	0
antioxidant vitamin	diffuse mixed small and large cell lymphoma	0
peach	occipital trauma	0
hypericum perforatums	acute monoblastic leukemias	0
venison	limb tremors	0
kiwi	hemolytic jaundices	0
citrus aurantiifolias	zoonotic disease	0
soya milk	atherosclerosis	0
indian laburnum	infantile colic	0
pineapple juice	retained surgical needles	0
sour fruit	auriculo-ventricular dissociation	0
caramel	fibroatheromatous plaque	0
chickpea	memory disorder	0
trigonella foenum graecum	a-v dissociation	0
include flaxseed	heart attacks	0
psyllium	diffuse undifferentiated lymphoma	0
ranking foods	fusiform aneurysms	0
ocimum sanctum	chronic lymphatic leukemia	0
dog rose berries	alactasia	0
vitamin	physical anhedonias	0
ceratonia	female pattern baldness	0
mango	brain cancer	0
chervil	sprue	0
gooseberry	weight loss	0
dairy yogurt	voice box cancer	0
pimenta diocia	schizophrenia	0
specific nuts	endometriose	0
carica papayas	non-b hepatitis enterically-transmitted non-a	0
plantago	papillary meningioma	0
chewing gum	seizure disorders	0
cuminum cyminums	nonhodgkins lymphoma	0
spice turmeric	gastric neoplasm	0
healthiest nuts	hair losses	0
phaseolus vulgaris	penile cancer	0
dried peas	human t-cell leukemia virus type iii	0
assai palms	crohn's enteritis	0
cynara scolymus	intervertebral disc degeneration	0
collard green	transmissible dementias	0
msg	thrombosis	0
amla	uterine fibromas	0
fruit and vegetable juices	prion induced disorder	0
organ	fatty liver disease	0
broccoli	testicular cancer	0
fatty foods	parkinson disease	0
tisane	brain cancer	0
prenatal vitamins	colorectal cancer	0
petroselinum crispums	liver injury	0
tea	behavior disorders	0
taking vitamin	hiccough	0
butternut squash	near-death experience	0
poisonous plant	lou-gehrigs disease	0
coriander	nonorganic insomnia	0
wheat	preterm birth	0
glycyrrhiza glabra	multiple meningiomas	0
elephant garlic	cancer of pancreas	0
meal time	asthma	0
beet greens	feline leukemia viruses	0
common bean plants	gall bladder disease	0
pepper	minor head injuries	0
uncooked foods	lou-gehrigs disease	0
pimenta officinalis	colorectal cancers	0
fed beef	cluster headache syndrome	0
pork	post traumatic osteoporosis	0
cultivated radish	postviral fatigue syndromes	0
cooked tomatoes	cancer of lung	0
pureed apples	cerebral strokes	0
trompillo	creutzfeldt-jakob syndrome	0
capsicum	subfertility	0
maize oils	block cancer	0
horse nettle	persistent atrial fibrillation	0
liquorice	sudden infant death syndrome	0
marijuana	ache	0
meal	bechterew disease	0
salmonella-infected eggs	psychogenic parasitosis	0
high-fiber food	allergic reaction	0
laudable legume	subfertility	0
garcinia mangostana	coarse tremor	0
true nut	histamine cephalgias	0
brassica juncea	myocardial infarcts	0
high fructose corn syrup	muscle cramp	0
kavas	long sleeper syndrome	0
bergamot	develop cancer	0
food companies	cancer of ovary	0
lunch times	gale deficiencies	0
sweetener	peanut allergy	0
morel	allergic reactions	0
cranberry juice	variant creutzfeldt-jakob disease	0
oryza	penis neoplasm	0
fagopyrum tataricum	johne disease	0
study lavender	olfactory seizures	0
ground flax	retained surgical items	0
sea-food	persistent atrial fibrillations	0
illicium verum	macular dystrophy	0
bertholletia excelsa	brittle diabetes mellitus	0
big food	asymmetric diabetic proximal motor neuropathy	0
boiled broccoli	irritable bowel syndromes	0
avena sativa	barrett metaplasia	0
mangosteen	mad cow diseases	0
pudding	allergic diseases	0
oats	painful menstruations	0
hop	chronic lymphoblastic leukemias	0
rye bread	heart decompensation	0
avoid peanuts	bladder neoplasms	0
melissa	spinal cord disorder	0
sausage	spinal cord disorders	0
largest meal	syncope	0
suggesting apple	birth weight	0
century plant	senile plaque	0
honey	bilateral headaches	0
fresh meat	esophageal reflux	0
french bean plants	influenza in humans	0
saint john's wort	leukemogenic viruses	0
kava	gnathostoma infection	0
mustard seeds	substance dependence	0
lycopersicon esculentum	renal calculus	0
wild yam	bone fractures	0
sour cream	ischemia	0
sweetened cereal	birth weights	0
flounder	tongue cancer	0
pistachio nut tree	manic-depressive psychoses	0
white tea	female sterility	0
orange trees	eczematous dermatitis	0
neu5gc-rich food	pancreatic neoplasm	0
worldwide fruit	inflammatory disease	0
replenish nutrients	osteoarthrosis	0
pimpinella	single seizures	0
curcuma zedoarias	urticarias	0
hibiscus sabdariffa	avitaminosis	0
vitamin pills	degenerative neurologic diseases	0
dietary sucrose	cephalalgia	0
holy basil tea	allergic reactions	0
origanum	galactosemia 2	0
coleslaw	ciguatera poisoning	0
almond oil	torsion fractures	0
dandelion	polyphagia	0
solanum laciniatum	pancreatic cancers	0
soy sauce	premature births	0
actual fruit	kidney stones	0
plantago psyllium	pneumonia	0
melissa officinali	increased cancer	0
avena	fibroid uterus	0
cocoa	acute monoblastic leukemia	0
red peppers	terminal cancer	0
mentha spicatas	study cancer	0
wheat brans	kill cancer	0
higher vegetable	micturition syncopes	0
whole foods	diffuse undifferentiated lymphomas	0
lemon balm tea	fibrositis	0
prunus dulcis	cancer of breast	1
density foods	lymphocytic lymphomas	0
artificial butter	aids viruses	0
caryophyllus aromaticus	hiatal hernias	0
aloe vera	anxiety disorders	0
no-calorie sweeteners	mixed cell lymphoma	0
plantago indica	galactokinase deficiency disease	0
betel nuts	acquired immunologic deficiency syndrome	0
skim milk	non b hepatitis enterically transmitted non a	0
pistachio nut trees	social anxiety disorders	0
chamomile oil	necrotizing fascitis	0
foxglove	a v dissociation	0
soy milk	landry-guillain-barre syndrome	0
buckwheat	degenerative disease	0
vodka	exanthema	0
ribes nigrum	udp galactose 4 epimerase deficiency	0
rooibo	galk deficiency	0
fungus	exudative bronchiolitides	0
chilli pepper	tumorigenese	0
camomile	intracranial meningiomas	0
dinnertime	pharyngitis	0
wild celery	schizophreniform disorders	0
rubus glaucus	oncogenesis	0
corn	cervix cancer	0
drinking orange	inappropriate gh secretion syndrome (acromegaly)	0
kawa kawa	alopecia cicatrisata	0
phaseolus	esophagus cancers	0
guava	tumor virus	0
olea	fibromyalgia-fibromyositis syndrome	0
crataegus monogyna	malignant epithelial tumor	0
nut	intermediate-grade lymphomas	0
sauerkraut	bladder diseases	0
daily nut	insomnia	0
vegetable proteins	gingivitide	0
triticum durum	diverticulitis	0
tea hibiscus	epstein barr virus	0
nutrient-dense foods	headache disorders	0
hordeum	diverticulum	0
high-phytate foods	heat strokes	0
poultry	paraesophageal hernia	0
copaifera	abdominal cramp	0
vaccinium angustifolium	occipital region trauma	0
licorice	nutritional disease	0
zucchini	fine tremor	0
citrus-based fruits	somatotropin hypersecretion syndromes (acromegaly)	0
crocus	genital warts	0
machaerium	oral disease	0
ultra-processed foods	age-related memory disorders	0