
hickory trees	hypercapnia	0
cannabis sativas	rna tumor virus	0
shan yao	intervertebral disc degenerations	0
poisonous plants	disorders of initiating and maintaining sleep	0
hibiscus	vagina cancers	0
guacamole	osteoarthritide	0
olive trees	post-traumatic osteoporosis	1
oregano	human t-lymphotropic virus type iii	0
eupatorium rebaudianum	somatotropin (acromegaly) hypersecretion syndromes	0
daily nut	neoplasm metastasis	0
dioscorea batatas	cardiac arrhythmias	0
fig	paroxysmal atrial fibrillations	0
soy beverage	genital wart	0
stevia rebaudiana	renal failure	0
maple syrup	age-related macular degenerations	0
oxen meat	senile tremor	0
triticum aestivum	parodontosis	0
algarrobo	fibrous meningiomas	0
fruit juices	metabolic acidoses	0
ready-prepared foods	tying disease	0
pecan trees	urinary bladder neoplasms	0
melissa officinalis	familial atrial fibrillation	0
arecas	aphthous stomatitides	0
collard green	lymphocytic lymphomas	0
sea bilberries	aids viruses	0
vegetarianism	peripheral arterial disease	0
low meat	pseudopelade	0
alfalfa	impaired sensation	0
amorpha	disc degradation	0
brew	stomatognathic disease	0
persea	epithelial cancer	0
linum usitatissimums	lead poisoning	0
cassia	tongue neoplasm	0
toxic plant	bowel disease	0
tea hibiscus	kidney insufficiencies	0
espresso	infant gynecomastia	0
candy	b-cell chronic lymphocytic leukemia	0
alcoholic beverage	primary fibromyalgias	0
psidium	cystic disease of breast	0
lucerne	scorbutus	0
copaifera	paroxysmal atrial fibrillations	0
cuminum cyminum	kidney stones	0
triticum vulgare	rectum cancer	0
eating broccoli	hemolytic uremic syndrome	0
alpine strawberries	headache	0
cherry plum tree	cancer of uterus	0
fed beef	bechterew's disease	0
green lentils	pill rolling tremor	0
navy beans	postoperative emesis	0
cinnamomum verum	spinal cord degenerative diseases	0
bertholletia	gluten-sensitive enteropathy	0
morning meals	fibrosis	0
eden foods	hypoxemia	0
hibiscus tea	hemolytic jaundice	0
snack food	atherogenesis	0
chinese cinnamons	severe gh insensitivity	0
curcuma	reticulosarcoma	0
sugar maples	felv	0
flammulina velutipes	spinal meningioma	0
juiced broccoli	high cholesterol level	0
diabetic diets	e b virus	0
include apples	anal ulcer	0
stevia rebaudianas	open head injuries	0
ficus	action tremors	0
goji berry	epithelial cancer	0
food poisoning	fifth phacomatoses	0
porphyra	venous thromboses	0
applesauce	phage	0
sour fruit	prion diseases	0
assai palm berries	postoperative emeses	0
pepper	infantile autism	0
confection	bruise	0
breakfast time	vaginal neoplasm	0
porgy	autoimmune diseases	0
soya milk	non-b hepatitis epidemic non-a	0
callerya	colonic cancer	0
java plum trees	degenerative intervertebral disks	0
aquatic food	barrett esophagus	0
flavoring	auriculo-ventricular dissociation	0
opium poppies	common bile duct gall stones	0
cooked meat	chronic diseases	0
overpriced vitamin	superficial head injuries	0
tea leaves	acute monocytic leukemias	0
goiaba	hepatitide	0
anti-inflammatory foods	ciliary neuralgias	0
kiwi	prostatic intraepithelial neoplasm	0
nettle tea	esophagus cancer	0
no coffee	bacterial vaginitis	0
persea americanas	plasma cell myeloma	0
butter	megacolon	0
ready-to-eat meals	splitting pain	0
pine nuts	gastro esophageal reflux	0
citrullus	icterus	0
cocoanut	lens opacities	0
mangosteen	psychophysiological insomnia	0
grape	cervix neoplasm	0
whole grains	malignant brain neoplasms	0
refined olive	feminization	0
floret	hair losses	0
rye bread	human t-cell leukemia virus type iii	0
carbonated waters	primary brain tumors	0
strawberry	testicular cancer	0
triticum spelta	muscular cramp	0
flaked coconut	acute myeloid leukemia	0
jalapeno peppers	neoplasm metastasis	0
supper	bovine spongiform encephalitis	0
concord grapes	protein deficiencies	0
aloe vera	cervix cancers	0
milk proteins	chronic disease	0
processed apples	diabetic amyotrophies	0
taro	carcinomatosis	0
brussel sprout	leukemogenic viruses	0
coca	atypical diffuse small lymphoid lymphoma	0
red rice	seasickness	0
nutritional yeast	thyroid neoplasms	0
avena sativa	ankylosing spondyloarthritis	0
boiled eggs	cll lymphoplasmacytoid lymphoma	0
smoked foods	amaurose	0
rice milk	irritable bowel syndromes	0
andropogon nardus	multiple head injury	0
pyrus	oncogenic virus	0
healthy snack	leprosy	0
iv vitamin	anal ulcer	0
holy basil tea	rete testis tumors	0
rheum rhaponticum	acquired deafness	0
belladonna	cot death	0
triticum turgidum subsp. durum	vulva neoplasm	0
beverage	acquired immuno-deficiency syndrome	0
frosting	clonic seizures	0
wolfberry	communicable diseases	0
white wine	paroxysmal atrial fibrillation	0
crabapple	acute inflammatory demyelinating polyradiculoneuropathy	0
granny smith	pancreas cancers	0
high fructose corn syrup	fibrositis	0
noni fruit	cancer of lung	0
brown sugar	high grade lymphoma	0
prunus salicinas	occipital region trauma	0
dietary sucrose	contagious pustular dermatitides	0
ultra-processed foods	degenerative intervertebral discs	0
dasheen	rectum cancers	0
common plant	hypospadia	0
black rice	oxygen deficiency	0
dog rose berries	pediatric obesity	0
elephant garlic	avitaminose	0
snacktime	autosomal dominant parkinsonism	0
whole grain cereals	chest pain	0
fagopyrum sagittatum	intermediate-grade lymphomas	0
parsley	episodic cluster headache	0
areca catechu	hiatus hernia	0
sweet orange	throbbing headaches	0
japanese plum	xanthomatous meningioma	0
soy bean curds	central nervous system cysticercosis	0
black teas	small noncleaved cell lymphoma	0
tepary beans	stomatognathic diseases	0
texturized vegetable protein	plegia	0
eugenia malaccensis	tonsil cancer	0
bitter orange tree	mild cognitive impairments	0
cilantro	dysmenorrhea	0
apple trees	spongiform encephalopathies	0
holy basil	prion-induced disorders	0
dripping	diabetic autonomic neuropathies	0
linseed	ankylosing spondyloarthritides	0
swiss chard	t virus	0
aubergine	mixed lymphoma	0
bilberry	leukemia	0
ribe	tick bite	0
corn syrup	bone fractures	0
myristica fragrans	foreign objects	0
sweetener	brain neoplasms	0
chinese cassias	deficiency diseases	0
poppy seed	aphthae	0
cinnamomum cassia	colon cancers	0
breakfast	infant obesity	0
jambolan plum trees	common cancer	0
betel nut	diabetes mellitus complications	0
pimpinella anisum	breast carcinomas	0
dog rose	kidney disease	0
infant formula	experimental lung inflammation	0
emphasize plant	familial diffuse gastric cancer	0
veggie	perioral tremor	0
jell-o	familial guillain-barre syndrome	0
plant arils	gnathostomiase	0
black coffee	crushing skull injury	0
alpine strawberry	diffuse lymphomas	0
pea family	strains and sprains	0
pureed apples	acquired blindness	0
mastictree	idiopathic polymyositis	0
regular olive	tonsillar cancers	0
plant embryos	icterus	0
illicium verums	rest tremor	0
carbonated mineral waters	skin neoplasms	0
colocasia	wound botulisms	0
vitis	auriculo-ventricular dissociations	0
sugar	early awakening	0
french bean plant	age-related memory disorder	0
chinese cinnamon	bronchiolitis obliterans	0
herr	uterine cancers	0
frozen cranberries	acute infectious polyneuritis	0
flounder	bechterew disease	0
food supplement	mixed small and large cell lymphoma	0
glucose-fructose syrup	ankylosing spondyloarthritis	0
eating almonds	fibromyoma	0
fennel seeds	lung neoplasms	0
pistachio nut trees	penile neoplasm	0
anise seed	prostatic neoplasms	0
raisin	brain cysticercosis	0
no-calorie sweeteners	heart block	0
teosinte	newborn gynecomastia	0
cranberry juice	eczematous dermatitides	0
acer saccharums	near-death experience	0
frozen broccoli	terminal ileitis	0
solanum melongena	dyslipoproteinemia	0
euterpe edulis	fibromyositis-fibromyalgia syndrome	0
breakfast times	barrett epithelium	0
sushi	sexual dysfunction	0
sweet marjorams	cancer of the endometrium	0
olea	reticulum-cell sarcomas	0
cold-steeping tea	recurrent brain tumor	0
poppy seeds	b-cell leukemia	0
common foxgloves	sciatic neuralgia	0
tangerine tree	dental fluorosis	0
tomato	neurocysticercosis	0
sunflower seeds	crohnâ€™s disease	0
medicago sativa	drug abuse	0
green tea	substance dependence	0
hot pepper	cognitive retention disorders	0
organic foods	penis neoplasm	0
marijuana	parietal region trauma	0
so-called meat	cancer of tongue	0
poultry products	dysosmia	0
solanum laciniatums	prostatic intraepithelial neoplasias	0
salt-free diet	memory loss	0
pumpkin seeds	growth hormone receptor deficiency	0
vitamin	non-alcoholic fatty liver disease	1
sugar-sweetened beverages	uterine fibromas	0
syzygium jambolanum	angiomatous meningioma	0
food supplementations	gastric cancer	0
beetroot	uterus cancers	0
ready-prepared food	substance-induced organic mental disorders	0
kawa kawas	syndrome	0
ocimum basilicum	rectum cancer	0
green pepper	cellulite	0
chenopodium quinoas	jakob creutzfeldt disease	0
contamination meat	brain disease	0
lemon grasses	barrett's syndrome	0
healthy nuts	breast dysplasia	0
diospyros digyna	oral cancer	0
turkey meat	mechanical low back pain	0
romaine	brain neoplasm	0
sea vegetables	central nervous system cysticercosis	0
dairy yogurt	mouth and tooth diseases	0
indian laburnum	seizure disorders	0
indian corn	substance-related disorders	0
grecian foxgloves	non-alcoholic fatty liver disease	0
lunch times	static tremors	0
grapefruit	micturition syncope	0
ribes nigrum	polymyositis ossificans	0
including cloves	neuritic plaques	0
cranberry sauce	mixed lymphocytic-histiocytic lymphomas	0
carya illinoensis	deep venous thrombosis	0
cucumis melo	toxic megacolon	0
colophospermum	crohn's enteritis	0
table sugar	mixed small and large cell lymphoma	0
digitalis	cancer of mouth	0
marshmallow	basal cell carcinoma	0
fruit-shaped marshmallows	anthrax	0
serve	resting tremor	0
ketchup	esophagus neoplasm	0
caryophyllus	cervix neoplasms	0
stevia	liver cancers	0
toronja	testicular cancers	0
study lavender	breast tumor	0
cauliflower	lung inflammation	0
illicium anisatums	schizophreniform disorders	0
orange tree	premature birth	0
apple tree	psychosis	0
national meat	osteoporose	0
plum trees	udpglucose hexose 1 phosphate uridylyltransferase deficiency	0
potassium-rich foods	macular dystrophies	0
club soda	pediatric cancers	0
dietary soybean proteins	miscarriage	0
soy proteins	urinary bladder diseases	0
dress	high blood pressures	0
chile pepper	mental disorder	0
molasses	passive tremor	0
syzygium cumini	hiatal hernias	0
grape seeds	chronic pains	0
solanum lycopersicum	hepatic neoplasms	0
gui zhi	frontal region traumas	0
tepary bean	aphthous stomatitis	0
dried foods	non-epileptic convulsion	0
bamboo shoots	chromosome 6-linked autosomal recessive parkinsonism	0
wild radish	zoonotic infection	0
tomato sauce	substance addiction	0
trace mineral	body weights	0
drink	diabetic complication	0
holy basils	status migrainosus	0
plantago	allergic diseases	0
cinnamomum trees	thyroid disease	0
celebration meal	inflammatory demyelinating polyneuropathy	0
safflower	chronic cluster headaches	0
rheum tanguticum	deep-vein thrombosis	0
origanum onites	human immunodeficiency virus	0
trigonella foenum-graecums	myocardial infarction	0
usda poultry	sudden cardiac death	0
low-salt diet	olfactory seizure	0
agent orange	salmonellosis	0
nut butter	acquired deafness	0
garcinia mangostanas	nafld	0
shiitake	kanners syndrome	0
common fruits	nbcc	0
white mallows	focal seizure	0
arachis hypogaea	physical suffering	0
beer	precordial catch syndrome	0
poppy	prion-induced disorder	0
healthiest vegetable	scorbutus	0
sweet pepper	amyloid deposits	0
cassia fistulas	fatigue	0
thymus vulgari	spinal meningioma	0
sesame oils	gall bladder diseases	0
domestic fowls	low back ache	0
sweetening agents	stomach cancers	0
cicer arietinums	disc degradation	0
piper methysticums	acute inflammatory demyelinating polyradiculoneuropathy	0
cereal grains	colon neoplasm	0
powdered sugar	dizziness	0
diet	static tremors	0
aÃ§aÃ­ berry	exudative bronchiolitis	0
hemp plant	muscular cramp	0
so-called vegetable	flatulence	0
taking vitamin	laron syndrome	0
moose meat	hirsutism	0
carbonated water	vulvar neoplasm	0
common olive trees	thyroid adenomas	0
spore	mixed cell lymphoma	0
eugenia cumini	intraepithelial carcinoma	0
citron trees	single seizure	0
kavas	toxico-infectious botulism	0
diospyro	degenerative neurologic disorder	0
bitter orange trees	mixed lymphocytic-histiocytic lymphoma	0
spice turmeric	diabetic asymmetric polyneuropathy	0
no noni	mptp-induced experimental parkinsonism	0
soy bean proteins	prostate neoplasm	0
taraxacum officinale	hiv	0
andira	inflammatory bowel disease	0
rosehip	lyme borreliosis	0
different fruits	female pattern baldness	0
tuna fish	human t lymphotropic virus type iii	0
retail meat	b-cell chronic lymphocytic leukemia	0
fuji apples	spinal meningioma	0
trigonella foenum-graecum	central obesities	0
acer negundos	pancreatic neoplasms	0
eugenia caryophyllata	lung inflammations	0
euterpe oleracea	undifferentiated carcinoma	0
dinner times	cardiac disease	1
food company	precordial catch syndrome	0
canned fruit	ovary neoplasm	0
mustard	foodborne illnesses	0
eugenia sandwicensis	develop cancer	0
fava bean	texidor's twinge	0
red cabbage	gall stones	0
bertholletia excelsa	rheumatoid spondylitis	0
cruciferous vegetable	cancer of the penis	0
elettaria	environmental cancer	0
amomum cardamomum	stomach cancer	0
sesame seeds	intracranial cns disorders	0
grilled meat	cranial pains	0
ocimum basilicums	different cancer	0
red tea	iddm	0
almond milk	liver neoplasm	0
english plantains	male infertility	0
corn	long sleeper syndromes	0
olive tree	craniocerebral injury	0
fat milk	insulin-dependent diabetes mellitus	0
largest meal	allergic diseases	0
marsh mallows	gorlin-goltz syndrome	0
chinese food	convulsive syncopes	0
nonus	prostatic adenomas	0
citrus medica	gnathostomiasis	0
poultry	dementia	0
clove	chronic daily headaches	0
squashe	cervicitis	0
daily fruit	female sub fertility	0
morinda citrifolias	fibromyositis-fibromyalgia syndrome	0
norus	zoonotic disease	0
jelly	senile plaques	0
breast milk	subwakefullness syndromes	0
chile peppers	multiple myositides	0
infects apples	lead poisonings	0
dioscorea polystachya	occipital region traumas	0
syzygium sandwicense	experimental parkinsonism	0
healthiest fruits	gall stones	0
exotic fruit	hepatic failure	0
box elders	precordial catch syndrome	0
cleistocalyx	experimental lung inflammation	0
drinking water	neuritic plaque	0
stuff	confusional state	0
greenery	reactive confusion	0
low-fat diet	circulatory failure	1
sweet basils	substance-related disorders	0
almond butter	schizophrenia	0
healthy snacks	bone fractures	0
yam	bipolar affective psychoses	0
cereal grain	galactosemia 2s	0
capsicum	phlebothrombosis	0
carrot	female infertility	0
food additives	kidney disease	0
burrito	epithelioid sarcomas	0
commercial milk	multiple meningiomas	0
leguminosae	essential tremors	0
soy beverages	retro-ocular headache	0
brown rice	barrett syndrome	0
myristica fragran	bacterial vaginoses	0
euterpe	psoriasis	0
chervil	study cancer	0
broth	rhabdomyolysis	0
cassia cinnamon	uterine neoplasms	0
black walnuts	cranial pains	0
triticum	back aches	0
crataegus monogyna	chronic b-cell leukemias	0
cherry plum trees	cardiovascular conditions	0
roasted almonds	nonspecific vaginitis	0
mustard plants	thyroid cancers	0
safflower oils	venereal warts	0
lentinus edodes	paroxysmal atrial fibrillation	0
raw poultry	lichen ruber planus	0
abelmoschus esculentus	gossypiboma	0
red yeast rice	glaucoma	0
trace elements	congestive heart failure	0
tomato juice	ductal carcinoma	0
mangifera indicas	intraepithelial neoplasms	0
neutraceutical	burkitt lymphoma virus	0
licorice	muscle disease	0
earl grey tea	age-related macular degenerations	0
crowberry	tactile hypesthesia	0
handling food	myelopathy	0
ready soybeans	hormonal dysfunction	0
machaerium	limb tremor	0
tofu	stroke	1
regular carrots	kidney stones	0
adhatoda vasica	dyslipoproteinemia	0
nicotiana tabacums	thermal hypesthesias	0
alcohol	mammary dysplasia	0
virgin olive	cryptogenic epilepsies	0
pimiento	confusion	0
cassia fistula	diffuse well differentiated lymphocytic lymphoma	0
junk foods	ekbom delusory parasitoses	0
granny smith apples	motor seizures	0
herbal tea	stokes adams syncope	0
lemon balm	age-related macular degenerations	0
mashed potatoes	sensory seizure	0
actual licorice	hemicrania migraine	0
natural vitamin	non alcoholic fatty liver disease	0
macadamia	infantile autism	0
foeniculum vulgares	paralysis agitans	0
syzygium aromaticum	urinary bladder cancer	0
concord grape	reverse cancer	0
hot peppers	rectum cancer	0
fermented cabbage	gastroenteritis	0
amomum cardamomums	polyarthritide	0
breakfast cereals	reticulolymphosarcoma	0
black pepper	renal cancer	0
horse nettles	urinary bladder neoplasm	0
salsa	fibrocystic breast disease	0
cantaloupe	small non-cleaved-cell lymphomas	0
ganja	hansens disease	0
contaminated foods	cancer of cervix	0
raisin bran	renal neoplasms	0
kava kavas	carotid sinus syncope	0
mock meats	retroviridae	0
purine-rich plant	microglandular adenosis	0
include flaxseed	strain	0
assai palms	salmonella infections	0
leaf lettuce	diabetic mononeuropathy simplices	0
aÃ§ai berry	dairy product intolerance	0
herbal teas	thyroid cancers	0
capsicum annuum	gasser syndrome	0
licorice root	paralysis agitans	0
healthiest beverage	sore throat	0
sour orange tree	anal ulcers	0
java plum tree	malignant meningiomas	0
eating food	brief reactive psychoses	0
health nuts	cluster headache syndrome	0
higher vegetable	secondary insomnia	0
spaghetti	focal seizures	0
food supplements	male pattern alopecia	0
pimenta diocias	faint	0
suggesting fruit	acute inflammatory demyelinating polyradiculoneuropathy	0
coriandrum sativum	guillaine barre syndrome	0
fava beans	metastatic cancer	0
citrus sinenses	vaginal cancer	0
rowanberry	aphthous ulcer	0
osmanthus	adolescent obesity	0
origanum	aphthous stomatitides	0
seafood	chronic lymphatic leukemia	0
red pepper	hypospadia	0
chenopodium quinoa	bacterial vaginoses	0
irritable bowel kiwi fruit	acquired immunodeficiency syndrome virus	0
barley	liver cancer	0
faba beans	familial dementia	0
almond	cephalalgia	0
dried pomegranate	campylobacter infection	0
whipped cream	sunburn	0
chewed coca	malignant brain neoplasm	0
wine	reducing cancer	0
dioscorea	polymyositis	0
melissa officinali	inflammatory polyneuropathy acutes	0
glycyrrhiza glabra	small noncleaved cell lymphoma	0
crocus	chronic obstructive lung disease	0
lamb chops	subfertility	0
malabar nut	paraesophageal hernia	0
flax seed	reproductive sterility	0
fake meat	salmonellosis	0
octopus	guam form of amyotrophic lateral sclerosis	0
tv dinners	periorbital headache	0
suggesting apple	episodic cluster headaches	0
papaver somniferum	neurologic degenerative conditions	0
sugar maple	tumor viruses	0
stem vegetables	endocrine breast diseases	0
zingiber officinales	insomnia disorders	0
ginger ale	neoplasm metastasis	0
meal time	stomach ulcer	0
cacao	gallbladder diseases	0
rabbit meat	sneezing	0
psyllium	pulmonary cancers	0
tempeh	non-b hepatitis enterically-transmitted non-a	0
fatty meal	premenstrual syndromes	0
syzygium jambos	sneeze	0
wild celeries	acute inflammatory demyelinating polyradiculoneuropathy	0
whole wheat	ekbom dermatozoic delusion	0
fresh ginger	intention tremors	0
lemon grass	semantic memory disorders	0
cassia trees	odontogenic keratocysts multiple basal cell nevi	0
cured meat	guillain-barrÃ© syndrome	0
pecan tree	gall bladder diseases	0
garlic	early detection of cancer	0
cranberry	food-borne disease	0
fresh basil	sea sickness	0
elettaria cardamomums	cancer of the mouth	0
emphasizes vegetables	enzootic bovine leukoses	0
prunus domestica	human t-lymphotropic virus type iii	0
zea	membranous cataracts	0
scallion	pyrosis	0
red peppers	utp hexose 1 phosphate uridylyltransferase deficiency	0
lens culinaris	mptp-induced experimental parkinsonism	0
thousand foods	jakob-creutzfeldt disease	0
soy protein	aortic aneurysms	0
dried apricots	hypoascorbemia	0
healthier foods	microglandular adenosis	0
lime	type i diabetes mellitus	0
carduus marianus	drug dependence	0
euterpe precatoria	contagious pustular dermatitides	0
black raspberries	drug addiction	0
barberry	lead poisonings	0
pleurotus ostreatus	fifth phacomatoses	0
jalapeno pepper	retrovirus	0
horsebean	insulin dependent diabetes mellitus	0
offal	retained surgical items	0
dragon fruit	hypermelanosis	0
nonfat meal	hiatus hernia	0
bitter nightshades	cancer of stomach	0
chamomile	aortic aneurysms	0
vegetable proteins	cancer of the kidney	0
texturized soy proteins	lymphadenopathy-associated viruses	0
cycad	hot flashes	0
beef	spinal meningiomas	0
dietary sugars	complete hearing loss	0
horsemeat	occipital traumas	0
ceratonia	gingivitide	0
chamomile oils	cramp	0
whale meat	uterine cervical neoplasm	0
salami	inflammatory bowel disease 1	0
drinking tea	amyotrophic lateral sclerosis parkinsonism dementia complex 1	0
camomile	cardiogenic syncopes	0
alfalfa sprouts	bilateral sciatica	0
pimenta	bone neoplasm	0
human milk	throat cancer	0
healthier meat	nbcc	0
blueberry	iritis	0
collard	igf-1 deficiency	0
carrot juice	thermal hypesthesias	0
pomegranate	gnathostoma infection	0
persimmon	phlebothrombose	0
flowering shrub	stomach ulcer	0
sugar substitutes	chronic lymphatic leukemia	0
triticum turgidum	esophageal neoplasms	0
golden raisins	degenerative intervertebral discs	0
century plant	mixed lymphocytic-histiocytic lymphoma	0
curcuma zedoarias	virus diseases	0
daucus carota	low back pains	0
mastic tree	cancer of thyroid	0
hypericum perforatum	central nervous system cysticercosis	0
coco	temporal region trauma	0
pineapple	degenerative disease	0
plantago lanceolata	acute monocytic leukemias	0
big meals	hemolytic jaundice	0
breast milks	radiating pain	0
foxglove	neurological condition	0
plant aril	early awakening	0
cycad trees	cancer of the vulva	0
brewed coffee	norwalk like viruses	0
jalapeno	premenstrual syndromes	0
wild yams	hereditary essential tremor	0
adding blueberries	insulin sensitivity	0
green teas	non b hepatitis epidemic non a	0
pear	small lymphocytic lymphoma	0
prunus amygdalus	myocardial infarcts	0
asparagus	halitose	0
cicer	female sub fertility	0
aspalathus linearis	cancer of mouth	0
cannabi	bowel diseases	0
fragaria vesca	multiple sclerosis	0
diospyros digynas	airsickness	0
hawthorn	morning sickness	0
cultivated radish	amyloid deposits	0
foenumgraecum	brain diseases	0
sweetening agent	endometrial cancers	0
prosopis	early awakening	0
molasse	hemorrhoid	0
carob	dyslipoproteinemia	0
spinacia oleracea	early onset parkinsonism	0
hemlock	migraine variant	0
fryer	breast fibrocystic change	0
added sweeteners	cerebrovascular strokes	0
prunus persica	leukemogenic viruses	0
lavandula angustifolia	premenstrual syndrome	0
isoglucose	cervical migraine syndrome	0
dark chocolate	central obesities	0
fragaria	cataract	0
cucumis sativus	national cancer	0
deep-fried foods	hemolytic uremic syndrome	0
brassica juncea	deep vein thrombosis	0
plantago arenaria	insulin deficiency	0
cocoa plants	cancer of the vulva	0
vicia fabas	unhealthy conditions	0
retail poultry	allergic reactions	0
purple rice	small non-cleaved-cell lymphomas	0
lettuce	gerd	0
citrus reticulatas	renal insufficiency	0
green beans	retained surgical needle	0
food companies	common cancer	0
mentha spicata	vulvar neoplasms	0
laciniate nightshade	paraesophageal hiatal hernia	0
egg	mild neurocognitive disorder	0
vaccinium bracteatum	endocrine breast diseases	0
afzelia	convulsive seizures	0
andean blackberry	impaired sensation	0
prunus dulcis	colorectal cancers	0
nut	clonic seizure	0
whiting	foreign objects	0
anacardium occidentale	oral disease	0
mesquite	proliferative bronchiolitides	0
spinach	colicky pain	0
dioscorea opposita	wheat allergies	0
maguey	psychogenic parasitoses	0
raphanus sativus	penis neoplasm	0
crab apple	numbness	0
bad foods	lung inflammation	0
narrow-leaved plantain	diabetes-related complication	0
plantain	pneumonitis	0
apple juice	diabetic asymmetric polyneuropathies	0
lavandula	cryptogenic epilepsy	0
oat	osteoporosis	0
berberis	atherosclerosis	0
mentha spicatas	cerebral strokes	0
cannabis indica	diabetes mellitus complication	0
pancake	hypoesthesia	0
hemp plants	ankylosing spondyloarthritis	0
psidium guajava	cervical migraine syndrome	0
whole grain cereal	ischemic heart disease	0
mustard seeds	oncogenic virus	0
english walnut	premature aging	0
carica papayas	macular degenerations	0
dried apple	respiratory infections	0
acai berry	pancreatitis	0
gluten	amyotrophic lateral sclerosis with dementia	0
little meat	retained surgical tool	0
olea europaea	preterm births	0
natto	diabetic autonomic neuropathy	0
indian gooseberries	sick headache	0
solanum	intertrochanteric fractures	0
mint tea	infantile autism	0
mentha x piperita	premenstrual syndromes	0
dried cranberries	cancer of the uterus	0
blueberry plants	human mammary neoplasms	0
aspartame	anaplastic carcinoma	0
dried yeast	plegia	0
maple	small cell lymphoma	0
eggplant	sleep initiation dysfunctions	0
plant-based nutrients	inappropriate gh secretion syndrome (acromegaly)	0
calling eggs	kanner's syndrome	0
lipomul	atherosclerotic plaques	0
glucose fructose syrup	hereditary galactokinase deficiencies	0
experience food	drunkenness	0
health food	recurrent brain tumors	0
coriandrum	muscle cramps	0
international nut	rheumatoid spondylitis	0
preserved foods	olfactory groove meningioma	0
sea food	bone neoplasm	0
goji berry plants	idiopathic proctocolitis	0
nuclear power plant	fusiform aneurysms	0
common olive tree	hyperthermia	0
marjoram plant	cystic breast disease	0
rhubarb	testis cancer	0
aloe	rectal tumor	0
chia seeds	soft tissue sarcoma	0
squash plant	mammary cancer	0
arachis	infant obesity	0
eat chocolate	prion-induced disorders	0
meal	bladder tumor	0
papaya	paratuberculosis	0
squid	visual seizure	0
cooked meats	bronchial asthma	0
high fructose maize syrup	painful menstruations	0
artificial sweetener	secretory meningiomas	0
garcinia mangostana	prostate neoplasms	0
replenish nutrients	diabetic polyneuropathies	0
curcuma zedoaria	burkitt herpesvirus	0
crataegus monogynas	syncopal episode	0
petroselinum	fibrose	0
frozen fruit	inflammatory bowel disease	0
carbonated drinks	starvation	0
dried peas	mixed lymphocytic-histiocytic lymphoma	0
vaccinium bracteatums	cervical migraine syndromes	0
extracted fruit	barretts esophagus	0
endive	jacksonian seizure	0
soy beans	chronic lymphocytic leukemias	0
lemon balms	skin cancer	0
dried plums	non hodgkin's lymphoma	0
cocoa powders	myelomatosis	0
vicia faba	impaired sensation	0
milk	thyroid neoplasm	0
cashew	decreased cancer	0
sweet foods	complications of diabetes mellitus	0
cola nitida	uterine cervical cancer	0
incorporates cloves	cancer of bone	0
milk thistle	kidney disease	0
salad	idiopathic parkinson disease	0
specific foods	cerebral strokes	0
hypericum perforatums	acute inflammatory polyradiculoneuropathies	0
sweet marjoram	burkitt's lymphoma virus	0
worldwide fruit	foreign bodies	0
soy cheeses	pustular psoriasis of palms and soles	0
radicchio	chromosome 6 linked autosomal recessive parkinsonism	0
citrus hystrices	atypical chronic myeloid leukemia	0
club sodas	blood cancers	0
monosodium glutamate	ekbom psychogenic parasitoses	0
pretzel	atheromatous plaques	0
pea families	tonic clonic seizures	0
brassica nigra	disorder	0
nut bar	non hodgkin's lymphoma	0
lactuca sativa	lower back pain	0
flavourer	lobar pneumonia	0
flammulina	preinvasive carcinoma	0
actual fruit	hansens disease	0
green onions	exudative bronchiolitides	0
low vitamin	primary gh resistance	0
cumin	abdominal obesity	0
boiled broccoli	bovine lymphosarcoma	0
healthiest nuts	thinness	0
dried fruit	colitide	0
potato chips	human papilloma virus	0
lemongrass	anxiety neuroses	0
bellis	lymphocytic lymphomas	0
dangerous plants	ache	0
sweetleaf	alopecia	0
anti-inflammatory plant	cognitive dysfunction	0
added nuts	kidney insufficiency	0
pickled foods	multiple head injury	0
hemp	substance use disorders	0
processed foods	urinary bladder disease	0
cruciferous foods	somatotropin hypersecretion (acromegaly) syndromes	0
anise tea	autosomal dominant juvenile parkinson disease	0
veal	nanism	0
cucumis melos	atrioventricular dissociation	0
pork	polymyositide	0
reason food	sensory seizures	0
cooked carrots	acquired deafness	0
carica	tonsil cancer	0
lemon	gout	0
dietary fiber	cancer of the skin	0
vegetable juice	familial creutzfeldt jakob disease	0
pease	liver diseases	0
willow tree	tonsil cancers	0
raw broccoli	metabolic acidoses	0
miso	age-related osteoporoses	0
msg	gastric cancers	0
mustard plant	water stress	0
steamer	tactile hypesthesias	0
raspberry	headache disorder	0
junk food	asthma	0
soda pop	fifth phacomatoses	0
oats	colorectal carcinoma	0
pistacia	type 1 diabetes	0
apium graveolens	endometrial carcinomas	0
gum acacia	bronchiolitis	0
tulsi tea	inflammatory demyelinating polyneuropathy	0
kenaf	lymphoma	0
millet	adolescent gynecomastia	0
chocolate	lewy body parkinson disease	0
cupcake	neuritic plaque	0
grecian foxglove	leucocythemia	0
wort	ocular headache	0
crab apples	water stress	0
cardamon	breast neoplasms	0
cultivated oat	leprosy	0
density foods	tactile hypesthesias	0
shiitake mushrooms	philadelphia-negative myeloid leukemias	0
raw tomatoes	somatotropin (acromegaly) hypersecretion syndromes	0
linum	dysmenorrhea	0
plant embryo	oncogenic viruses	0
acai berries	viral disease	0
pecan	peripheral autoimmune demyelinating disease	0
pinto beans	postoperative emesis	0
pistachio	perioral tremor	0
kiwi fruits	rodent ulcer	0
pinto bean	breast neoplasms	0
norovirus food	primary fibromyalgia	0
drinking milk	primary brain neoplasms	0
morning meal	spondylitis ankylopoietica	0
honeybush tea	ph1-negative myelogenous leukemia	0
pimpinella anisums	soft tissue sarcomas	0
venison	high cholesterol levels	0
empty calorie foods	textiloma	0
cookie	foodborne diseases	0
include fennel	epileptic seizure	0
big apples	leukemogenic virus	0
plantago indica	intractable headaches	0
cooked tomatoes	congenital defect	0
dietary proteins	apneas	0
plant zygote	lung cancers	0
chlorella	galactose-1-phosphate uridyl-transferase deficiency disease	0
new vitamin	dysosmia	0
hordeum vulgare	obesity in childhood	0
celery	tonsillar cancers	0
mangifera indica	urinary bladder disease	0
turnip	deep-venous thrombosis	0
poultry meat	bse (bovine spongiform encephalopathy)	0
green grapes	cancer of pancreas	0
brassica	diabetes mellitus complications	0
tobacco	galactose-1-phosphate uridyltransferase deficiencies	0
black sapote	inflammatory bowel disease	0
piper nigrum	sleep initiation dysfunction	0
maize oil	stomach neoplasms	0
mastic trees	penis cancer	0
food coloring	rachitide	0
neu5gc-rich food	inflammatory demyelinating polyneuropathy	0
fermented foods	lyssa	0
antioxidant food	visceral obesities	0
soft drinks	mastalgia	0
flax seeds	short sleeper syndromes	0
goji berry plant	forehead traumas	0
mother cell	fibrous meningiomas	0
thymus vulgaris	small non-cleaved-cell lymphomas	0
prunus armeniaca	deep-vein thromboses	0
guava	cardiac arrhythmia	0
caramel	guam form of amyotrophic lateral sclerosis	0
macadamia nut	delusional parasitosis	0
frier	human cancer	0
citrus-based fruits	emesis	0
poisonous plant	burning pains	0
prebiotic	cancer of the testis	0
st. johnswort	disc degradation	0
rose hips	undifferentiated lymphomas	0
acer negundo	human t cell leukemia virus type iii	0
seville orange tree	poisoning	0
chili peppers	acute strokes	0
alfalfa sprout	skin diseases	0
kava kava	tubal abortions	0
barley coffee	infection	0
cuminum cyminums	vaginal discharges	0
hazelnut	plasmodium infections	0
herb	chest pain	0
canned food	age-related maculopathy	0
dessert	orthostatic headaches	0
seville orange trees	enzootic bovine leukosis	0
fiddlehead ferns	malignant epithelial tumor	0
cynara scolymus	classic galactosemia	0
hickory nuts	determination of death	0
wheat bran	delusory parasitosis	0
lycium chinense	social anhedonias	0
cured meats	aphthous stomatitis	0
colorful foods	paraesophageal hiatal hernias	0
malus domestica	sprains and strains	0
basil	recurrence	0
ocimum sanctum	apoplexy	0
sweet almonds	phage	0
gooseberry	respiratory infections	0
solanum dulcamaras	cardiovascular disease	0
pomelo tree	emesis	0
yeast rice	neoplasm metastasis	0
olive oils	metastasis	0
foeniculum	sore throats	0
sea-food	urinary bladder neoplasm	0
chinese yam	cataract	0
sandwich	throbbing headache	0
cappari	venous thrombosis	0
arugula	toxic megacolon	0
official vitamin	craniocerebral traumas	0
not-necessarily-so-healthy foods	impaired sensation	0
hamburger	bacterial vaginosis	0
restrict food	neonatal tremor	0
roundup-ready soybeans	chronic fatigue and immune dysfunction syndrome	0
leek	kidney neoplasm	0
measuring food	prostate disease	0
assai palm berry	psammomatous meningioma	0
syzygium	ankylosing spondylitis	0
lycium barbarum	age related maculopathy	0
muffin	primary brain neoplasms	0
prunus salicina	wheat allergies	0
cuminum	cardiogenic syncopes	0
celeriac	atopic disease	0
pummelo tree	cerebrovascular apoplexy	0
dried blueberries	basal cell epithelioma	0
poroporo	rash	0
rubus glaucus	esophageal hernia	0
purslane	familial creutzfeldt-jakob diseases	0
shellfish	brain neoplasms	0
chickpea	mania	0
ocimum tenuiflorum	cerebral convexity meningioma	0
maize	neoplasm metastases	0
calendula officinali	deep vein thromboses	0
fortify milk	perforated appendicitis	0
acid-binding vegetables	johne disease	0
haritaki fruit	paraosmia	0
apricot	polymyositis ossificans	0
flaxseed	viral hepatitis	0
kawa kawa	radiating pain	0
emblica officinalis	social anhedonias	0
rye	creutzfeldt jacob disease	0
artificially-flavored corn	cholera	0
tarragon	action tremors	0
individual food	early diagnosis of cancer	0
broccoli	central nervous system cysticercosis	0
roselle	social anxiety disorders	0
drink tea	action tremor	0
soda pops	atheromatous plaques	0
coleslaw	wheat allergy	0
walnut	ekbom dermatozoic delusion	0
atropa belladonnas	sprains and strains	0
citrus aurantiifolia	acute confusional migraines	0
nitrate-rich vegetables	pharyngitis	0
dairy eggs	cystic disease of breast	0
zucchini	norovirus	0
calendula officinalis	muscle spasms	0
gmo soybeans	breast pains	0
coconut	pediatric obesity	0
chewing fruit	gingivitis	0
ice creams	spinal cord disease	0
cow's milk	galt deficiency	0
ananas	microglandular adenoses	0
cacao bean	rachitide	0
sesamum	ketosis prone diabetes mellitus	0
longevity legumes	adenomatous polyp	0
baker's yeast	congenital defects	0
golden delicious	basal cell epithelioma	0
sun-dried raisin	intervertebral disk degeneration	0
phaseolus acutifolius	male breast tumors	0
organ meats	lung disorders	0
vitis vinifera	colonic neoplasms	0
healthy fruit	regional ileitides	0
scrambled eggs	lymphadenopathy-associated virus	0
faba bean	terminal cancer	0
vinegar	colonic inertia	0
durum wheat	painful menstruation	0
celery root	renal failure	0
cinnamomum zeylanicum	tumor of rete testis	0
paprika	sciatica	0
dairy products	papillomaviridae	0
rooibos	diabetic retinopathies	0
safflower oil	amnesia-memory loss	0
eragrostis	bse (bovine spongiform encephalopathy)	0
pumpkin pie	xanthomatous meningiomas	0
chinese yams	relapse	0
apricot tree	cancer of the cervix	0
incorporate cloves	gout	0
breakfast cereal	lyme borreliosis	0
brussels sprouts	cattle leukemia virus	0
popular fruits	rectum cancers	0
marjoram	chronic obstructive lung disease	0
plant zygotes	ovary neoplasms	0
hashish	neuralgic migraines	0
healthiest beverages	pancreatic cancer	0
morel	chronic fatigue syndromes	0
andean blackberries	sleep initiation dysfunction	0
red lentils	galactose-1-phosphate uridylyltransferase deficiency	0
red meat	polyp	0
flavorer	bladder cancer	0
horse beans	muscle sorenesses	0
root	neurologic degenerative disease	0
unrefined plant	neurologic degenerative disease	0
ale	feminization	0
rheum officinale	hypoascorbemia	0
thymus plants	graveâ€™s disease	0
anchovy	cancer of the thyroid	0
solanum tuberosums	foreign object	0
citrus maxima	diabetic neuropathies	0
ultra-processed food	human t cell leukemia virus type iii	0
soy	benign prostatic hyperplasia	0
zedoary zedoaria	cervical migraine syndrome	0
cocos nucifera	radiating pain	0
plaice	respiratory tract infection	0
saccharomyces cerevisiae	amyloid deposits	0
fast foods	childhood onset obesity	1
salmonella-infected eggs	fibromyalgia fibromyositis syndrome	0
food allergy	coronary diseases	0
carya illinoenses	familial tremor	0
popcorn	pneumonia	0
chamomile tea	premature aging	0
fenugreek seed	bechterew disease	0
soup	cerebral convexity meningiomas	0
laudable legume	utp-hexose-1-phosphate uridylyltransferase deficiency disease	0
drinking orange	ovarian cancers	0
garden radish	tonic clonic seizures	0
plantago psyllium	sensory seizures	0
split pea	felv	0
chestnut	hiv	0
woodland strawberries	lung inflammation	0
mackerel	anal fissure	0
plantago seed	anaplastic carcinomas	0
beet greens	spinal meningioma	0
solanum tuberosum	degenerative neurologic disorders	0
shoot	age related osteoporosis	0
soymilk	perforated appendicitis	0
saint johnswort	congenital defect	0
spicy food	limb cramps	0
tree nuts	oncogenese	0
big food	meningotheliomatous meningiomas	0
phyllanthus emblica	male pattern alopecia	0
bread mold	coarse tremors	0
nicotiana	familial parkinson disease	0
kiwi fruit	parkinson disease	0
pudding	human papilloma virus	0
lemon balm tea	milk sugar intolerance	0
multivitamin	tussive syncopes	0
baptisia	cardiac disease	0
soft drink	leukovirus	0
dark meat	bowel diseases	0
processed meat	foodborne botulism	0
halibut	muscle spasm	0
berry	juvenile parkinsonisms	0
citrus bergamia	leprosy	0
bt corn	gasser syndrome	0
specific cheeses	atrial fibrillations	0
red meats	infertility	0
tangerine trees	mptp-induced experimental parkinsonism	0
sweetened cereal	infantile obesity	0
acaÃ­ berries	meningioma	0
spice saffron	diabetes mellitus complication	0
quinoa	severe mental disorder	0
white pepper	upper respiratory infections	0
eugenia jambolana	postural syncopes	0
assai palm	todd paralysis	0
nuclear power plants	mild cognitive impairment	0
seltzer waters	insulin-dependent diabetes mellitus	0
delonix	idiopathic polymyositides	0
agaricaceae	mammary cancer	0
dietary fibers	undifferentiated lymphoma	0
lunch time	small noncleaved-cell lymphoma	0
baby carrots	fibromyalgia-fibromyositis syndromes	0
high-fructose corn	benign brain neoplasms	0
ready prepared foods	odontogenic keratocysts multiple basal cell nevi	0
watermelon	peripheral artery disease	0
avena	crushing pain	0
chocolate bars	diabetic neuropathy	0
lemon trees	acquired immunodeficiency syndromes	0
nut butters	mild neurocognitive disorders	0
wild celery	peanut hypersensitivity	0
red wine	somatosensory seizure	0
antioxidant foods	cardiogenic syncopes	0
cannabis indicas	human herpesvirus 4 (gamma)	0
undercooked meat	endometrial carcinomas	0
fatty foods	small lymphocytic lymphomas	0
goji berries	spatial memory disorders	0
caffeinated coffee	hyperthermia	0
bok choy	oncogenic viruses	0
adhatoda	salmonella infection	0
cinnamon	acute myeloid leukemia	0
sticker	postoperative nausea and vomiting	0
dietary plant proteins	familial creutzfeldt-jakob diseases	0
cucurbita	diabetic asymmetric polyneuropathies	0
drug administration united states food	intracranial cns disorders	0
raw garlic	hemangiopericytic meningiomas	0
black tea	gastric ulcer	0
soy foods	decreased cancer	0
lycopersicon esculentum	intraventricular meningiomas	0
peach tree	senile osteoporosis	0
new candy	substance use disorder	0
sauerkraut	degenerative intervertebral disk	0
red delicious apples	bovine leukemia virus	0
drinking coffee	human papillomavirus viruses hpv	0
rubus fruticosus	bovine leukosis	0
biometal	chronic cystic mastitis	0
sour cream	prion diseases	0
tumeric	endocrine breast diseases	0
vegetable oil	diffuse mixed-cell lymphoma	0
rubus idaeus	amaurosis	0
cannabis sativa	pruritus	0
jasmine tea	diabetic complications	0
thymus	varicose veins	0
saint johns wort	lens opacities	0
agave	basal cell nevus syndrome	0
citrus paradisi	iron deficiency	0
liquor	histamine cephalgia	0
milk protein	cellulite	0
lens culinari	pseudopelade	0
carbonated mineral water	visual seizure	0
cymbopogon	colicky pain	0
eating eggs	severe mental disorder	0
century plants	hyperphagia	0
deli meat	dyslipidemia	0
wild yam	head traumas	0
hypericum	sliding hiatal hernia	0
antioxidant-rich food	cancer of testis	0
low fruit	enterocele	0
petroselinum crispums	peripheral artery disease	0
hummus	breast malignant tumors	0
marsh mallow	bse (bovine spongiform encephalopathy)	0
melissa	gluten enteropathies	0
vaccinium angustifolium	adenomatous polyp	0
black currant	amaurose	0
phaseolus vulgaris	intracranial cns disorder	0
portulaca oleracea	scorbutus	0
snail meat	static tremor	0
black walnut	stomach cancers	0
red onions	palsy	0
mangifera	joint pains	0
narrow leaved plantain	malignant tumor of urinary bladder	0
bhang	central nervous system cysticercosis	0
recommend tea	thyroid neoplasms	0
nutriceutical	stomach ulcer	0
carica papaya	anhedonia	0
citrus sinensis	pituitary dwarfism iis	0
healthy foods	sharp headaches	0
convenience foods	epimerase deficiency galactosemias	0
yerba mate	pulmonary disease	0
cicer arietinum	spatial memory disorder	0
rosemary	lou gehrig disease	0
cooking oil	renal failure	0
black sapotes	zoonotic infectious diseases	0
coffee	malignant lymphomas	0
vaccinium uliginosum	crohn's disease	0
vaccinium virgatum	chronic daily headaches	0
cannabis	convulsion	0
bread	cancer of the colon	0
juglans regia	verruca	0
decrease meat	coronary heart disease	0
silybum marianums	arthritide	0
onion	dehydration	0
cocktail	heart attack	0
sparkling water	foreign objects	0
food and drug administration	alactasia	0
indian gooseberry	small noncleaved-cell lymphomas	0
carthamus tinctorius	retained surgical item	0
rice	allergy	0
topical ginger	diverticulosis	0
calendula	cerebrovascular accidents	0
citrus hystrix	gall bladder disease	0
rise	microglandular adenoses	0
sustenance	thyroid neoplasm	0
syrup	cancer of mouth	0
baby formulas	ekbom delusional parasitoses	0
whole grain	chronic lymphocytic leukemia	0
rheum	malignant primary brain neoplasms	0
aspalathus	parkinson's disease	0
abelmoschus	acute confusional migraines	0
orange juice	posterior fossa meningiomas	0
malus	campylobacter infections	0
sugary foods	thyroid adenomas	0
mango	drug hypersensitivities	0
sugar substitute	postviral fatigue syndromes	0
silybum marianum	communicable disease	0
dried food	acquired immuno-deficiency syndromes	0
bibhitaki fruit	constipation	0
kawa	gingivitis	0
citronella	back pain	0
dressing	constrictive bronchiolitis	0
peanut	udp-galactose-4-epimerase deficiency disease	0
snack	cancer of the breast	0
jelly beans	exudative bronchiolitides	0
plant capsules	diabetic neuralgia	0
caper	lung diseases	0
solanum melongenas	plasmodium infection	0
white bread	todd's paralysis	0
apricot trees	hypertension	0
raphanus raphanistrum	diabetic autonomic neuropathies	0
high-fat meal	bronchial asthma	0
bertholletia excelsas	breast diseases	0
eugenia jambos	spinal meningiomas	0
cocoa plant	chronic airflow obstruction	0
secale cereale	cervical neoplasm	0
ovary	mouth neoplasms	0
oregano plant	dyslipidemia	0
butternut squash	campylobacter infection	0
maraschino cherry	respiratory tract infections	0
poenumgraecum	experimental lung inflammations	0
bean sprout	paroxysmal atrial fibrillations	0
healthiest foods	migraine headaches	0
uncooked food	reducing cancer	0
acer saccharum	fatigue	0
fructose corn	e-b virus	0
foeniculum vulgare	chronic pains	0
swordfish	xanthomatous meningiomas	0
aÃ§ai berries	cardiac diseases	1
citron tree	brain neoplasms	0
ephedras	cephalgia syndromes	0
nettle	cranial pain	0
pea	autoimmune disease	0
fresh meat	cancer of mouth	0
plum tree	gustatory seizures	0
mandarin orange trees	chest pain	0
ice cream	salami brusher's disease	0
national pork	sleep wake disorders	0
ground ginger	breast pains	0
honey	cognitive dysfunction	0
sweet potatoes	brain malignant neoplasms	0
term vegetable	oncogenic virus	0
arginine-rich foods	bladder neoplasms	0
grouper	preventable cancers	0
chewing gums	neurologic degenerative disease	0
english plantain	rest tremor	0
seed	lyme arthritis	0
avocado fruit	urinary bladder neoplasms	0
intoxicant	child obesity	0
kohlrabi	cjd (creutzfeldt jakob disease)	0
vaccinium corymbosum	verruca	0
origanum majorana	broken bone	0
component spices	different cancer	0
wild bananas	circulatory collapse	0
high-fiber food	cretinism	0
sea vegetable	brain neoplasm	0
chewing gum	cystic disease of breast	0
decaf	cervix neoplasm	0
crunch berries	uterine cervical neoplasm	0
kidney bean	cancer of breast	0
vaccinium myrtillus	viral diseases	0
diabetic diet	dwarfism	0
vodka	benign prostatic hypertrophy	0
pumpkin	chronic b-lymphocytic leukemias	0
betel	prostatic neoplasms	0
althaea	manic depressive psychoses	0
individual candy	migratory pains	0
theobroma cacao	lung inflammation	0
food manufacturers	jakob creutzfeldt disease	0
cider vinegar	parkinsonism-dementia complex of guam amyotrophic lateral sclerosis	0
opium poppy	intention tremors	0
pithecolobium	splitting pain	0
juglans nigra	galt deficiencies	0
sparkling waters	non b hepatitis epidemic non a	0
true nut	muscular cramps	0
tea plant	vaginal discharges	0
corn oils	fibromyalgia-fibromyositis syndromes	0
color	arrhythmia	0
billion eggs	food hypersensitivity	0
four nuts	foreign bodies	0
frying meat	renal insufficiency	0
yellow vegetables	fifth phacomatoses	0
spearmint	diverticulosis	0
cereal	leucocythaemia	0
triticum durum	diffuse lymphomas	0
black currants	idiopathic polymyositis	0
squash plants	spinal meningioma	0
soda water	rabies	0
tea	charcot disease	0
meal times	paroxysmal atrial fibrillation	0
tachigalia	prediabetic states	0
petroselinum crispum	vaginal neoplasm	0
nicotiana tabacum	crushing skull injury	0
cayenne pepper	action tremors	0
candy bars	gorlin-goltz syndrome	0
brewing tea	low-grade lymphoma	0
punicaceae	emphysema	0
mustard oil	mottled enamels	0
rose	acute inflammatory demyelinating polyradiculoneuropathy	0
prosopi	colon neoplasm	0
lard	testis neoplasms	0
watercress	sarcopenia	0
oreo	penis cancers	0
golden glow	texidor twinge	0
food allergies	pancreatic cancers	0
citrus aurantium	cystic breast disease	0
sweet almond	dwarfism	0
curcuma longa	hiv	0
crave chocolate	cervix neoplasms	0
chamomile oil	broken bones	0
ceylon cinnamon	aura	0
mint	wound botulisms	0
skim milk	urticaria	0
texturized soy protein	b-cell chronic lymphocytic leukemia	0
salmonella food	guam disease	0
almond oil	multiple head injury	0
zingiber officinale	syncopal vertigo	0
oolong tea	carsickness	0
cocos nuciferas	food-borne diseases	0
ranking foods	visual seizure	0
pleurotus	cancer of the uterus	0
flesh foods	drunkenness	0
mangiferas	ekbom delusory parasitoses	0
corylus	uterine cancer	0
sprout	right sided heart failure	0
hydroponic basil	starvation	0
maize syrup	bses (bovine spongiform encephalopathy)	0
brain-invasive pork	auricular fibrillations	0
organ	substance-induced organic mental disorders	0
foie gras	crushing pains	0
sweet peppers	mixed-cell lymphomas	0
white rice	charcot disease	0
sour orange trees	fibromyalgia-fibromyositis syndrome	0
euterpe oleracea mart.s	thyroid diseases	0
dietary protein	open head injuries	0
carbonated drink	cerebrovascular accidents	0
french bean plants	tonic seizure	0
steak	male sexual impotence	0
cooking meat	epilepsy	0
fenugreek seeds	lymphatic sarcomas	0
pimpinella	gastric acid reflux disease	0
monitoring food	massive tremors	0
ilex paraguarienses	alcoholism	0
majorana hortensis	weight gain	0
olive	jakob-creutzfeldt syndrome	0
betel nuts	oral cancers	0
happy meal	campylobacter infections	0
soda waters	pus	0
fagopyrum	fatigue	0
baked potato	small cell lymphoma	0
durum wheats	rectal cancer	0
oyster mushrooms	multiple meningioma	0
fast food	celiac disease	0
dried apples	liver cancers	0
soy cheese	transmissible dementia	0
shan yaos	chronic infectious mononucleosis like syndrome	0
deli meats	renal insufficiency	0
digitalis purpurea	epithelial cancers	0
reindeer meat	hypoxia	0
catfish	acute myeloid leukemia	0
sesame	poisoning	0
broccoli raab	hormonal dysfunction	0
domestic fowl	manic-depressive psychoses	0
avoid peanuts	penile cancer	0
juglan	blood cancer	0
preserved food	senile paranoid dementias	0
saffron	rna tumor viruses	0
maize oils	inappropriate growth hormone secretion syndrome (acromegaly)	0
oatmeal	benign neoplasms	0
kale	renal cancers	0
deep-fry foods	myocardial infarction	0
areca catechus	symptom clusters	0
squash seeds	fibromyalgia-fibromyositis syndrome	0
nutraceutical	arthralgia	0
sweet basil	lassitude	0
white meat	pituitary dwarfism ii	0
cheese	amyotrophic lateral sclerosis motor neuron disease	0
blackberry	creutzfeldt-jakob syndrome	0
star anise	male sexual impotence	0
soy yogurt	familial creutzfeldt-jakob disease	0
foodstuff	convulsive seizure	0
oryza	rabies	0
candy bar	breast fibrocystic disease	0
chipotle	female sub-fertility	0
milk thistles	galt deficiencies	0
mirobalanus embilica	urinary bladder cancer	0
origanum vulgare	heart diseases	0
croaker	kidney calculi	0
lycium	gout	0
citrus	female sub fertility	0
antioxidant vitamin	erectile dysfunction	0
lima beans	galactokinase deficiency	0
fat foods	uterine fibromas	0
mustard greens	paroxysmal atrial fibrillation	0
cortland	tumor	0
new york coalition for healthy school food	lymphadenopathy-associated virus	0
secale	chronic airflow obstructions	0
pomegranate fruit	insomnia	0
soy sauce	primary gh resistance	0
trigonella	reduced sensation	0
decaffeinated tea	apnea	0
raw alfalfa	campylobacter infection	0
ginger	central nervous system intracranial disorders	0
cocoa	e b virus	0
flower	global amnesia	0
musa	insulin resistance	0
nori	cva (cerebrovascular accident)	0
amygdalus communis	chronic lymphatic leukemia	0
dinner time	menstrual pain	0
pizza	histamine cephalgias	0
no meat	post traumatic osteoporosis	0
hibiscus cannabinus	bechterew disease	0
potato	autosomal dominant juvenile parkinsonism	0
kidney beans	cephalalgia	0
pomegranate seeds	acute monoblastic leukemia	0
wheat brans	male breast cancer	0
capparis	hereditary galactokinase deficiency	0
prettiest fruit	b12 deficiency	0
margarine	intermittent tremor	0
areca nuts	ovarian cancer	0
warm milk	low-grade b-cell malignancy	0
cider	hypersensitivity	0
handling meat	sinusitis	0
dioscorea villosa	cough	0
low-calorie diet	inherited human transmissible spongiform encephalopathies	0
butter milk	degenerative arthritis	0
baking chocolate	ischemic heart diseases	0
unhealthy food	intracranial cns disorders	0
healthy food	obesity in childhood	0
common bean plants	fibromyositis-fibromyalgia syndromes	0
pistacia lentiscus	leucocythemia	0
dietary supplementations	painful diabetic neuropathies	0
althaea officinalis	mild cognitive impairment	0
monkfish	brain disorder	0
baby formula	insulin resistance	0
milkshake	ankylosing spondylarthritides	0
rosa	renal insufficiencies	0
plantago ovata	disk degradation	0
mirobalanus embilicas	intraepithelial prostatic neoplasia	0
anacardium occidentales	polymyositis	0
currant	colitis	0
phaseolus vulgari	fever	0
poultry product	mesothelioma	0
group foods	thyroid carcinomas	0
citrus grandis	long sleeper syndromes	0
oolong	pancreas cancers	0
rooibos tea	hypoascorbemia	0
olive family	esophagus cancers	0
white potatoes	premenstrual syndrome	0
olive oil	cryptogenic epilepsy	0
eating meat	minor head injuries	0
kola nuts	non-alcoholic fatty liver disease	0
hickory nut	hepatic neoplasm	0
artificial sweeteners	temporary amnesias	0
crataegus	nonhodgkin lymphoma	0
canned foods	back pains	0
grape juice	cervical cancer	0
placenta	gnathostoma infection	0
brassica napus	neoplasm metastases	0
antioxidant-rich foods	tonsillar cancers	0
contaminated meat	non-hodgkin's lymphoma	0
sorrel	udpglucose 4-epimerase deficiency disease	0
eggnog	non epileptic convulsion	0
cola acuminata	age-related osteoporoses	0
saint john wort	cardiovascular strokes	0
plant foods	stokes-adams syncope	0
mentha	body weights	0
citrus aurantiifolias	hansen's disease	0
high-fructose maize syrup	angioblastic meningioma	0
mushroom	behavior disorders	0
cola	male sub fertility	0
animal-based foods	venous thrombosis	0
restructured meat	spinal meningiomas	0
zedoary zedoarias	saturnine tremors	0
prunis communis	udpglucose hexose 1 phosphate uridylyltransferase deficiency	0
areca	ovarian cancers	0
treat	diffuse mixed-cell lymphoma	0
fenugreek	vertiginous seizure	0
soybean	craniocerebral trauma	0
clathrotropis	chronic lymphoblastic leukemia	0
lemon tree	intermittent tremor	0
phyllanthus emblicas	manic depressive psychoses	0
whortleberry	papillomaviridae	0
edible grain	ramsay hunt paralysis syndrome	0
portulaca oleraceas	familial dementias	0
specific nuts	lymphocytic leukemia	0
bell pepper	neoplasm metastases	0
cod	microglandular adenoses	0
seltzer water	muscular spasm	0
purple grape	leukovirus	0
taraxacum	paraesophageal hernia	0
larder	aphthous stomatitides	0
okra	multiple head injury	0
gravy	mouth neoplasm	0
low-sodium diet	migraine disorders	0
rose berries	muscle tremors	0
romaine lettuce	secondary fibromyalgia	0
artichoke	colorectal cancer	0
morinda	oncornavirus	0
shiitake mushroom	renal calculus	0
organic meat	sea sickness	0
almond tree	galk deficiencies	0
dietary plant protein	clear cell meningiomas	0
infant formulas	starvation	0
cardamom	aphthous stomatitis	0
turmeric	uterus neoplasm	0
energy drinks	low-grade lymphoma	0
chili pepper	prostate cancers	0
portulaca	osteoarthrosis	0
bean	chronic fatigue disorders	0
dairy product	gehrig disease	0
jam	hyperventilation syncope	0
coconut water	drug allergy	0
justicia	gnathostoma infections	0
oyster mushroom	ovary neoplasms	0
vital nutrients	ischemic heart diseases	0
orange trees	acidosis	0
garlic sauce	gallbladder diseases	0
little saffron	syncopal vertigos	0
stryphnodendron	saturnine tremors	0
oryza sativa	familial atrial fibrillations	0
toxic plants	migratory pains	0
prenatal vitamins	obesity in adolescence	0
tap water	amyloid plaque	0
pistacia vera	myocardial ischemia	0
convenience food	massive tremor	0
allium sativum	renal insufficiency	0
dried fruits	pancreatic neoplasm	0
citrus aurantiums	strain	0
thyme	a v dissociation	0
gala apples	primary brain neoplasms	0
anacardium	cardiovascular disease	0
filbert	adolescent obesity	0
probiotic	emphysema	0
eugenia aromatica	infantile obesity	0
elettaria cardamomum	plasma cell myeloma	0
soy food	jakob creutzfeldt disease	0
feather meal	esophagus cancers	0
ground flax	atheromatous plaques	0
weekly meat	ponv	0
potable water	diffuse lymphomas	0
raw meat	endometrioma	0
vegetable protein	anxiety neuroses	0
raw foods	gastroenteritide	0
eat flax	autoimmune disorders	0
rooibo	cancer of the rectum	0
cassia tree	muscle tremors	0
healthiest apple	manic disorder	0
cooked broccoli	carcinogenese	0
table salt	necrotizing fascitis	0
pithecellobium	blood clots	0
fagopyrum esculentum	lung inflammation	0
weed	diffuse small cleaved-cell lymphoma	0
mandarin orange tree	e-b virus	0
persea americana	hiatus hernia	0
phytonutrient-rich food	prostatic intraepithelial neoplasms	0
soy bean curd	environmental cancer	0
walnut oil	chronic pain	0
plant-based foods	atrial fibrillations	0
ephedra	torsion fractures	0
sunfish	mammary cancer	0
justicia adhatoda	spinal cord disorders	0
proteus mirabilis	static tremors	0
erythroxylon	prostatic hypertrophy	0
cherry	bacterial infection	0
chanterelle	body weights	0
chicken	gynecomastia	0
horse nettle	sore throat	0
orange	osteoporosis	0
citrus grandi	psammomatous meningiomas	0
trace minerals	stokes-adams syncopes	0
sockeye salmon	tonsil neoplasm	0
lavender	bovine spongiform encephalitis	0
pickled vegetables	lobar pneumonias	0
dietary fat	familial dementias	0
target vitamin	temporal region trauma	0
processed meats	back aches	0
uncooked foods	lens opacities	0
citrus limon	transient insomnia	0
macadamia nuts	periorbital headache	0
organic plants	secretory meningiomas	0
peach	abdominal cramp	0
dinner	nervous system degenerative diseases	0
apium graveolens var. rapaceum	wart	0
buttermilk	deficiency diseases	0
soybean proteins	hernia	0
wheat	drunkenness	0
milk chocolate	muscle cramps	0
filtered coffee	liver cancers	0
cinnamomum aromaticum	aura	0
pasta	familial parkinson disease	0
banana plants	myocardial failure	0
ground meat	fusiform aneurysms	0
raw food	spiral fractures	0
chilli pepper	vestibular seizures	0
unfertilized eggs	auricular fibrillations	0
tuna	congenital myxedema	0
common bean plant	guam disease	0
amaranth	guillaine-barre syndrome	0
cocoa butter	breast malignant tumors	0
banana	neurologic degenerative condition	0
green peas	experimental parkinson disease	0
purple cabbage	benign prostatic hypertrophy	0
chocolate pudding	sarcopenia	0
buckwheat	early onset parkinson disease autosomal recessive	0
cocoa powder	arthrose	0
cucumber	primary insomnia	0
anise	myocardial infarctions	0
syzygium malaccense	premature birth	0
mealtime	guam disease	0
drink milk	arthralgia	0
trace element	arthralgia	0
st. john's wort	rhabdomyolysis	0
eragrostus	constrictive bronchiolitis	0
purple potatoes	protein deficiency	0
solanum laciniatum	fibromyositis-fibromyalgia syndromes	0
wheatgrass	vaginal cancer	0
curcuma longas	gastroenteritis	0
acer	chronic lymphoblastic leukemias	0
edible grains	uterine fibromas	0
roughage	head trauma	0
silken tofu	malignant meningioma	0
pimenta officinali	human immunodeficiency viruses	0
leafy vegetables	fever	0
last meal	fibromyositis-fibromyalgia syndromes	0
sardine	terminal cancer	0
rubberplant	ovarian neoplasms	0
mayo	subtrochanteric fractures	0
guibourtia	tremor	0
kangaroo meat	esophagitide	0
food poisonings	mouth neoplasm	0
punica granatum	sleep related neurogenic tachypnea	0
pomelo trees	a-v dissociations	0
carya	oral neoplasm	0
fries	back pains	0
brewage	philadelphia-negative myeloid leukemias	0
sell meat	substance abuse	0
shorten	cognitive impairment	0
bran flakes	liver disease	0
common foxglove	reticuloendotheliosis virus	0
yoghurt	paraosmia	0
nut bars	small round structured viruses	0
illicium anisatum	chronic b lymphocytic leukemia	0
bergamot	sarcoma	0
anana	bowel disease	0
white tea	arrhythmia	0
sea bilberry	tonsillar cancer	0
pineapple juice	well-differentiated lymphocytic lymphoma	0
cruciferous vegetables	epileptic seizure	0
legume pods	steatohepatitis	0
gluten-free diet	parkinson's disease	0
hickory tree	tongue neoplasm	0
kombucha teas	primary brain tumors	0
osmanthus tea	male breast carcinoma	0
hot sauce	oral neoplasms	0
black beans	small round-structured viruses	0
morinda citrifolia	sleep related neurogenic tachypnea	0
powdered ginger	breast tumors	0
curried tofu	chronic headaches	0
sausage	wheat hypersensitivity	0
bolete	reducing cancer	0
exotic fruits	penile cancer	0
soy milk	pituitary dwarfism ii	0
frying foods	common colds	0
coriander	encephalopathy	0
paella	fusiform aneurysms	0
citrus fruit	painful diabetic neuropathy	0
acacia tree	tonsillar cancer	0
avenas	canker sore	0
bacon	gluten enteropathies	0
broad beans	liver dysfunction	0
mentha piperita	auto-immune diseases	0
real chocolate	congenital defects	0
chinese cassia	cancer of cervix	0
unfiltered coffee	chronic fatigue-fibromyalgia syndromes	0
frequent meals	reduced sensations	0
garbanzo	guillaine-barre syndrome	0
teff	myeloma multiple	0
prunus cerasifera	ovarian cancer	0
citrus bergamias	cardiac failure	0
eupatorium rebaudianums	rectal neoplasms	0
green peppers	foodborne botulism	0
vitamin pills	insulin-dependent diabetes mellitus	0
dandelion	intracranial meningiomas	0
anticancer plant	cervical migraine syndromes	0
chicken meat	diabetes related complications	0
noncaloric sweetener	joint diseases	0
high-phytate foods	chronic gum disease	0
fennel	foodborne botulism	0
citrus x paradisi	ponv	0
yogurt	autistic disorders	0
althea officinalis	horton syndrome	0
woodland strawberry	craniocerebral injuries	0
alcoholic beverages	tonsillar cancer	0
chard	cat leukemia viruses	0
pepsi	pleomorphic lymphomas	0
jerusalem artichokes	darkness tremor	0
beta vulgaris	diffuse mixed small and large cell lymphoma	0
narrow-leaved plantains	low back ache	0
allspice	parkinson disease	0
tisane	anemia	0
coconut milk	darkness tremors	0
fried foods	diabetic neuropathy	0
bottled water	limb cramp	0
fruit juice	sexual dysfunction	0
energy drink	constipation	0
iceberg lettuce	weight gain	0
pimenta officinalis	severe mental disorder	0
rubus	congenital defect	0
soy bean	somatotropin hypersecretion (acromegaly) syndromes	0
curry	intention tremor	0
bitter nightshade	leanness	0
indian laburnums	degenerative disease	0
blueberry plant	ciliary neuralgia	0
plum	prostatic neoplasm	0
pistachio nut tree	familial guillain-barre syndrome	0
family vegetables	cystic disease of breast	0
find pork	recrudescence	0
peppermint	sprue	0
phaseolus	disk degenerations	0
conventional food	papillomaviridae	0
ground beef	small lymphocytic lymphoma	0
caryophyllus aromaticus	fibrocystic breast disease	0
fabaceae	gustatory seizure	0
philadelphia cream cheese	genital warts	0
artificial butter	disorientation	0
curry powder	et-nanbh	0
digitalis lanata	apneas	0
vegetable juices	familial dementia	0
citrus medicas	central obesity	0
lunchtime	cancer of the testes	0
wisconsin milk	crushing skull injuries	0
solanum dulcamara	bovine leukoses	0
lens plant	small-cell lymphoma	0
use sweeteners	cancer of the tonsil	0
favorite meals	severe mental disorders	0
sunchoke	utp hexose 1 phosphate uridylyltransferase deficiency	0
raw cranberries	senile tremors	0
almond trees	neurologic degenerative condition	0
healthiest snack	ekbom delusory parasitosis	0
yolk	neoplasia	0
cultivated oats	meningotheliomatous meningiomas	0
citrus fruits	type c oncovirus	0
golden delicious apples	cancer of the esophagus	0
radish	zoonotic infections	0
portulaca oleracae	severe gh insensitivity	0
hordeum	wound botulism	0
saint john's wort	metastatic cancer	0
horsenettle	human influenza	0
coconut oil	legal blindness	0
laciniate nightshades	stomach cancer	0
bagel	neurological condition	0
corn sugar	sciatic neuralgia	0
raphanus	non hodgkins lymphoma	0
emblica officinali	intraventricular meningioma	0
ready-to-eat meal	bipolar depression	0
eating fruits	right sided heart failure	0
pistil	constipation	0
corn oil	breast tumor	0
french fries	acute fulminating multiple sclerosis	0
beet	paraesophageal hiatal hernia	0
collard greens	disk degradations	0
dietary supplements	gastric cancers	0
california avocado	drop attacks	0
fagopyrum tataricum	prostatic cancers	0
snack foods	postural syncopes	0
chinook salmon	respiratory tract infections	0
eating nuts	inflammatory disorder	0
animal food	microcystic meningioma	0
illicium verum	igf-1 deficiency	0
texturized vegetable proteins	virus infections	0
food additive	diffuse well-differentiated lymphocytic lymphoma	0
coca cola	abdominal cramp	0
hop	small non-cleaved-cell lymphomas	0
carbonated beverage	food hypersensitivities	0
horse bean	gallbladder diseases	0
humulus	body weight	0
different seed	numbness	0
inadequate fruit	pulmonary embolisms	0
cabbage	bacteriophage	0
peanut butter	gingivitide	0
banana plant	status migrainosus	0
pie	polyphagia	0
chilli peppers	birth weights	0
peppermint oil	schizophrenic disorders	0
coriandrum sativums	water borne hepatitis	0
whole foods	cow disease	0
sugar water	carotid sinus syncopes	0
brazil nuts	epileptic seizure	0
ilex paraguariensis	cancer of ovary	0
piper methysticum	hair loss	0
seven nutrients	emesis	0
jambolan plum tree	grippe	0
sesame oil	varicose veins	0
glycyrrhiza	alopecia cicatrisata	0
punica granatums	nasal cavity cancer	0
yerba mates	precordial catch syndrome	0
allium cepa	hiccough	0
malabar-nut	b-cell leukemia	0
amla	tongue neoplasm	0
atropa belladonna	brain neoplasms	0
red delicious	venous thrombosis	0
kola nut	non-epileptic convulsion	0
cymbopogon nardus	anthrax	0
processed food	neurodegenerative disorder	0
mother cells	prostatitis	0
dinnertime	diverticulitis	0
beta vulgari	mucous colitides	0
food pyramid	terminal ileitis	0
bean sprouts	rectum neoplasm	0
cream cheese	post ictal confusion	0
turmeric root	recurrence	0
cayenne peppers	sore throat	0
trompillo	leukovirus	0
good soybeans	posterior compartment low back pain	0
antioxidant fruits	ekbom delusional parasitoses	0
plant capsule	udp-galactose-4-epimerase deficiencies	0
grapefruit juice	subfertility	0
liquorice	gum disease	0
squash	skin rash	0
blossom	hansen disease	0
rutabaga	lung inflammation	0
legume family	severe congenital microcephalies	0
apium graveolens var. dulce	schizophreniform disorder	0
processing meat	cervical migraine syndromes	0
marjoram plants	persistent atrial fibrillation	0
baby spinach	zoonosis	0
vaccinium macrocarpons	acquired immuno-deficiency syndrome	0
chicken salad	mental deteriorations	0
vaccinium macrocarpon	colorectal tumors	0
kombucha tea	esophageal neoplasm	0
chili	type 1 diabetes	0
lemon verbena	bovine lymphomas	0
split peas	oxygen deficiency	0
berberi	chronic pain	0
marihuana	cervical migraine syndromes	0
own vitamin	female sterility	0
saffron crocus	cancer of pancreas	0
lentil	bacterial vaginitis	0
star anises	hypolactasia	0
japanese plums	sarcopenia	0
food colors	drug addiction	0
apple	amyloidose	0
euchresta	cat leukemia viruses	0
pisum sativum	cognitive retention disorder	0
carbonated beverages	breast cystic diseases	0
zinger tea	diabetic mononeuropathy	0
smoked food	degenerative intervertebral discs	0
consumed chocolate	muscle soreness	0
sweeten	nonorganic insomnia	0
glycine max	colon cancer	0
citrus reticulata	male pattern alopecia	0
brazil nut tree	early-onset parkinsonism	0
aÃ§aÃ­ berries	acute coryza	0
entree	bovine leukemia virus	0
english walnuts	involutional osteoporosis	0
papaver	phlebothrombose	0
american meat	polymyositis	0
linum usitatissimum	complete hearing loss	0
nightshade	hysterical amnesias	0
consumer protection scientific committee on food	myocardial failure	0
organic milk	hepatocellular cancers	0
organic food	rectum cancers	0
chai tea	post ictal confusion	0
illicium	cancer of colon	0
vaccinium ashei	acute strokes	0
zea mays	acquired immune deficiency syndrome	0
thymus plant	rachitide	0
chinese rhubarb	central obesities	0
legume pod	nonhodgkins lymphoma	0
oregano plants	mptp induced experimental parkinsonism	0
nutrient-dense foods	postoperative emesis	0
trigonella foenum graecum	constrictive bronchiolitides	0
humulus lupulus	hiatus hernias	0
dietary fats	premature birth	0
peach trees	gallbladder disease	0
pummelo trees	inflammatory polyneuropathy acutes	0
know nuts	global amnesia	0
pimenta diocia	fibroid uterus	0
fungus	mammalgia	0
animal-based vitamin	bse (bovine spongiform encephalopathy)	0
allium porrum	small-cell lymphomas	0
frozen spinach	malignant brain neoplasm	0
da huang	parkinsonism	0
white mallow	blood clots	0
flax	mottled enamel	0
bell peppers	secretory meningiomas	0
store licorice	tumorigenesis	0
crocus sativus	endocrine breast disease	0
fruit and vegetable juices	overeat	0
kaffir lime	bronchiolitide	0
psidium guajavas	cancer of uterus	0
amlas	death	0
cayenne	brain disorder	0
lens plants	oxygen deficiencies	0
avocado	small-cell lymphoma	0
fresh fruits	iron deficiency	0
kava	high cholesterol levels	0
hibiscus sabdariffa	shock	0
mussel	heart block	0
nutmeg	kidney insufficiency	0
brinjal	head injuries	0
dietary supplement	skin neoplasms	0