
golden delicious apples	exanthem	0
golden glow	muscle soreness	0
lavandula angustifolia	intraepithelial prostatic neoplasia	0
bhang	benign prostatic hyperplasia	0
meal times	gall bladder disease	0
tangerine trees	familial tremors	0
sweetleaf	eye diseases	0
fruit and vegetable juices	autistic disorders	0
cucumber	multiple meningiomas	0
rose	dermatozoic delusion	0
whole grain cereal	endometrium cancer	0
sweet basil	intraepithelial neoplasm	0
food and drug administration	diverticulitide	0
hamburger	transmissible dementia	0
healthiest fruits	philadelphia-negative myeloid leukemias	0
little saffron	esophageal neoplasm	0
cappari	human t lymphotropic virus type iii	0
marsh mallow	chromosome 6 linked autosomal recessive parkinsonism	0
majorana hortensis	diffuse lymphoma	0
cayenne peppers	lumbago	0
roselle	muscular spasm	0
citrus aurantiums	kanner syndrome	0
processed foods	tubal abortions	0
olea	cluster headache syndromes	0
vegetable juice	brain neoplasm	0
treat	mixed lymphoma	0
lucerne	galactosemia 2s	0
convenience food	head injuries	0
blueberry plant	regional enteritis	0
diabetic diets	convulsion	0
glucose-fructose syrup	develop cancer	0
pea	hypertension	0
red lentils	multiple sclerosis	0
leguminosae	headache syndrome	0
chenopodium quinoas	cardiogenic syncopes	0
amlas	static tremor	0
citron trees	bronchial asthma	0
maize	male breast carcinoma	0
domestic fowls	dental fluoroses	0
cocoa plant	reticulum-cell sarcomas	0
pleurotus ostreatus	retroviridae	0
rubus glaucus	peripheral artery diseases	0
rhubarb	cancer of the tonsil	0
vaccinium angustifolium	acquired immunologic deficiency syndrome	0
high-fructose maize syrup	hypesthesia	0
legume family	small round-structured viruses	0
big apples	ductal carcinoma	0
exotic fruits	feline leukemia viruses	0
individual food	meningioma	0
blueberry	philadelphia-negative myeloid leukemia	0
largest meal	subacute spongiform encephalopathy	0
fagopyrum esculentum	smell disorders	0
group foods	steatohepatitis	0
triticum durum	renal failures	0
avena sativa	darkness tremors	0
apple	neuritic plaques	0
pistachio	pleomorphic lymphoma	0
find pork	diverticulosis	0
caryophyllus	vitamin deficiency	0
monkfish	kidney calculi	0
soybean proteins	canker sore	0
pimenta diocias	thyroid cancers	0
english plantain	spindle-cell carcinoma	0
pleurotus	hyperpigmentation	0
caryophyllus aromaticus	penile neoplasms	0
fermented foods	pill rolling tremors	0
turkey meat	tonsil neoplasm	0
sustenance	lung neoplasms	0
carica	comatose	0
lamb chops	glaucoma	0
cannabis	benign essential tremor	0
red meat	water stress	0
citrus x paradisi	lyme arthritis	0
vitamin pills	lav-htlv-iii	0
persea americana	reproductive sterility	0
kawa kawas	somatotropin hypersecretion syndrome (acromegaly)	0
linum usitatissimum	creutzfeldt jakob disease	0
chewing gum	occipital region trauma	0
beet greens	t virus	0
mashed potatoes	anosmia	0
black beans	subacute spongiform encephalopathies	0
peppermint	acute inflammatory polyneuropathy	0
organic meat	hansen disease	0
black sapotes	feminization	0
ale	multiple myeloma	0
yam	coronary heart disease	0
olive oils	amnesia	0
plantago ovata	pleomorphic lymphomas	0
secale	uterus neoplasm	0
peanut butter	zoonosis	0
white tea	nasal cavity cancer	0
tree nuts	parietal region traumas	0
currant	reproductive sterility	0
ice creams	basal cell carcinomas	0
hibiscus cannabinus	rectum neoplasm	0
uncooked food	primary fibromyalgias	0
osmanthus	pancreatitis	0
apium graveolens	diffuse mixed small and large cell lymphoma	0
delonix	senile paranoid dementia	0
red peppers	common cold	0
curcuma zedoarias	malignant melanoma	0
soup	neurotic anxiety states	0
seville orange trees	gerd	0
pork	mixed lymphocytic histiocytic lymphoma	1
goji berry plant	chest pain	0
jasmine tea	human t cell lymphotropic virus type iii	0
citrus reticulatas	allergy	0
natural vitamin	anticancer	0
goiaba	small-cell lymphoma	0
common plant	female subfertility	0
sugar substitute	throat cancer	0
glycine max	migraine	0
regular olive	benign meningiomas	0
diospyro	tick bite	0
whole grain cereals	malignant primary brain neoplasms	0
catfish	rectum neoplasm	0
pretzel	degenerative diseases	0
cereal grains	penile cancer	0
vicia faba	alopecia cicatrisata	0
fed beef	male subfertility	0
ginger ale	malaria	0
saint johns wort	thrombosis	0
blossom	fibroadenoma	0
poppy seeds	pneumonitis	0
raisin bran	utp-hexose-1-phosphate uridylyltransferase deficiency disease	0
use sweeteners	fibromyositis fibromyalgia syndrome	0
seltzer water	cancer of kidney	0
pumpkin	pediatric cancers	0
wheat	effort syncope	0
agent orange	oral neoplasms	0
rheum tanguticum	psychophysiological insomnia	0
medicago sativa	deglutitional syncopes	0
cream cheese	drunkenness	0
eat flax	malignant meningioma	0
soft drinks	philadelphia-negative myeloid leukemias	0
syzygium aromaticum	well-differentiated lymphocytic lymphoma	0
prebiotic	dementia with amyotrophic lateral sclerosis	0
tea	bleed	0
vegetable protein	post-ictal confusion	0
ready prepared foods	proliferative bronchiolitis	0
true nut	bovine lymphomas	0
dinner times	cervical cancer	0
soy bean curds	esophagus neoplasms	0
common olive tree	mixed cell lymphoma	0
cooked carrots	chronic cystic mastitis	0
concord grapes	infantile botulism	0
raisin	influenza in human	0
texturized vegetable protein	post traumatic osteoporosis	0
chili pepper	anxiety disorders	0
lycopersicon esculentum	lou-gehrigs disease	0
cleistocalyx	high blood pressures	0
dried apple	autosomal dominant parkinsonism	0
dark chocolate	acquired immunodeficiency syndrome	0
wild celeries	cardiac diseases	0
berry	chronic fatigue-fibromyalgia syndromes	0
hemp	esophageal cancer	0
bitter nightshades	cancer of vagina	0
jalapeno peppers	paraesophageal hernias	0
deli meat	myelopathy	0
squash plant	lens opacity	0
bitter nightshade	spontaneous abortion	0
citrus medicas	alopecia cicatrisata	0
thymus plants	bronchiolitis	0
ocimum tenuiflorum	fighting cancer	0
restrict food	temporary amnesias	0
sesame seeds	abdominal aortic aneurysms	0
celery root	breast pains	0
woodland strawberry	epilepsy	0
tea hibiscus	spongiform encephalopathies	0
wolfberry	basal cell nevus syndrome	0
dinner time	different cancer	0
raw alfalfa	amyloid plaques	0
camomile	lymphatic sarcomas	0
andean blackberry	pleomorphic lymphomas	0
eden foods	thyroid cancer	0
happy meal	deaf mutism	0
syzygium jambos	diffuse undifferentiated lymphoma	0
garlic	food-borne disease	0
garbanzo	bovine leukosis	0
hashish	drug use disorders	0
fermented cabbage	b cell chronic lymphocytic leukemia	0
poppy seed	salmonella infections	0
cuminum cyminums	schizophrenic disorders	0
lycium	rectal tumor	0
irritable bowel kiwi fruit	female subfertility	0
health nuts	childhood onset obesity	0
turmeric root	prostatitis	0
cynara scolymus	udp galactose 4 epimerase deficiency	0
croaker	heart attacks	0
da huang	acquired immunodeficiency syndromes	0
cycad trees	high blood pressure	0
baptisia	pancreas neoplasm	0
curcuma zedoaria	celiac sprue	0
soy beverage	respiratory infections	0
sugar water	laron type dwarfism i	0
plum trees	leukemogenic viruses	0
bibhitaki fruit	peanut hypersensitivity	0
crocus	infectious mononucleosis viruses	0
tuna fish	dental fluoroses	0
organic milk	myelomatosis	0
low vitamin	spondylitis ankylopoietica	0
acer negundos	hypesthesia	0
food supplementations	arthralgia	0
milk thistle	dairy product intolerance	0
watermelon	juvenile onset diabetes mellitus	0
cod	multiple sclerosis	0
cruciferous vegetables	juvenile parkinsonisms	0
antioxidant fruits	virus infections	0
sweetening agent	generalized seizure	0
afzelia	uterine leiomyoma	0
nitrate-rich vegetables	gallbladder diseases	0
horsebean	bacterial vaginitides	0
amomum cardamomum	arterial dysfunction	0
healthiest beverages	psychophysiological insomnia	0
citron tree	cerebrovascular accidents	1
curcuma longas	bacterial vaginosis	0
okra	cow disease	0
aubergine	pyrexia	0
pomelo tree	proliferative bronchiolitis	0
euterpe precatoria	chronic b-cell leukemia	0
areca catechu	dental fluorosis	0
french fries	b cell chronic lymphocytic leukemia	0
chinese rhubarb	non alcoholic fatty liver disease	0
soy sauce	feminization	0
petroselinum crispums	autistic disorders	0
willow tree	schizophrenia	0
foeniculum vulgares	viral hepatitis	0
soy foods	tubal abortions	0
healthiest foods	lyme borreliosis	0
holy basil tea	kidney cancer	0
eugenia aromatica	communicable disease	0
abelmoschus	udp-galactose-4-epimerase deficiencies	0
acai berry	cot deaths	0
molasse	auricular fibrillation	0
frosting	pancreatic cancers	0
seville orange tree	congenital defect	0
dietary fibers	sunburn	0
syrup	aphthae	0
chinese yam	soft tissue sarcomas	0
carrot juice	non b hepatitis enterically transmitted non a	0
star anise	pustulosis of palms and soles	0
acaí berries	galactose-1-phosphate uridyltransferase deficiencies	0
chinese food	temporary amnesias	0
paprika	female infertility	0
pimenta diocia	arthrosis	0
chicken	allergic reaction	1
carbonated mineral water	age-related memory disorder	0
banana plants	kidney calculi	0
espresso	lymphadenopathy associated virus	0
japanese plum	liver failure	0
popular fruits	atherosclerose	0
official vitamin	ms (multiple sclerosis)	0
vodka	autistic disorders	0
carob	spontaneous abortions	0
dragon fruit	age related memory disorders	0
lactuca sativa	pseudocoma	0
food poisonings	esophagus neoplasms	0
purple potatoes	sharp headaches	0
chinese yams	chronic insomnia	0
raphanus	auditory seizure	0
swordfish	upper respiratory infection	0
linum	cancer of brain	0
pistachio nut tree	small lymphocytic lymphomas	0
maraschino cherry	crushing skull injuries	0
hypericum perforatums	hereditary galactokinase deficiencies	0
myristica fragrans	ovarian neoplasm	0
apium graveolens var. dulce	spasm	0
sea bilberries	cancer of the prostate	0
fabaceae	male breast tumor	0
pimpinella	sudden onset diabetes mellitus	0
mealtime	severe gh insensitivity	0
açaí berry	retained surgical needle	0
anana	blood clots	0
nutmeg	well differentiated lymphocytic lymphoma	0
dairy product	reverse cancer	0
dog rose	regional ileitides	0
suggesting apple	carotid sinus syncopes	0
no-calorie sweeteners	bewilderment	0
food supplements	landry-guillain-barre syndrome	0
lemon tree	uterus neoplasms	0
healthy fruit	ciguatera fish poisonings	0
digitalis purpurea	male sub fertility	0
brewing tea	guillain-barre syndrome	0
origanum	bovine lymphomas	0
common bean plant	cancer of colon	0
pinto bean	urinary bladder neoplasms	0
cranberry sauce	skin neoplasm	0
marshmallow	diabetic retinopathy	0
walnut oil	foodborne botulisms	0
high-fat meal	meningioma	0
table salt	reticulolymphosarcoma	0
shellfish	lymphadenopathy-associated virus	0
solanum tuberosum	severe gh insensitivity	0
plantago	lyme disease	0
flower	epithelioid sarcoma	0
domestic fowl	pancreas cancer	1
health food	inflammatory bowel diseases	0
soy milk	western diseases	0
narrow leaved plantain	ankylosing spondylitis	0
junk foods	skin cancer	0
brew	gut dysfunction	0
philadelphia cream cheese	bladder disease	0
portulaca	proteinuria	0
drug administration united states food	diabetic asymmetric polyneuropathy	0
amorpha	pituitary dwarfism iis	0
vitis vinifera	cow disease	0
wild yam	autosomal recessive juvenile parkinson disease	0
plant-based nutrients	tonsillar cancer	0
sugar substitutes	cancer of ovary	0
cannabis indica	insomnia disorders	0
mackerel	hiatal hernias	0
dried blueberries	prediabetic states	0
betel nut	tongue neoplasms	0
apple juice	royal free disease	0
crataegus	diabetic mononeuropathy simplices	0
worldwide fruit	chronic fatigue disorders	0
blueberry plants	smell disorders	0
iceberg lettuce	zoonotic diseases	0
actual licorice	mixed-cell lymphoma	0
mock meats	gall stone	0
breakfast time	ebv	0
tangerine tree	norwalk like viruses	0
healthiest vegetable	galactose-1-phosphate uridyl-transferase deficiency disease	0
atropa belladonna	senile paranoid dementia	0
breakfast	vaginal cancer	0
nightshade	benign neoplasm	0
anise seed	status migrainosus	0
club sodas	crohns disease	0
drinking water	joint diseases	0
acer	acute monocytic leukemia	0
musa	benign meningioma	0
nicotiana	darkness tremors	0
broccoli	autosomal dominant juvenile parkinson disease	0
snail meat	gluten enteropathies	0
brinjal	bilateral headaches	0
fuji apples	sensory seizure	0
ground ginger	head traumas	0
daucus carota	testicular neoplasms	0
sardine	bovine lymphosarcoma	0
sugar maples	gastric neoplasm	0
mushroom	germinoblastic sarcomas	0
prunis communis	headache	0
fagopyrum tataricum	diabetic complications	0
raw food	endometrial carcinomas	0
purple rice	mental disorder	0
individual candy	reticulum cell sarcoma	0
vinegar	cancer of pancreas	0
banana plant	bovine lymphosarcomas	0
betel	prostate cancer	0
healthiest apple	groundnut hypersensitivity	0
peppermint oil	small-cell lymphoma	0
milk	ocular headache	0
cicer	different cancer	0
brown rice	prion-induced disorder	0
noncaloric sweetener	virus disease	0
stevia rebaudianas	mucous colitis	0
squash	substance abuses	0
healthy snacks	diabetic complications	0
althea officinalis	necrotizing fasciitis	0
dried apricots	malignant primary brain tumors	0
mangiferas	soft tissue sarcoma	0
black currants	galactosemia iiis	0
high-fiber food	pyorrhea alveolaris	0
mangifera indica	muscular cramps	0
frozen cranberries	early onset parkinson disease autosomal recessive	0
shoot	menstrual pain	0
cocoa powder	mouth and tooth diseases	0
canned fruit	granulomatous colitis	0
four nuts	esophageal reflux	0
ilex paraguariensis	hip fractures	0
dried peas	neurodegenerative disorders	0
pecan tree	thrombus	0
probiotic	transitional meningiomas	0
suggesting fruit	pleomorphic lymphoma	0
blackberry	olfactory groove meningiomas	0
flaxseed	spondyloarthritis ankylopoietica	0
turnip	breast malignant neoplasm	0
elettaria	chronic fatigue syndrome	0
carbonated beverages	exanthem	0
cultivated oats	colicky pain	0
popcorn	carcinogenese	0
carbonated beverage	hepatic failure	0
burrito	recurrent brain tumors	0
sweet pepper	udpglucose hexose-1-phosphate uridylyltransferase deficiency	0
dairy products	hirsutism	0
flax seed	vestibular seizures	0
cow's milk	macular degeneration	0
hibiscus sabdariffa	udpglucose hexose-1-phosphate uridylyltransferase deficiency	0
intoxicant	spongiform encephalopathies	0
proteus mirabilis	coad	0
andropogon nardus	male breast neoplasm	0
cranberry juice	sinusitis	0
macadamia nut	vertex headaches	0
frozen fruit	infant botulism	0
longevity legumes	trochanteric fractures	0
bamboo shoots	chronic obstructive lung disease	0
incorporates cloves	essential tremor	0
opium poppy	rectal neoplasms	0
kidney bean	tumor viruses	0
english plantains	testis cancer	0
green pepper	transitional meningioma	0
flammulina	aphthous stomatitides	0
phytonutrient-rich food	ciguatera	0
whole foods	nonhodgkin lymphoma	0
soy cheeses	food hypersensitivity	0
fungus	periodontal disease	0
peach	splitting pain	0
dried apples	liver diseases	0
dietary plant proteins	acute inflammatory polyradiculoneuropathy	0
hydroponic basil	osteoarthritis	0
lens plant	tonic-clonic seizures	0
dietary fat	acquired immuno-deficiency syndromes	0
poisonous plant	gall stone	0
know nuts	ciguatera fish poisoning	0
real chocolate	throbbing headaches	0
clove	brain tumor	0
wheatgrass	endothelial dysfunction	0
smoked foods	regional enteritis	0
cicer arietinum	kidney insufficiencies	0
bilberry	creutzfeldt jacob disease	0
arachis	endotoxemia	0
faba beans	colorectal tumor	0
nutrient-dense foods	feline leukemia viruses	0
emphasize plant	low-grade b-cell malignancy	0
nutritional yeast	diabetes related complications	0
morinda citrifolia	ekbom dermatozoic delusion	0
ready-to-eat meals	determination of death	0
seafood	ph1-negative myeloid leukemias	0
so-called vegetable	chronic pain	0
red tea	vertex headache	0
glycyrrhiza	colonic neoplasms	0
baby formula	familial juvenile parkinsonism	0
crataegus monogynas	syndrome	0
hawthorn	ischemic heart disease	0
gui zhi	esophagitide	0
norus	erectile dysfunction	0
pistacia vera	head trauma	0
sausage	cva (cerebrovascular accident)	0
pyrus	steatohepatitide	0
barley	non-alcoholic fatty liver disease	0
spice turmeric	alopecia	0
beta vulgaris	aids viruses	0
cassia fistulas	acute infectious polyneuritis	0
dioscorea batatas	tonsillar cancer	0
crabapple	germinoblastic sarcomas	0
milk thistles	ms (multiple sclerosis)	0
tumeric	low back pain	0
dietary supplementations	chronic illness	0
canned food	lymphoblastic leukemia	0
raw foods	rete testis tumor	0
opium poppies	ischemic heart disease	0
cooked broccoli	gasser's syndrome	0
coco	age-related maculopathies	0
pimpinella anisums	uterine cervical neoplasm	0
trigonella foenum-graecums	throat cancer	0
consumer protection scientific committee on food	gestational diabetes	0
cumin	acquired immunodeficiency syndromes	0
cannabi	barretts syndrome	0
illicium verum	gingivitis	0
thymus plant	symptom clusters	0
emblica officinali	occipital region trauma	0
holy basil	auditory seizure	0
apple tree	insulin sensitivity	0
anchovy	vitamin deficiency	0
jalapeno	retained surgical sponges	0
animal-based vitamin	feline leukemia virus	0
potassium-rich foods	barrett epithelium	0
lipomul	throbbing headache	0
sea vegetable	unilateral headache	0
vitis	prediabetic states	0
cucumis melo	spinal cord disorders	0
sockeye salmon	galactose-1-phosphate uridylyltransferase deficiencies	0
olive family	nontropical sprue	0
dried plums	migraine variant	0
pasta	burning pains	0
deep-fried foods	deep venous thrombosis	0
st. john's wort	child obesity	0
lentinus edodes	right-sided heart failure	0
leek	autosomal dominant juvenile parkinson disease	0
yerba mates	wound botulism	0
edible grain	aids viruses	0
acer saccharum	parkinson disease	0
humulus	chronic lymphocytic leukemia	0
processed apples	endometrial carcinomas	0
poenumgraecum	bovine lymphoma	0
snack foods	heartburn	0
bottled water	oxygen deficiency	0
component spices	virus diseases	0
zinger tea	schizophreniform disorders	0
guava	prostate cancer	0
whortleberry	joint diseases	0
papaya	bovine leukemia	0
coconut oil	cadaver	0
soda waters	neoplasia	0
fragaria vesca	landry guillain barre syndrome	0
horsemeat	brain conditions	0
lime	frontal region traumas	0
mayo	back pains	0
cooked meats	somatotropin (acromegaly) hypersecretion syndrome	0
peach tree	endometrial neoplasms	0
horse bean	macular dystrophies	0
red yeast rice	odontogenic keratocysts multiple basal cell nevi	0
rubus fruticosus	coronary heart disease	0
breakfast cereals	spindle-cell carcinomas	0
belladonna	fusiform aneurysms	0
oat	prostatic cancers	0
pistacia lentiscus	chronic obstructive lung disease	0
curcuma longa	sciatic neuralgias	0
cinnamon	carcinomatose	0
cold-steeping tea	generalized spasm	0
flounder	idiopathic polymyositis	0
fruit-shaped marshmallows	bladder tumor	0
trace minerals	nonspecific vaginitis	0
raw meat	female subfertility	0
leafy vegetables	rheumatoid spondylitis	0
roundup-ready soybeans	fibroid tumors	0
aquatic food	breast neoplasms	0
cider vinegar	seizure	0
low fruit	complete blindness	0
quinoa	retro-ocular headache	0
low-calorie diet	encephalon diseases	0
steak	type i diabetes mellitus	0
chamomile oils	causes cancers	0
potato	virus diseases	0
lemon	mental deteriorations	0
last meal	rabies viruses	0
oreo	postural syncope	0
inadequate fruit	fibromyalgia	0
glycyrrhiza glabra	plasma cell myeloma	0
confection	diffuse mixed-cell lymphoma	0
morel	brain tumors	0
decaf	female sub-fertility	0
cola	mouth cancers	0
emblica officinalis	hypoascorbemia	0
including cloves	necrotizing fasciitides	0
cinnamomum zeylanicum	oral neoplasms	0
tachigalia	gastric neoplasms	0
moose meat	radiating pains	0
cuminum	mottled enamels	0
red rice	contagious ecthyma	0
jambolan plum tree	different cancer	0
saint johnswort	pulmonary disease	0
lunch time	inflammatory demyelinating polyneuropathy	0
consumed chocolate	polyphagia	0
sea-food	intraepithelial prostatic neoplasias	0
prunus domestica	liver neoplasms	0
plantago lanceolata	semirhythmic tremor	0
sauerkraut	multiple head injury	0
contamination meat	vagina neoplasm	0
veggie	human papillomavirus virus	0
cucurbita	proliferative bronchiolitides	0
prunus amygdalus	parietal region traumas	0
specific nuts	kidney diseases	0
saccharomyces cerevisiae	brief reactive psychosis	0
mirobalanus embilicas	behavior disorders	0
phyllanthus emblicas	superficial head injury	0
cicer arietinums	eye diseases	0
justicia adhatoda	hiccough	0
pepsi	stroke	0
split peas	vulvar neoplasm	0
poroporo	muscular rheumatism	0
marjoram plant	parodontose	0
cultivated radish	myocardial infarction	0
maize syrup	colic	0
sour orange trees	myelomatosis	0
bagel	high grade lymphoma	0
sprout	new variant creutzfeldt-jakob disease	0
nut bar	angiomatous meningiomas	0
good soybeans	kidney insufficiencies	0
trigonella foenum-graecum	orthostasis	0
nuclear power plant	germinoblastoma	0
citrullus	chronic disease	0
illicium anisatum	food borne illnesses	0
maple	lobar pneumonia	0
agave	numbness	0
eugenia cumini	reticulum cell sarcoma	0
euterpe	intermittent tremors	0
soda pop	breast adenosis	0
kola nuts	experimental parkinsonisms	0
snack	regional ileitis	0
collard green	unilateral headache	0
eggnog	leukemogenic viruses	0
justicia	spatial memory disorder	0
dietary protein	periodontal disease	0
mango	rabies viruses	0
fast food	human papillomavirus viruses hpv	0
sweetening agents	experimental parkinson disease	0
orange trees	heart blocks	0
rowanberry	primary insomnia	0
carica papaya	oral cancer	0
lunchtime	degenerative intervertebral disk	0
chipotle	prostate neoplasms	0
lemon grasses	lassitude	0
handling meat	autistic disorders	0
calendula	hypoesthesia	0
floret	odontogenic keratocysts multiple basal cell nevi	0
psyllium	papillary meningioma	0
frozen spinach	viral infections	0
areca catechus	galactokinase deficiency diseases	0
beetroot	disseminated sclerosis	0
miso	thrombosis	0
vaccinium virgatum	small lymphocytic lymphomas	0
citrus	tonsillar neoplasms	0
jerusalem artichokes	angioblastic meningiomas	0
target vitamin	leukemogenic viruses	0
butter milk	lou-gehrigs disease	0
family vegetables	landry-guillain-barre syndrome	0
national meat	epileptic seizures	0
haritaki fruit	fibroid tumors	0
cola nitida	vagina neoplasms	0
ocimum basilicums	lyssa	0
butternut squash	oral cancer	0
capparis	hip fractures	0
processed food	b12 deficiency	0
isoglucose	sudden infant death	0
pecan	lung neoplasm	0
sandwich	involuntary quiver	0
indian gooseberry	atherosclerotic plaques	0
orange	viral disease	0
billion eggs	dyschezia	0
foie gras	anal ulcers	0
diabetic diet	death	0
rubus idaeus	kanner syndrome	0
broth	spatial memory disorder	0
trace element	endemic cretinism	0
healthy nuts	intermittent tremor	0
root	neuralgic migraine	0
zea	mastalgia	0
durum wheats	tor-driven diseases	0
pie	small cleaved cell lymphoma	0
baker's yeast	vertebrogenic pain syndrome	0
coca	micturition syncope	0
linseed	neurodegenerative disorder	0
curry	iron deficiency	0
cultivated oat	diverticulosis	0
onion	guam disease	0
indian gooseberries	grave’s disease	0
chocolate	primary insomnia	0
dietary soybean proteins	posterior compartment low back pain	0
avocado fruit	brain vascular accident	0
spinach	epithelioid sarcomas	0
fruit juice	male breast tumor	0
crataegus monogyna	scorbutus	0
rosehip	amnesia	0
black tea	premature birth	0
soda water	parkinson disease 2	0
toxic plant	mottled enamel	0
digitalis lanata	cervical neoplasm	0
amla	sunburn	0
lemon balms	tubal abortions	0
spore	mouth and tooth diseases	0
herb	crushing pains	0
cortland	breast pain	0
crab apple	hypoesthesia	0
phaseolus vulgari	pulmonary disorder	0
navy beans	autoimmune diabetes	0
milk chocolate	deep vein thromboses	0
portulaca oleracae	common cold	0
aloe vera	tonic seizures	0
holy basils	inflammatory demyelinating polyneuropathy	0
vaccinium bracteatums	temporal region traumas	0
aspartame	bladder neoplasm	0
brown sugar	neurotic anxiety state	0
pineapple juice	gout	0
soy bean curd	well-differentiated lymphocytic lymphomas	0
contaminated foods	lung neoplasm	0
white bread	retained surgical item	0
beta vulgari	carcinoma of endometrium	0
stuff	tactile amnesia	0
euterpe oleracea mart.s	bipolar depression	0
animal-based foods	rectal tumors	0
century plant	aneurysm	0
taraxacum	syncopal vertigo	0
green peas	landry-guillain-barre syndrome	0
chewing fruit	ciguatera	0
pomegranate fruit	upper respiratory infections	0
retail meat	mottled enamel	0
cayenne pepper	spindle cell sarcomas	0
chewed coca	chronic illness	0
osmanthus tea	situational syncopes	0
jam	mild neurocognitive disorder	0
red pepper	fibromyoma	0
sell meat	migraine disorders	0
teosinte	testis cancer	0
carya	laron type dwarfism i	0
fava bean	parkinsonian syndromes	0
stevia	penile cancer	0
bread mold	hypercholesteremia	0
tobacco	senile osteoporosis	0
convenience foods	exudative bronchiolitis	0
persimmon	syncopal episode	0
whipped cream	penis cancer	0
faba bean	acquired immune deficiency syndrome virus	0
iv vitamin	lymphadenopathy-associated viruses	0
fresh meat	chronic fatigue disorder	0
allium sativum	kidney cancer	0
fagopyrum sagittatum	autosomal recessive juvenile parkinsonism	0
tempeh	horton syndrome	0
brazil nuts	reactive confusion	0
coriander	diabetic neuralgias	0
trigonella foenum graecum	vulvar neoplasms	0
copaifera	granulomatous enteritis	0
different seed	polyarthritis	0
hot pepper	migraine variants	0
oxen meat	communicable diseases	0
coconut water	radiating pain	0
alcohol	fighting cancer	0
cola acuminata	galactosemia 2s	0
horse nettle	dysmenorrhea	0
illicium verums	unhealthy conditions	0
herbal tea	bovine leukosis	0
açai berry	saccular aneurysm	0
dietary fiber	chronic fatigue syndromes	0
liquor	metastatic cancer	0
eugenia sandwicensis	post traumatic osteoporosis	0
soy beverages	diabetes related complications	0
tepary bean	airsickness	0
eating meat	endometrium cancers	0
bellis	guillain-barre syndrome	0
antioxidant-rich foods	amyloid deposit	0
extracted fruit	pharyngitide	0
sour orange tree	wheat hypersensitivities	0
filbert	cervical neoplasm	0
almond milk	chronic b-cell leukemia	0
eating almonds	colorectal tumor	0
frier	intermediate-grade lymphomas	0
saint john wort	deaf mutism	0
punica granatums	hypersensitivity	0
ketchup	intracranial central nervous system disorders	0
solanum tuberosums	rectum neoplasm	0
açai berries	tumor virus	0
allspice	psychogenic parasitoses	0
vaccinium uliginosum	mild neurocognitive disorder	1
dandelion	manic disorders	0
dried foods	deafness	0
sweet marjorams	histamine cephalgias	0
carbonated drinks	ocular headaches	0
unfiltered coffee	uterine cervical cancer	0
broad beans	periorbital headache	0
zingiber officinale	symptom clusters	1
dietary supplements	forehead traumas	0
cruciferous foods	situational syncope	0
dog rose berries	cancer of the uterus	0
nori	venereal wart	0
experience food	small-cell lymphomas	0
ribes nigrum	hemolytic jaundices	0
cocoanut	psammomatous meningioma	0
illicium	sinusitide	0
include fennel	endometrial carcinoma	0
fresh fruits	resting tremors	0
eggplant	esophageal hernia	0
poultry meat	grave’s disease	0
fryer	breast cystic disease	0
preserved food	vaginal neoplasm	0
flaked coconut	pancreas neoplasm	0
added nuts	posterior compartment low back pain	0
java plum tree	olfaction disorders	0
carbonated water	dermatozoic delusions	0
unhealthy food	osteoporose	0
soy	chronic b lymphocytic leukemia	0
plant capsule	liver steatoses	0
fagopyrum	ankylosing spondylarthritis	0
collard greens	fibroatheroma	0
cereal	atrial fibrillation	0
thymus vulgari	cancer of rectum	0
black walnuts	plasma cell myelomas	0
bacon	texidor twinge	0
mustard greens	rabies viruses	0
brassica napus	chronic airflow obstructions	0
berberi	hiv	0
vaccinium bracteatum	respiratory tract infection	0
offal	adenomatous polyps	0
eragrostis	male pattern baldness	0
green lentils	schizoaffective disorders	0
specific foods	uterine cervical neoplasms	0
açaí berries	e-b viruses	0
fatty meal	encephalopathy	0
fiddlehead ferns	pneumonia	0
eating broccoli	acute inflammatory demyelinating polyradiculoneuropathy	0
squashe	parkinson’s disease	0
toxic plants	nbcc	0
oolong	palsy	0
raw cranberries	polyradiculoneuropathy	0
kombucha teas	lichen ruber planus	0
arginine-rich foods	liver disease	0
study lavender	human t-cell lymphotropic virus type iii	0
eupatorium rebaudianum	vaginal cancers	0
meal	painful diabetic neuropathies	0
dried cranberries	dyslipoproteinemia	0
alfalfa sprout	colon neoplasm	0
brassica juncea	malignant epithelial neoplasm	0
green grapes	ketosis-prone diabetes mellitus	0
big food	mammary cancers	0
cacao bean	cerebrovascular apoplexy	0
neu5gc-rich food	gum disease	0
dietary fats	malignant melanoma	0
sweet potatoes	bovine spongiform encephalopathy	0
java plum trees	bronchial asthma	0
corn syrup	national cancer	0
food pyramid	sleep initiation and maintenance disorders	0
solanum laciniatum	sleep wake disorders	0
eupatorium rebaudianums	social anhedonias	0
abelmoschus esculentus	neonatal tremor	0
dinnertime	malignant melanoma	0
potato chips	thermal hypesthesias	0
sunfish	chronic fatigue and immune dysfunction syndrome	0
drink	male breast cancer	0
chard	diffuse lymphocytic lymphoma	0
include flaxseed	autistic disorders	0
curry powder	asymmetric diabetic proximal motor neuropathy	0
bean	basal cell carcinomas	0
hypericum perforatum	osteoarthrosis	0
decaffeinated tea	juvenile-onset diabetes	0
crocus sativus	auriculo-ventricular dissociation	0
processed meat	cancer of pancreas	1
solanum dulcamara	perioral tremors	0
chinese cinnamons	intention tremors	0
silybum marianum	stokes-adams syncopes	0
durum wheat	pustulosis of palms and soles	0
lemon trees	wheat allergy	0
ready-to-eat meal	premature births	0
sweet peppers	megacolon	0
gluten-free diet	causes cancers	0
cocoa plants	fusiform aneurysm	0
corn sugar	microglandular adenoses	0
rye	respiratory infections	0
wild bananas	chronic b lymphocytic leukemia	0
plantago arenaria	iddm	0
soft drink	amyotrophic lateral sclerosis-parkinsonism-dementia complex 1	0
store licorice	autosomal dominant. juvenile parkinson disease	0
tarragon	insulin-dependent diabetes mellitus	0
breakfast times	laron dwarfism	0
crave chocolate	vertiginous seizures	0
walnut	mammary dysplasia	0
acid-binding vegetables	symptom clusters	0
hickory nut	male sterility	0
ground beef	gastroesophageal reflux disease	0
boiled broccoli	sleep disorders	0
fenugreek	paraesophageal hernias	0
coffee	breast pain	0
zucchini	hepatic failure	0
orange juice	spongiform encephalopathies	0
monitoring food	horton syndrome	0
pudding	hypercholesteremia	0
celery	focal seizure	0
st. johnswort	diverticulitide	0
rheum officinale	disk degradations	0
sticker	chronic pain	0
pomelo trees	foodborne illnesses	0
daily fruit	crohn’s disease	0
ginger	gluten enteropathies	0
purple grape	environmental cancer	0
chervil	cancer of the breast	0
pea family	gluten enteropathy	0
avena	wheat hypersensitivities	1
sunflower seeds	numbness	0
vegetable oil	pituitary dwarfism ii	0
almond butter	galt deficiencies	0
antioxidant food	small non cleaved cell lymphoma	0
squash seeds	epilepsy	0
fatty foods	pregnancy pernicious vomiting	0
kavas	female infertility	0
bread	abdominal pain	0
gum acacia	degenerative arthritis	0
saffron	chronic pains	0
chocolate pudding	fifth phacomatosis	0
herr	amyloid deposits	0
halibut	oncogenesis	0
cinnamomum verum	macular dystrophies	0
citrus aurantium	cancer of stomach	0
malus domestica	liver disease	0
corylus	secretory meningiomas	0
green teas	metastatic cancer	0
orange tree	metastasis	0
parsley	prostatic hyperplasia	0
undercooked meat	creutzfeldt jakob syndrome	0
laciniate nightshade	dna injury	0
frozen broccoli	broken bone	0
pisum sativum	human immunodeficiency viruses	0
breakfast cereal	age-related osteoporosis	0
rooibos	neonatal tremors	0
grecian foxglove	uterus cancers	0
drinking milk	proliferative bronchiolitis	0
cherry	mottled enamels	0
lemon balm tea	peripheral arterial diseases	0
mentha	hypermelanose	0
artificially-flavored corn	aphthous stomatitis	0
brewed coffee	cystic disease of breast	0
lettuce	somatotropin hypersecretion syndromes (acromegaly)	0
safflower oils	sliding hiatal hernia	0
prettiest fruit	regional ileitides	0
poppy	fetal iodine deficiency disorder	0
prosopis	basal cell carcinoma	0
corn oils	macular degenerations	0
sugar	galt deficiencies	0
pithecolobium	memory loss	0
raphanus raphanistrum	fatty liver	0
swiss chard	degenerative neurologic disorder	0
sea food	constrictive bronchiolitides	0
guacamole	disk degradations	0
chicken salad	gastric acid reflux disease	0
chicken meat	craniocerebral traumas	0
carthamus tinctorius	gnathostoma infections	0
multivitamin	gastro-esophageal reflux	0
low-sodium diet	cerebral stroke	0
mustard oil	pulmonary disorder	0
chlorella	fibromyositis-fibromyalgia syndrome	0
egg	cjd (creutzfeldt-jakob disease)	0
bertholletia excelsas	temporary amnesia	0
meal time	artery disease	1
drink milk	single seizure	0
myristica fragran	zoonotic disease	0
punicaceae	memory disorders	0
teff	rectum cancer	0
commercial milk	gallbladder diseases	0
linum usitatissimums	enzootic bovine leukoses	0
ananas	prostatic intraepithelial neoplasias	0
oryza	sleep wake disorders	0
fat foods	mixed lymphomas	0
fast foods	wheat hypersensitivity	0
cooked meat	mania	0
kava	rheumatoid spondylitis	0
tea leaves	vertex headaches	0
sugar-sweetened beverages	tonic-clonic seizures	0
safflower oil	marsh fever	0
bt corn	mixed lymphocytic-histiocytic lymphoma	0
white pepper	steatohepatitis	0
shan yao	metastatic cancer	0
not-necessarily-so-healthy foods	chronic diseases	0
retail poultry	felv	0
kombucha tea	phlebothrombose	0
squash plants	sudden infant death syndrome	0
ice cream	lyme borreliosis	0
term vegetable	drop attack	0
piper methysticum	starvation	0
lard	chronic gum disease	0
shan yaos	atherosclerose	0
foxglove	lung cancers	0
macadamia	parkinsonism dementia complex of guam amyotrophic lateral sclerosis	0
dripping	bladder tumor	0
reindeer meat	thermal hypesthesia	0
sunchoke	effort syncope	0
infant formula	guillaine-barre syndrome	0
eating nuts	atrioventricular dissociation	0
hot sauce	colorectal tumor	0
drinking coffee	intracranial central nervous system disorders	0
vitamin	back pain with radiation	1
soy bean proteins	food-borne disease	0
frying foods	common bile duct biliary calculi	0
daily nut	rash	0
horsenettle	kidney stone	0
cherry plum trees	mottled enamel	0
silybum marianums	amnesia memory loss	0
biometal	acute confusional migraines	0
almond tree	galactose-1-phosphate uridyltransferase deficiency	0
salsa	guam disease	0
hickory nuts	static tremors	0
fennel seeds	disseminated sclerosis	0
piper methysticums	respiratory infections	0
herbal teas	norwalk like viruses	0
mangosteen	micturition syncope	0
phaseolus	gastroenteritis	0
cocoa powders	leanness	0
cabbage	acquired immunodeficiency syndrome virus	0
endive	leucocythaemia	0
cauliflower	multiple myelomas	0
food supplement	rectum cancers	0
sweet almonds	broken bone	0
allium cepa	hyperphagia	0
cooked tomatoes	pyrosis	0
grapefruit juice	fibroatheromatous plaque	0
fennel	apnea	0
tepary beans	prion protein diseases	0
salami	biliary calculi	0
zedoary zedoaria	thyroid disease	0
romaine lettuce	granulomatous enteritis	0
uncooked foods	oncogenic virus	0
triticum vulgare	retro ocular headache	0
anti-inflammatory plant	aortic aneurysms	0
euterpe oleracea	recrudescence	0
high-fructose corn	sleep initiation dysfunction	0
dietary plant protein	crushing pain	0
dangerous plants	mouth cancer	0
baked potato	prostatic cancers	0
common foxgloves	male impotence	0
vegetarianism	galk deficiency	0
baking chocolate	fibromyalgia-fibromyositis syndromes	0
healthiest snack	blv	0
nutriceutical	sphenoid wing meningioma	0
stryphnodendron	high grade lymphoma	0
spearmint	ebv	0
phyllanthus emblica	foreign body	0
dietary sugars	hair loss	0
soya milk	lens opacities	0
split pea	encephalopathy	0
roughage	sphenoid wing meningioma	0
mastictree	prostatic cancers	0
prosopi	prostate cancer	0
nut butter	neonatal tremors	0
jelly	intraepithelial prostatic neoplasia	0
sweet foods	leukemogenic virus	0
recommend tea	v-cjd (variant-creutzfeldt-jakob disease)	0
high-phytate foods	light headedness	0
replenish nutrients	inflammatory disorder	0
morning meals	symptom clusters	0
bad foods	aphthous stomatitides	0
hop	paraesophageal hernia	0
plant zygotes	cancer of the colon	1
black teas	diarrhea	0
euterpe edulis	chronic cluster headaches	0
citrus limon	autistic disorders	0
whole grain	ankylosing spondyloarthritides	0
syzygium sandwicense	cancer of the breast	0
celebration meal	age-related maculopathy	0
white potatoes	acquired immuno deficiency syndrome	0
allium porrum	drug use disorders	0
coca cola	premenstrual tension	0
drinking tea	leucocythaemia	0
apple trees	gastroesophageal reflux	0
carbonated drink	hyperventilation syncopes	0
gravy	disorders of initiating and maintaining sleep	0
black walnut	polyarthritide	0
brazil nut tree	vaginal cancer	0
golden delicious	flatus	0
refined olive	anaplastic carcinomas	0
zedoary zedoarias	membranous cataract	0
pomegranate seeds	liver diseases	0
wort	pulmonary embolism	0
steamer	numbness	0
agaricaceae	male sexual impotence	0
apricot tree	gestational diabetes mellitus	0
energy drink	vaginitis	0
chamomile	hysterical amnesias	0
canned foods	barrett's esophagus	0
caramel	horton's syndrome	0
powdered sugar	ileocolitis	0
plaice	atherosclerose	0
ephedras	esophageal cancer	0
unrefined plant	deep-venous thrombosis	0
arecas	bovine leukemias	0
ilex paraguarienses	liver steatosis	0
plantago psyllium	proliferative bronchiolitis	0
brain-invasive pork	amnesia	0
fenugreek seeds	causes cancers	0
ganja	idiopathic intracranial hypertension	0
ovary	vestibular seizures	0
soy yogurt	insulin-dependent diabetes mellitus 1	0
cilantro	rabies virus	0
processing meat	hemolytic-uremic syndrome	0
filtered coffee	drug habituation	0
cardamon	backache	0
japanese plums	liver cancer	0
syzygium	benign neoplasm	0
new vitamin	manic state	0
pea families	iron deficiency	0
glucose fructose syrup	age-related maculopathy	0
big meals	breast dysplasia	0
jell-o	tongue neoplasms	0
include apples	deglutitional syncope	0
assai palm berries	cervical migraine syndromes	0
lemon verbena	gall stones	0
liquorice	torsion fractures	0
saint john's wort	retroviridae	0
origanum vulgare	uterine fibromas	0
coconut milk	drop attack	0
sushi	mixed small and large cell lymphoma	0
healthy snack	myalgia	0
sugary foods	retained surgical needle	0
chile peppers	hepatitide	0
tuna	sudden-onset diabetes mellitus	0
silken tofu	drug hypersensitivity	0
nut	thyroid disorders	0
drink tea	carsickness	0
granny smith apples	cancer of the breast	0
acacia tree	arthralgia	0
hemp plant	endometrial neoplasm	0
trace elements	germinoblastic sarcomas	0
prenatal vitamins	vaginal neoplasms	0
cider	urinary bladder diseases	0
snack food	gastroesophageal reflux disease	0
raw poultry	cancer of tonsil	0
english walnut	hormonal dysfunction	0
weed	somatotropin hypersecretion (acromegaly) syndromes	0
asparagus	back ache	0
porgy	renal insufficiency	0
juglan	pseudopelade	0
poultry products	amyloid deposits	0
plum tree	heart attacks	0
diospyros digynas	sphenoid wing meningioma	0
portulaca oleraceas	carcinoma in situ	0
rheum	auto-immune disease	0
oregano	mild cognitive impairment	0
noni fruit	ankylosing spondylitis	0
alcoholic beverage	amyotrophic lateral sclerosis	0
licorice root	hepatic cancers	0
black coffee	juvenile onset diabetes mellitus	0
tomato sauce	et-nanbh	0
assai palms	headache disorders	0
dasheen	disk degradations	0
poisonous plants	benign intracranial hypertension	0
poultry	bacterial vaginitides	0
processed meats	generalized spasm	0
citrus hystrices	saturnine tremors	0
nuclear power plants	excess cancer	0
citrus sinensis	severe gh insensitivity	0
aloe	pseudotumor cerebri	0
chilli pepper	chronic daily headache	0
rabbit meat	nonalcoholic fatty livers	0
elettaria cardamomum	cognitive impairments	0
soy bean	non b hepatitis enterically transmitted non a	0
mustard seeds	sharp headaches	0
prunus persica	breast adenosis	0
marjoram	arterial dysfunction	0
grape juice	guillain-barré syndrome	0
millet	lower back pain	0
vegetable proteins	disc degeneration	0
sweetened cereal	multiple myelomas	0
raphanus sativus	bovine leukosis	0
rooibo	massive tremors	0
cured meats	breast pains	0
oyster mushrooms	aids virus	0
citrus maxima	rash	0
purple cabbage	water stress	0
apricot	type 1 diabetes	0
vital nutrients	galactose-1-phosphate uridylyltransferase deficiency	0
mandarin orange tree	global amnesias	0
citrus fruits	head injury	0
white wine	male sexual impotence	0
persea americanas	breast cancer	0
vaccinium ashei	static tremors	0
tea plant	mammary cancer	0
gmo soybeans	lower back pain	0
solanum laciniatums	deficiency diseases	0
black sapote	hepatitide	0
raw garlic	cancer of skin	0
lemongrass	human herpesvirus 4	0
nut butters	prediabetic states	0
berberis	galt deficiency	0
sparkling water	spatial memory disorder	0
beer	weight reductions	0
green tea	cellulite	0
indian laburnums	diffuse undifferentiated lymphomas	0
radicchio	uterine cancers	0
areca nuts	obesity in adolescence	0
prunus dulcis	disorder	0
solanum lycopersicum	myelomatosis	0
nutraceutical	throbbing headaches	0
carbonated mineral waters	heart diseases	0
radish	cancer of the bladder	0
cassia trees	irritable bowel syndrome	0
sun-dried raisin	fibroatheromatous plaque	0
horse nettles	vertebrogenic pain syndrome	0
sweet marjoram	bilateral headaches	0
mentha spicatas	preventable cancers	0
hummus	peripheral artery diseases	0
elettaria cardamomums	retained surgical sponges	0
cassia tree	a-v dissociation	0
density foods	sore throats	0
caper	ulcerative colitis	0
lens culinaris	pulmonary cancers	0
black currant	alopecia	0
crab apples	germinoblastic sarcomas	0
wisconsin milk	lens opacities	0
malabar nut	pediatric obesity	0
trigonella	intention tremor	0
eugenia jambolana	stomach neoplasm	0
barberry	cancer of breast	0
pear	b-cell leukemia	0
foeniculum	reticulum cell sarcoma	0
pepper	diffuse mixed cell lymphoma	0
whale meat	erectile dysfunction	0
kale	hepatocellular cancer	0
norovirus food	short sleeper syndrome	0
dried yeast	abdominal cramps	0
curcuma	senile tremor	0
dioscorea polystachya	creutzfeldt jakob syndrome	0
cooking meat	chronic lymphoblastic leukemia	0
citrus fruit	tumor virus	0
food coloring	brain vascular accidents	0
candy bar	hereditary galactokinase deficiency	0
whiting	experimental parkinson diseases	0
capsicum	autosomal dominant juvenile parkinson disease	0
anise tea	vaginitis	0
garcinia mangostanas	todds paralysis	0
lycium barbarum	neonatal tremors	0
mustard plant	breast tumors	0
plant-based foods	joint pain	0
foenumgraecum	complete blindness	0
common foxglove	postoperative nausea	0
deli meats	phage	0
citrus hystrix	drug hypersensitivity	0
bertholletia	epithelial cancers	0
spinacia oleracea	death	0
solanum melongenas	forehead trauma	0
brussels sprouts	dyschezia	0
barley coffee	olfaction disorders	0
kenaf	renal neoplasm	0
solanum melongena	chronic fatigue disorders	0
dietary proteins	pituitary dwarfism iis	0
kiwi fruits	classic galactosemia	0
bergamot	pulmonary embolisms	0
potable water	legal blindness	0
mangifera	prediabete	0
clathrotropis	coronary heart diseases	0
sweetener	undifferentiated lymphoma	0
grapefruit	pneumonitis	0
artificial sweetener	norwalk like viruses	0
goji berries	autosomal recessive parkinsonism	0
wine	fibroid	0
dessert	malignant neoplasm of breast	0
pinto beans	cancer of the tonsil	0
althaea officinalis	glaucoma	0
grape	chronic lymphatic leukemia	0
salmonella-infected eggs	ekbom delusory parasitosis	0
dress	angioblastic meningioma	0
prunus salicinas	western diseases	0
sorrel	b12 deficiency	0
higher vegetable	kidney cancer	0
juglans nigra	muscular rheumatism	0
ground meat	mixed cell lymphoma	0
dried fruit	utp hexose 1 phosphate uridylyltransferase deficiency	0
shorten	kidney insufficiency	0
ground flax	pustulosis palmaris et plantaris	0
arugula	paroxysmal atrial fibrillation	0
lemon balm	spiral fractures	0
healthy food	neurocysticercosis	0
own vitamin	myocardial infarction	0
contaminated meat	scorbutus	0
cycad	emphysema	0
petroselinum	intervertebral disc degeneration	0
colophospermum	lung inflammations	0
leaf lettuce	gale deficiency	0
oolong tea	bladder cancers	0
zea mays	rectal cancers	0
new york coalition for healthy school food	juvenile onset diabetes mellitus	0
yeast rice	pyrosis	0
dried food	iritide	0
malabar-nut	peripheral arterial disease	0
olea europaea	heart attacks	0
regular carrots	faint	0
placenta	dysfunction	0
oatmeal	anthrax	0
chewing gums	cancer of ovary	0
piper nigrum	emphysema	0
tisane	thyroid adenoma	0
avenas	diverticulum	0
chanterelle	tonic seizure	0
plant capsules	myalgia	1
healthier foods	low-grade lymphoma	0
seven nutrients	intermittent tremor	0
gluten	philadelphia-negative myeloid leukemia	0
black rice	dental fluorosis	0
chenopodium quinoa	generalized headache	0
persea	female sterility	0
plant embryo	disrupted in b-cell malignancy	0
usda poultry	bovine spongiform encephalopathy	0
theobroma cacao	headache syndrome	0
lens plants	uterine leiomyoma	0
plant foods	parkinson's disease	0
euchresta	perioral tremor	0
unfertilized eggs	diverticulosis	0
calling eggs	vertebrogenic pain syndromes	0
artificial butter	visceral steatosis	0
andira	rectal cancer	0
arachis hypogaea	preterm birth	0
malus	cluster headaches	0
sea vegetables	cardiac diseases	0
marsh mallows	dyspepsia	0
melissa officinali	xanthomatous meningiomas	0
ceylon cinnamon	multiple myeloma	0
dietary supplement	thyroid cancers	0
morinda	dermatozoic delusion	0
macadamia nuts	udpglucose hexose 1 phosphate uridylyltransferase deficiency	0
eat chocolate	prostatic adenomas	0
apium graveolens var. rapaceum	manic depressive psychoses	0
paella	degenerative arthritis	0
prunus armeniaca	postoperative vomiting	0
human milk	behavior disorders	0
cooking oil	endometrial carcinoma	0
marijuana	mild neurocognitive disorder	0
mussel	bilateral sciatica	0
measuring food	varicose vein	0
citrus sinenses	osteoarthrosis	0
curried tofu	muscle tremors	0
cranberry	dementia praecox	0
cinnamomum trees	inflammatory bowel diseases	0
club soda	experimental parkinson diseases	0
lunch times	ankylosing spondylarthritides	0
frequent meals	diabetic mononeuropathy simplex	0
rutabaga	scorbutus	0
kola nut	multiple myelomas	0
red wine	starvation	0
ultra-processed foods	cephalalgia	0
sparkling waters	infectious disease	0
flavoring	malignancy	0
white rice	contusion	0
neutraceutical	abdominal aortic aneurysm	0
no meat	myalgia	0
fig	creutzfeldt jakob disease	0
chile pepper	cancer of the lung	0
cannabis sativa	ebv	0
citrus paradisi	hemangioblastic meningiomas	0
octopus	tonic-clonic seizures	0
rise	acute inflammatory polyradiculoneuropathy	0
adding blueberries	primary malignant brain neoplasms	0
food companies	cacosmia	0
chia seeds	diverticulitide	0
rose hips	hemangioblastic meningioma	0
thyme	prostatic adenoma	0
melissa	dims (disorders of initiating and maintaining sleep)	0
fake meat	muscle pains	0
eugenia malaccensis	pleomorphic lymphoma	0
organic plants	inflammatory diseases	0
guibourtia	intervertebral disk degeneration	0
eating food	syncopal vertigos	0
kangaroo meat	uterus neoplasm	0
almond oil	atherosclerotic plaque	0
thousand foods	celiac disease	0
carica papayas	cancer of the rectum	0
powdered ginger	indigestion	0
pecan trees	lung neoplasm	0
healthier meat	widespread chronic pains	0
papaver	preventing cancer	0
taraxacum officinale	deep-venous thrombosis	0
pine nuts	light headedness	0
white meat	prostatic adenomas	0
acai berries	oncogenic viruses	0
wild celery	primary gh resistance	0
melissa officinalis	ciguatera poisonings	0
almond	galactose epimerase deficiencies	0
alfalfa	cancer of the testes	0
soy food	brain cysticercosis	0
strawberry	parodontose	0
shiitake mushrooms	brain tumors	0
citrus aurantiifolias	sleeplessness	0
solanum dulcamaras	primary insomnia	0
cashew	auriculo-ventricular dissociations	0
salmonella food	gall stones	0
citrus aurantiifolia	lymphoblastic leukemia	0
cannabis sativas	polyradiculoneuritis	0
chili	vitamin deficiency	0
gooseberry	peripheral artery disease	0
algarrobo	monocytic leukemia	0
raw tomatoes	rectal cancers	0
margarine	male pattern alopecia	0
gala apples	lymphocytic lymphoma	0
black pepper	lead poisoning	0
acer negundo	acquired blindness	0
coriandrum sativums	cadaver	0
red meats	paroxysmal atrial fibrillations	0
fried foods	prostatic adenoma	0
chocolate bars	spinal cord disorders	0
dioscorea	infection	0
kiwi	acquired immune deficiency syndrome	0
fries	gallstone	0
cereal grain	muscle spasm	0
soy proteins	diabetic polyneuropathy	0
common bean plants	adolescent gynecomastia	0
maple syrup	human t-lymphotropic virus type iii	0
vicia fabas	gastro esophageal reflux	0
cantaloupe	cervix cancers	0
anticancer plant	bechterews disease	0
lemon grass	rash	0
erythroxylon	increased cancer	0
hemp plants	human cancer	0
sesame	lymphocytic lymphoma	0
garcinia mangostana	sprain	0
yolk	involuntary quiver	0
scallion	psammomatous meningiomas	0
licorice	parkinson’s disease	0
sweet orange	nephrolith	0
entree	motor seizure	0
corn oil	ekbom delusory parasitoses	0
carya illinoenses	superficial head injuries	0
english walnuts	gout	0
pumpkin seeds	fine tremors	0
artichoke	b-cell leukemia	0
pistacia	generalized seizures	0
mandarin orange trees	non-b hepatitis epidemic non-a	0
turmeric	muscle sorenesses	0
narrow-leaved plantain	esophagus cancer	0
butter	gall bladder disease	0
triticum	acute infectious polyneuritis	0
empty calorie foods	oncogenic virus	0
coriandrum	cerebral convexity meningiomas	0
capsicum annuum	gallstone	0
low-salt diet	breast neoplasm	0
mastic tree	deficiency disease	0
green onions	dental plaque	0
kawa	visceral obesity	0
dioscorea opposita	age-related macular degenerations	0
sweet basils	circulatory collapse	0
mastic trees	hansen's disease	0
hypericum	viral infection	0
eating eggs	undifferentiated carcinoma	0
ready-prepared foods	gastro-esophageal reflux	0
laciniate nightshades	dyslipoproteinemia	0
jambolan plum trees	wart	0
food allergies	serious disease	0
bertholletia excelsa	reticulum-cell sarcomas	0
kidney beans	papillary meningiomas	0
plantago seed	feline lymphoma virus	0
star anises	gall bladder disease	0
diospyros digyna	chronic obstructive airway disease	0
ribe	itch	0
carduus marianus	throbbing headache	0
olive trees	nonhodgkins lymphoma	0
morinda citrifolias	female sterility	0
pickled vegetables	small round-structured viruses	0
adhatoda vasica	cerebrovascular strokes	0
wild radish	rheumatoid spondylitis	0
hordeum vulgare	crohn's disease	0
sweeten	utp hexose-1-phosphate uridylyltransferase deficiency	0
rice milk	cva (cerebrovascular accident)	0
ocimum sanctum	gluten enteropathies	0
lycium chinense	gorlin goltz syndrome	0
spaghetti	gastro-oesophageal reflux	0
bolete	infantile obesity	0
citrus-based fruits	malignant brain neoplasm	0
granny smith	iddm	0
applesauce	e b virus	0
avocado	bacterial vaginosis	0
grouper	vaginal neoplasm	0
oregano plants	ankylosing spondylarthritides	0
bitter orange trees	zoonotic infections	0
ceratonia	auditory seizures	0
venison	vaginal cancers	0
organ meats	human herpesvirus 4	0
rosemary	intermittent tremor	0
maguey	vaginal cancer	0
avoid peanuts	sensory seizure	0
candy bars	elevated cholesterols	0
citrus bergamias	high cholesterol level	0
areca	psychogenic parasitosis	0
soy protein	galactose 1 phosphate uridyltransferase deficiency	0
dried pomegranate	bacterial infection	0
texturized soy proteins	gastro esophageal reflux	0
kaffir lime	serious disease	0
cassia cinnamon	polyradiculoneuropathy	0
chamomile oil	bone fracture	0
calendula officinalis	jakob-creutzfeldt syndrome	0
zingiber officinales	myelopathy	0
veal	low-grade b-cell malignancy	0
low-fat diet	cancer of lung	0
rubus	udp galactose 4 epimerase deficiency disease	0
thymus	senile plaque	0
olive tree	strain	0
fresh basil	mouth neoplasm	0
secale cereale	brain cysticercosis	0
morning meal	e b virus	0
poultry product	social phobia	0
tofu	fibrocystic changes of breast	0
carya illinoensis	gestational diabetes mellitus	0
bell pepper	non b hepatitis enterically transmitted non a	0
red delicious	cognitive dysfunctions	0
rye bread	fighting cancer	0
indian corn	macular dystrophy	0
syzygium cumini	vaginitis	0
eugenia jambos	v cjd (variant creutzfeldt jakob disease)	0
ficus	hysterical blindness	0
green peppers	virus disease	0
lavender	different cancer	0
squid	chest pains	0
plantago indica	acne	0
watercress	epithelial cancer	0
stevia rebaudiana	reticulum-cell sarcomas	0
ready-prepared food	ovarian cancers	0
molasses	psychosis	0
calendula officinali	deglutitional syncope	0
earl grey tea	chronic headache	0
syzygium jambolanum	massive tremor	0
chinese cinnamon	liver diseases	0
rooibos tea	symptom clusters	0
illicium anisatums	palsy	0
concord grape	primary fibromyalgia	0
sesame oils	irritable colon	0
kava kava	hernia	0
spice saffron	relapse	0
feather meal	bipolar affective psychosis	0
pizza	chronic illnesses	0
raspberry	tongue cancer	0
toronja	semirhythmic tremor	0
greenery	gastro oesophageal reflux	0
bean sprouts	urinary bladder disease	0
cookie	gale deficiency	0
narrow-leaved plantains	occipital traumas	0
mentha spicata	vagina neoplasms	0
cymbopogon	fibromyalgia fibromyositis syndrome	0
digitalis	pulmonary cancer	0
breast milk	jacksonian seizure	0
brassica	oxygen deficiency	0
tv dinners	pustulosis palmaris et plantaris	0
overpriced vitamin	chronic b-lymphocytic leukemias	0
kiwi fruit	sterility	0
mentha piperita	nonalcoholic fatty liver	0
cymbopogon nardus	gingivitide	0
different fruits	campylobacter infection	0
nettle tea	uterus cancer	0
dried fruits	brains cancer	0
baby formulas	schizophreniform disorders	0
trace mineral	reduced sensations	0
jelly beans	v-cjd (variant-creutzfeldt-jakob disease)	0
rheum rhaponticum	cancer of endometrium	0
seed	myelomatose	0
vaccinium macrocarpon	lyme disease	0
ranking foods	bronchiolitis	0
texturized vegetable proteins	carcinomatose	0
cayenne	fibrositide	0
pomegranate	iron deficiency	0
thymus vulgaris	premenstrual syndromes	0
pistil	baldness	0
cacao	small round structured viruses	0
warm milk	single seizure	0
plantain	seizure disorder	0
kava kavas	chest pain	0
plant embryos	perforated appendicitis	0
fortify milk	air sickness	0
wheat bran	bowel disease	0
sea bilberry	iddm	0
dressing	brain conditions	0
citrus bergamia	cancer of bone	0
sweet almond	chromosome 6 linked autosomal recessive parkinsonism	0
flavorer	ache	0
common fruits	situational syncope	0
hickory tree	eczematous dermatitis	0
food additive	renal failure	0
mesquite	influenza	0
colorful foods	alzheimer’s disease	0
red onions	foodborne botulisms	0
indian laburnum	neurotic anxiety states	0
amaranth	vaginal neoplasms	0
antioxidant-rich food	hypolactasia	0
organic food	pediatric obesity	0
origanum majorana	chronic daily headache	0
dietary sucrose	creutzfeldt jacob disease	0
maize oil	male breast cancer	0
decrease meat	phlebothrombose	0
honey	human t lymphotropic virus type iii	0
little meat	epstein-barr virus	0
pimenta officinalis	encephalon disease	0
coriandrum sativum	craniocerebral traumas	0
carbonated waters	visual seizures	0
psidium guajavas	ovary neoplasm	0
red delicious apples	age related macular degeneration	0
boiled eggs	semirhythmic tremor	0
crowberry	basal cell nevus syndrome	0
acer saccharums	vaginal neoplasm	0
french bean plants	splitting pains	0
alcoholic beverages	olfaction disorders	0
tomato	igf-1 deficiency	0
taking vitamin	texidor's twinge	0
eugenia caryophyllata	atrial fibrillations	0
fenugreek seed	severe congenital microcephalies	0
lens culinari	menstrual pains	0
laudable legume	fibromyalgia-fibromyositis syndromes	0
alfalfa sprouts	global amnesia	0
humulus lupulus	familial tremors	0
cocoa butter	basal cell epithelioma	0
brussel sprout	thyroid diseases	0
legume pod	schizoaffective disorders	0
salt-free diet	lens opacity	0
texturized soy protein	bladder cancer	0
fat milk	renal neoplasms	0
cherry plum tree	painful menstruation	0
pimiento	cancer of the breast	0
assai palm berry	autosomal dominant juvenile parkinsonism	0
flowering shrub	lymphatic sarcomas	0
monosodium glutamate	intraepithelial prostatic neoplasia	0
coleslaw	progressive disorder	0
punica granatum	cognitive impairments	0
incorporate cloves	cirrhosis	0
mentha x piperita	arrythmia	0
exotic fruit	fibrocystic mastopathy	0
soymilk	back pain without radiation	0
vegetable juices	disorders of initiating and maintaining sleep	0
shiitake	acute monoblastic leukemias	0
mint	mucous colitis	0
marihuana	indigestion	0
milk proteins	reticulolymphosarcoma	0
national pork	gnathostomiasis	0
assai palm	muscle pain	0
century plants	guillaine barre syndrome	0
vaccinium myrtillus	sharp headaches	0
garden radish	oncogenic viruses	0
nicotiana tabacums	inflammatory polyneuropathy acute	0
roasted almonds	intraventricular meningioma	0
olive oil	experimental parkinson disease	0
added sweeteners	age-related maculopathy	0
box elders	strains and sprains	0
pimpinella anisum	malaria	0
chickpea	encephalon diseases	0
mother cell	autosomal recessive familial parkinson disease	0
soy cheese	oncornavirus	0
infant formulas	arthrosis	0
specific cheeses	myocardial failure	0
white mallow	generalized headache	0
vaccinium corymbosum	near-death experience	1
trompillo	urinary tract infection	0
yogurt	intervertebral disc degenerations	0
peach trees	headache syndrome	0
plant aril	cancer of the tonsil	0
nicotiana tabacum	skin neoplasms	0
white mallows	pruritus	0
pummelo trees	drug addiction	0
seltzer waters	subacute spongiform encephalopathies	0
rubberplant	monoblastic leukemia	0
pease	diverticulitide	0
lavandula	intermediate-grade lymphoma	0
mint tea	comatose	0
supper	intestinal diseases	0
callerya	peripheral arterial disease	0
olive	vertebrogenic pain syndrome	0
porphyra	neuritic plaques	0
baby spinach	respiratory tract cancer	0
fruit juices	retro-ocular headaches	0
bok choy	cancer of thyroid	0
bran flakes	hypermelanose	0
citronella	galactose 1 phosphate uridylyltransferase deficiency	0
sour fruit	acute inflammatory polyradiculoneuropathy	0
high fructose maize syrup	congenital hypothyroidism	0
low meat	alopecia	0
prunus salicina	creutzfeldt-jakob syndrome	0
phaseolus acutifolius	lymphocytic lymphoma	0
spicy food	infantile botulism	0
juglans regia	acne	0
atropa belladonnas	burning pains	0
mirobalanus embilica	deafness	0
romaine	cognitive declines	0
cuminum cyminum	cancer of kidney	0
sugar maple	ankylosing spondylarthritides	0
food additives	multiple sclerosis	0
pistachio nut trees	idiopathic polymyositides	0
conventional food	sudden cardiac arrest	0
skim milk	multiple myelomas	0
hibiscus tea	acquired immuno-deficiency syndrome	0
drinking orange	sliding hiatal hernia	0
basil	urinary bladder cancer	0
beverage	persistent atrial fibrillations	0
peanut	nanism	0
hibiscus	seizure disorder	0
frying meat	cognitive dysfunction	0
anacardium occidentales	deficiency disease	0
caffeinated coffee	salami brusher's disease	0
tap water	non-epileptic convulsions	0
handling food	soft tissue sarcomas	0
cucumis melos	basal cell epitheliomas	0
ephedra	anal ulcers	0
sesame oil	salami brusher's disease	0
pineapple	galactose-1-phosphate uridyl-transferase deficiency disease	0
plant arils	cysticercose	0
snacktime	gum disease	0
soda pops	paraosmia	0
raw broccoli	dissociative amnesia	0
plant zygote	infantile colic	1
serve	tonsil cancer	0
chestnut	lactose malabsorption	0
bell peppers	colorectal tumors	0
pureed apples	ph1-negative myelogenous leukemias	0
deep-fry foods	lymphadenopathy-associated virus	0
juiced broccoli	kidney diseases	0
ultra-processed food	leukemia	0
coconut	sneeze	0
apricot trees	cancer of prostate	0
cassia fistula	cataract	0
artificial sweeteners	hysterical blindness	0
nut bars	migraine headache	0
citrus grandi	udp galactose 4 epimerase deficiency	0
colocasia	abdominal aortic aneurysm	0
origanum onites	cryptogenic epilepsies	0
nettle	clonic seizures	0
flesh foods	neurodegenerative diseases	0
milkshake	small-cell lymphoma	0
flammulina velutipes	papillomaviridae	0
hemlock	episodic cluster headaches	0
junk food	viral infection	0
taro	brain disease	0
purine-rich plant	wheat allergy	0
goji berry plants	reproductive sterility	0
celeriac	muscle tremor	0
alpine strawberries	prion-induced disorders	0
alpine strawberry	cognitive impairments	1
goji berry	severe mental disorder	0
pithecellobium	udp-galactose-4-epimerase deficiencies	0
chilli peppers	proliferative bronchiolitis	0
oregano plant	respiratory tract infections	0
infects apples	atypical diffuse small lymphoid lymphoma	0
aspalathus linearis	guillaine barre syndrome	0
california avocado	cardiogenic syncope	0
candy	bacteriophage	0
cassia	lobar pneumonia	0
prunus cerasifera	horton syndrome	0
yerba mate	cancer of the bone	0
cucumis sativus	unhealthy conditions	0
ready soybeans	auto-immune disease	0
diet	dims (disorders of initiating and maintaining sleep)	0
food company	male breast enlargement	0
favorite meals	malignant epithelial tumors	0
plum	charcot disease	0
whole wheat	human mammary carcinoma	0
rosa	tick bites	0
crunch berries	kidney failures	0
buckwheat	pediatric obesity	0
breast milks	chronic lymphocytic leukemias	0
edible grains	infant obesity	0
emphasizes vegetables	allergic reaction	0
chinese cassias	histamine cephalgia	0
chai tea	congenital defect	0
healthy foods	benign meningiomas	0
papaver somniferum	occipital region traumas	0
fructose corn	galk deficiencies	0
cocos nuciferas	cervical neoplasm	0
almond trees	national cancer	0
jalapeno pepper	body weight	0
safflower	small-cell lymphoma	0
citrus grandis	icterus	0
cocos nucifera	t virus	0
solanum	radiating pain	0
corn	cerebrovascular accidents	0
cruciferous vegetable	endometrium carcinomas	0
triticum spelta	malaria	0
soybean	excess cancer	0
cinnamomum aromaticum	postoperative nausea and vomiting	0
baby carrots	esophageal reflux	0
kohlrabi	birth defects	0
pancake	hair losses	0
chili peppers	diabetic amyotrophies	0
food allergy	sinusitis	0
wild yams	lyme disease	0
maize oils	gluten enteropathy	0
stem vegetables	dissociative amnesias	0
natto	ductal carcinoma	0
salad	dental diseases	0
oats	eye disease	0
flavourer	type c oncoviruses	0
shiitake mushroom	metabolic acidosis	0
black raspberries	macular dystrophy	0
organ	colonic cancers	0
chinese cassia	kill cancer	0
table sugar	impaired sensation	0
horse beans	intracranial neoplasms	0
vaccinium macrocarpons	visual seizures	0
psidium guajava	cardiac sudden death	0
whole grains	osteoporosis	0
foeniculum vulgare	physical anhedonia	0
grape seeds	phlebothrombosis	0
syzygium malaccense	male sexual impotence	0
anti-inflammatory foods	age-related bone loss	0
elephant garlic	melanoma	0
antioxidant foods	cranial pains	0
pummelo tree	esophagus cancers	0
amomum cardamomums	myocardial infarct	0
french bean plant	undifferentiated lymphoma	0
sour cream	hansen disease	0
reason food	angioblastic meningioma	0
actual fruit	spindle-cell carcinomas	0
lima beans	pyrosis	0
machaerium	excess cancer	0
nonfat meal	paraesophageal hernia	0
psidium	metabolic acidosis	0
buttermilk	heat strokes	0
honeybush tea	female sub fertility	0
triticum turgidum	peanut allergy	0
aspalathus	familial dementias	0
dark meat	human papillomavirus viruses	0
chinook salmon	death	0
grecian foxgloves	gastric neoplasms	0
food manufacturers	chronic b lymphocytic leukemia	0
nonus	bse (bovine spongiform encephalopathy)	0
wheat brans	campylobacter infections	0
eating fruits	colonic cancers	0
scrambled eggs	prostate cancer	0
anacardium	breast pains	0
antioxidant vitamin	substance abuse	0
sesamum	amyloidose	0
beet	inflammatory polyneuropathy acute	0
color	neoplasm metastases	0
althaea	environmental cancer	0
carrot	undifferentiated carcinomas	0
legume pods	foodborne illnesses	0
pimenta	diabetic complications	0
dairy eggs	kidney stones	0
flax seeds	inflammatory bowel disease 1	0
cinnamomum cassia	lymphatic sarcomas	0
purslane	short sleep phenotype	0
cardamom	atypical chronic myeloid leukemia	0
cupcake	increase cancer	0
food colors	female sub-fertility	0
collard	sudden cardiac death	0
international nut	guam form amyotrophic lateral sclerosis	0
andean blackberries	social phobia	0
banana	widespread chronic pains	0
ocimum basilicum	ponv	0
garlic sauce	sore throat	0
smoked food	diabetic polyneuropathy	0
kawa kawa	zoonotic diseases	0
topical ginger	nonhodgkin lymphoma	0
oyster mushroom	bacteriophage	0
pimenta officinali	gastric ulcer	0
cheese	burkitt lymphoma virus	0
larder	spondyloarthritis ankylopoietica	0
foodstuff	familial guillain-barre syndrome	0
cocoa	tongue neoplasms	0
bean sprout	tick bites	0
tulsi tea	pulmonary disorder	0
mustard plants	convulsion	0
triticum aestivum	benign meningioma	0
restructured meat	androgenetic alopecia	0
dinner	prion induced disorder	0
new candy	poisoning	0
woodland strawberries	variant creutzfeldt-jakob disease	0
amygdalus communis	pancreas cancer	1
milk protein	acquired immuno-deficiency syndrome	0
portulaca oleracea	renal failures	0
healthiest beverage	colonic cancer	0
pickled foods	acquired immuno deficiency syndrome	0
mangifera indicas	chest pains	0
hordeum	syncope	0
citrus reticulata	deep-venous thromboses	0
grilled meat	nafld	0
bitter orange tree	thyroid disease	0
brewage	diabetes complications	0
rice	gall bladder diseases	0
virgin olive	brain benign neoplasms	0
broccoli raab	muscular spasm	0
muffin	post ictal confusion	0
pumpkin pie	heart blocks	0
hazelnut	temporary amnesia	0
cured meat	deep-vein thrombosis	0
common olive trees	horton syndrome	0
triticum turgidum subsp. durum	gasser's syndrome	0
lentil	plasmodium infections	0
preserved foods	sudden-onset diabetes mellitus	0
high fructose corn syrup	atrioventricular dissociations	0
beef	degenerative intervertebral discs	0
anacardium occidentale	symptom clusters	0
flax	hepatic neoplasm	0
yellow vegetables	halitose	0
saffron crocus	bone cancer	0
marjoram plants	retained surgical sponges	0
msg	postoperative emeses	0
organic foods	varicose vein	0
dioscorea villosa	recurrent brain tumors	0
tomato juice	non-b hepatitis enterically-transmitted non-a	0
adhatoda	syncopal vertigos	0
hickory trees	vagina neoplasm	0
mother cells	canker sores	0
brassica nigra	cjd (creutzfeldt jakob disease)	0
energy drinks	rheumatoid arthritis	0
no noni	odontogenic keratocysts multiple basal cell nevi	0
soy beans	vertebrogenic pain syndrome	0
weekly meat	acquired immuno-deficiency syndrome	0
american meat	hyperemesis gravidarum	0
animal food	degenerative diseases	0
dairy yogurt	adolescent obesity	0
phaseolus vulgaris	uveitis	0
petroselinum crispum	lens opacity	0
citrus medica	ciliary neuralgia	0
rose berries	amnestic state	0
cannabis indicas	chronic b-lymphocytic leukemias	0
fresh ginger	breast cystic diseases	0
oryza sativa	infertility	0
mustard	sprains and strains	0
no coffee	transmissible spongiform encephalopathies	0
anise	abdominal obesity	0
eragrostus	adenomatous polyp	0
yoghurt	auto-immune disease	0
so-called meat	diffuse lymphocytic lymphoma	0
betel nuts	brief reactive psychoses	0
fragaria	pulmonary thromboembolism	0
food poisoning	gehrig disease	0
cocktail	posterior fossa meningioma	0
hot peppers	stomach cancers	0
healthiest nuts	lactose intolerance	0
fava beans	obesity in childhood	0
chamomile tea	age-related osteoporosis	0
golden raisins	diffuse undifferentiated lymphoma	0
red cabbage	hypoascorbemia	0
green beans	pituitary dwarfism ii	0