
tepary beans	acquired immuno-deficiency syndromes	0
eden foods	anhedonia	0
four nuts	non-alcoholic fatty liver disease	0
largest meal	breast tumors	0
lemon trees	ciliary neuralgias	0
poultry meat	hepatic neoplasms	0
illicium anisatum	prostatic hypertrophy	0
uncooked foods	erectile dysfunction	0
meal times	cognitive retention disorders	0
poroporo	breast malignant tumor	0
flaxseed	inhibit cancer	0
saffron	ramsay hunt paralysis syndrome	0
chewing fruit	chronic lymphocytic leukemias	0
bean	uterine cervical cancer	0
low-sodium diet	respiratory tract infections	0
high-fat meal	pneumonitide	0
soy yogurt	neoplasia	0
adhatoda vasica	cancer of the lung	0
tarragon	hypersensitivity	0
daily fruit	abdominal aortic aneurysms	0
white potatoes	paraesophageal hiatal hernias	0
split pea	human herpesvirus 4 (gamma)	0
carbonated drink	cancer of the brain	0
preserved foods	burning pains	0
kavas	galt deficiencies	0
salt-free diet	charcot disease	0
big meals	testicular cancers	0
shan yaos	soft tissue sarcoma	0
oregano plant	anal fissure	0
sweetened cereal	gingivitide	0
lemon grass	olfaction disorder	0
veggie	bladder diseases	0
new candy	weight losses	0
avena sativa	texidor's twinge	0
lens plants	postoperative nausea	0
fagopyrum sagittatum	endometrial carcinoma	0
mint	degenerative intervertebral disks	0
pimenta	small non cleaved cell lymphoma	0
opium poppy	adenomatous polyps	0
prunus cerasifera	granulomatous colitis	0
peppermint oil	prostate neoplasm	0
silybum marianums	drug use disorder	0
mirobalanus embilica	arrythmia	0
crunch berries	degenerative intervertebral disks	0
piper methysticums	post-ictal confusion	0
hibiscus	mixed-cell lymphomas	0
fresh meat	auto-immune diseases	0
food poisoning	heart blocks	0
glycyrrhiza	gastro esophageal reflux	0
juglans nigra	acute monocytic leukemia	0
scallion	familial tremors	0
bertholletia excelsa	psychogenic parasitoses	0
adding blueberries	gnathostomiasis	0
emphasize plant	premenstrual syndrome	0
food additive	physical sufferings	0
last meal	hemolytic uremic syndrome	0
red peppers	skin neoplasms	0
citrus bergamia	motor seizure	0
buckwheat	colonic cancer	0
punica granatums	virus disease	0
california avocado	oxygen deficiencies	0
prunus salicina	visceral steatoses	0
dietary fibers	male sterility	0
raisin	smell disorder	0
vodka	autoimmune condition	0
zingiber officinale	communicable diseases	0
portulaca oleracea	severe congenital microcephalies	0
sandwich	gluten sensitive enteropathy	0
garden radish	plasma cell myeloma	0
red delicious apples	cot deaths	0
cinnamomum cassia	bilateral headache	0
convenience foods	prostatic cancer	0
healthiest fruits	intraepithelial prostatic neoplasia	0
potato	nonhodgkin's lymphoma	0
romaine lettuce	microglandular adenosis	0
lens culinari	zoonotic disease	0
seven nutrients	intervertebral disk degenerations	0
allium cepa	coma	0
whale meat	heart block	0
recommend tea	lymphoblastic leukemia	0
plant foods	alopecia cicatrisatas	0
jambolan plum trees	polyradiculoneuritide	0
safflower oils	deglutitional syncopes	0
pepper	virus disease	0
clove	muscle cramps	0
currant	deep vein thrombosis	0
table sugar	prostatic intraepithelial neoplasias	0
bergamot	chronic daily headaches	0
big apples	human herpesvirus 4	0
coconut oil	chronic disease	0
low meat	drop attacks	0
sweet marjorams	plasma-cell myelomas	0
animal food	fifth phacomatoses	0
wheat	joint disease	0
common foxglove	thyroid disease	0
eragrostus	cancer of mouth	0
nut butter	nasal cavity cancer	0
trace element	ekbom dermatozoic delusion	0
pork	terminal ileitis	0
pretzel	alopecia cicatrisata	0
cocoa powder	ph1 negative myeloid leukemia	0
carica papaya	menstrual pain	0
plum trees	mixed-cell lymphoma	0
horsebean	barrett epithelium	0
hazelnut	polymyositis	0
grilled meat	intervertebral disk degenerations	0
delonix	retained surgical instrument	0
stevia rebaudiana	brief reactive psychosis	0
salsa	classic galactosemias	0
century plants	intermediate-grade lymphoma	0
chamomile oil	liver disease	0
st. john's wort	pituitary dwarfism ii	0
plant-based nutrients	vertebrogenic pain syndromes	0
dried peas	multiple meningiomas	0
amomum cardamomums	joint pains	0
trigonella foenum graecum	high-grade lymphomas	0
tomato	sudden onset diabetes mellitus	0
lentil	verruca	0
food companies	parkinsonian disorders	0
morning meal	galactokinase deficiencies	0
white wine	jaundice	0
cooked tomatoes	pancreas neoplasm	0
artificial butter	pill rolling tremors	0
curcuma zedoarias	manic disorders	0
roundup-ready soybeans	obesity	0
food additives	substance use disorder	0
dietary sucrose	male impotence	0
purple cabbage	premenstrual tension	0
carbonated drinks	manic depressive psychosis	0
jelly beans	hemangiopericytic meningioma	0
dioscorea villosa	mad cow diseases	0
purple grape	degenerative neurologic disorders	0
hawthorn	deep venous thrombosis	0
high-fructose corn	atrioventricular dissociations	0
brassica napus	gall stones	0
lunch times	hortons syndrome	0
marjoram plant	sleep initiation dysfunction	0
study lavender	non-b hepatitis enterically-transmitted non-a	0
cheese	paroxysmal atrial fibrillation	0
bok choy	irritable bowel syndromes	0
nightshade	e-b virus	0
espresso	gastric neoplasms	0
baby spinach	neurologic degenerative disease	0
bagel	prostatic hypertrophy	0
dioscorea opposita	texidor twinge	0
osmanthus	fine tremor	0
different fruits	physical sufferings	0
trigonella foenum-graecum	lung diseases	0
ribe	sleep initiation dysfunction	0
crataegus monogynas	aphthae	0
jalapeno pepper	primary growth hormone resistance	0
portulaca oleracae	mad cow disease	0
jerusalem artichokes	postural syncopes	0
frying meat	gingivitis	0
cynara scolymus	hyperthermia	0
kiwi fruit	male infertility	0
wheat brans	right sided heart failure	0
citrus aurantiifolia	comatose	0
chinese cassia	uterine cervical neoplasm	0
whole grain	protein deficiencies	0
citrus aurantiums	galk deficiency	0
sea bilberry	papillomaviridae	0
contamination meat	cerebrovascular accident	0
citrus fruit	pulmonary inflammations	0
oatmeal	oncornavirus	0
cocos nucifera	sharp headaches	0
frosting	social phobia	0
dietary plant proteins	benign neoplasm	0
soy protein	hemorrhage	0
calendula	infantile autism	0
petroselinum crispums	widespread chronic pains	0
teff	age related maculopathy	0
experience food	cramp	0
opium poppies	encephalon disease	0
colophospermum	retained surgical items	0
chewed coca	static tremors	0
steak	pulmonary embolism	0
weed	neurologic degenerative condition	0
faba beans	gluten enteropathy	0
watercress	pseudotumor cerebri	0
mustard plant	joint disease	0
artificially-flavored corn	crohn’s disease	0
brown sugar	male breast neoplasms	0
food pyramid	male sterility	0
whole grain cereals	inflammatory polyneuropathy acutes	0
rose hips	prion-induced disorder	0
malabar nut	cerebral stroke	0
fed beef	dizziness	0
ready-to-eat meals	insulin dependent diabetes mellitus 1	0
legume pod	pancreatic neoplasms	1
human milk	prostate cancers	0
ocimum tenuiflorum	hansen's disease	0
eugenia caryophyllata	skin neoplasms	0
sesame oil	parkinsonism-dementia complex of guam amyotrophic lateral sclerosis	0
sour orange trees	ovary neoplasm	0
organic plants	frontal region trauma	0
wolfberry	prostatic cancer	0
willow tree	parkinsonian syndrome	0
kidney bean	lung diseases	0
glucose-fructose syrup	ovary cancers	0
orange tree	bruise	0
french bean plant	myelogenous leukemia	0
greenery	olfactory groove meningiomas	0
marshmallow	sleep related neurogenic tachypnea	0
poppy seeds	insulin-dependent diabetes mellitus	0
indian gooseberries	atherosclerotic plaques	0
saint john's wort	stokes-adams syncope	0
banana	benign prostatic hypertrophy	0
pomegranate	fibrositide	0
japanese plum	hypesthesia	0
mustard plants	grave’s disease	0
commercial milk	somatosensory seizure	0
specific foods	acute stroke	0
fragaria vesca	vagina cancer	0
capsicum	lobar pneumonias	0
cooking meat	brain malignant neoplasms	0
chamomile oils	parkinsonian syndromes	0
hibiscus tea	e-b virus	0
acer saccharums	experimental lung inflammation	0
black walnut	stokes adams syncope	0
soy beverage	lymphoplasmacytoid lymphoma	0
raw poultry	ileocolitis	0
solanum lycopersicum	age-related memory disorder	0
oolong	craniocerebral traumas	0
stevia rebaudianas	disorder	0
cuminum cyminum	memory deficit	0
chocolate	soft tissue sarcomas	0
acer	kahler disease	0
citron tree	polyradiculoneuritide	0
seltzer water	androgenic alopecias	0
pimpinella anisum	physical suffering	0
chinese yams	retained surgical needles	0
apricot tree	coarse tremors	0
agave	venereal wart	0
raphanus	marie struempell disease	0
thymus plants	spondylitis ankylopoietica	0
psidium guajava	chronic fatigue fibromyalgia syndrome	0
taking vitamin	diffuse small cleaved-cell lymphoma	0
morinda	coarse tremors	0
coriander	juvenile onset diabetes mellitus	0
sesame oils	heatstroke	0
rosehip	cardiogenic syncope	0
citrus x paradisi	premenstrual syndrome	0
dinner times	polymyositis	0
blueberry plants	cryptogenic epilepsies	0
nicotiana	salmonella infections	0
laciniate nightshade	post-traumatic osteoporosis	0
syzygium jambolanum	idiopathic proctocolitis	0
corn	unhealthy conditions	0
bitter orange tree	histamine cephalgias	0
melissa officinali	sciatic neuralgias	0
flavourer	spatial memory disorders	0
isoglucose	carcinogenesis	0
vaccinium macrocarpon	dental disease	0
milk thistles	delusory parasitosis	0
mentha x piperita	cluster headaches	0
blossom	microlissencephaly	0
colorful foods	renal calculi	0
rye bread	prostate cancers	0
tempeh	e-b viruses	0
maize syrup	non hodgkins lymphoma	0
spicy food	hemorrhage	0
regular olive	polymyositis ossificans	0
olive oils	syncopal vertigo	0
dog rose	bilateral sciatica	0
lemongrass	familial juvenile parkinsonism	0
saint john wort	low back aches	0
citrus sinenses	non-hodgkin's lymphoma	0
sugar water	pulmonary neoplasms	0
yerba mate	diverticulum	0
filtered coffee	barrett's esophagus	0
lipomul	phlebothrombose	0
peanut butter	amyotrophic lateral sclerosis with dementia	0
celery	acquired immuno-deficiency syndromes	0
chlorella	generalized seizures	0
aubergine	fibrocystic disease of breast	0
black pepper	muscle pains	0
persea americanas	lung diseases	0
new york coalition for healthy school food	well-differentiated lymphocytic lymphoma	0
nut butters	chronic fatigue-fibromyalgia syndrome	0
whole wheat	small noncleaved-cell lymphoma	0
low-salt diet	tonsil neoplasm	0
coriandrum sativum	retained surgical instrument	0
corn oils	endometriosis	0
garbanzo	limb cramps	0
poppy	hysterical amnesias	0
healthier meat	guillain-barré syndrome	0
curcuma	carcinomatosis	0
beta vulgari	bipolar depression	0
nutraceutical	degenerative intervertebral disk	0
beet greens	postoperative nausea	0
glycine max	cervical cancer	0
soy bean	monoblastic leukemia	0
ice cream	utp hexose-1-phosphate uridylyltransferase deficiency	0
jalapeno peppers	myeloid leukemia	0
mussel	diabetic asymmetric polyneuropathies	0
salmonella food	proliferative bronchiolitides	0
sustenance	chronic pains	0
hordeum	undifferentiated carcinomas	0
lard	preterm birth	0
meal time	degenerative neurologic diseases	0
acacia tree	cardiac arrhythmias	0
honeybush tea	respiratory tract infection	0
zedoary zedoarias	infectious mononucleosis viruses	0
oat	apoplexy	0
purple potatoes	infant obesity	0
cranberry	weight losses	0
plant capsules	familial dementias	1
citrullus	cancer of uterus	0
carduus marianus	acquired immunodeficiency syndrome	0
topical ginger	gorlin syndrome	0
olive	peripheral artery disease	0
msg	atherosclerotic plaques	0
orange juice	cerebral stroke	0
emphasizes vegetables	amyloidosis	0
red tea	static tremors	0
seafood	rhabdomyolys	0
narrow leaved plantain	brain cysticercosis	0
purine-rich plant	crushing pain	0
ocimum sanctum	uveitide	0
club soda	action tremors	0
mock meats	myalgia	0
endive	xanthomatous meningioma	0
althaea	texidor twinge	0
deli meats	salmonellosis	0
red pepper	perforated appendicitis	0
golden delicious	vaginitis	0
emblica officinali	brain disorder	0
malus	tactile hypesthesias	0
antioxidant-rich food	cancer of ovary	0
prunus salicinas	igf-1 deficiency	0
citrus-based fruits	a-v dissociation	0
berberis	skin cancers	0
arachis	prostate cancer	0
erythroxylon	pregnancy induced diabetes	0
bean sprout	leucocythemia	0
plantago lanceolata	rectal tumors	0
cayenne	basal cell nevus syndrome	0
arecas	micturition syncope	0
low-fat diet	water borne hepatitis	0
decaffeinated tea	testicular cancer	0
poultry product	diabetic retinopathies	0
aspalathus	carcinoma of endometrium	0
kiwi fruits	drug habituation	0
pistacia vera	uterine cancers	0
mustard greens	human papillomavirus viruses	0
dried pomegranate	hyperventilation syncopes	0
snack	non b hepatitis epidemic non a	0
consumer protection scientific committee on food	utp-hexose-1-phosphate uridylyltransferase deficiency disease	0
liquor	mastalgia	0
raw garlic	newborn gynecomastia	0
retail poultry	arthropathy	0
soy proteins	rabies virus	0
dripping	papillary meningiomas	0
ceratonia	tonsil neoplasms	0
soda water	degenerative arthritides	0
beef	tubal abortions	0
rheum	amyotrophic lateral sclerosis with dementia	0
artichoke	atopic disease	0
bread mold	crushing pains	0
flavoring	head injury	0
kenaf	drug hypersensitivities	0
brewed coffee	pulmonary thromboembolisms	0
prunus armeniaca	weight reduction	0
banana plants	udp galactose 4 epimerase deficiency disease	0
brussels sprouts	semirhythmic tremors	0
linum usitatissimum	head injury	0
common bean plants	aneurysm	0
cannabis	familial atrial fibrillation	0
canned food	generalized spasms	0
dinner	prion disease	0
red cabbage	neurocysticercose	0
lycium	burkitt lymphoma virus	0
goji berry	chronic b lymphocytic leukemia	0
incorporates cloves	creutzfeldt jacob disease	0
replenish nutrients	influenza	0
corn sugar	proliferative bronchiolitis	0
hickory trees	brain disease	0
illicium verum	fusiform aneurysms	0
rose	renal neoplasm	0
dragon fruit	ankylosing spondylarthritis	0
flax seeds	irritable colon	0
solanum dulcamara	cardiac diseases	0
watermelon	tussive syncope	0
sugar-sweetened beverages	gasser syndrome	0
chinese cassias	olfactory groove meningiomas	0
saffron crocus	post-traumatic osteoporosis	0
pimpinella	tonsillar neoplasms	0
syrup	creutzfeldt-jakob disease	0
mangifera indicas	sphenoid wing meningiomas	0
barley coffee	familial dementias	0
mentha spicatas	stroke	0
powdered ginger	prion-associated disorders	0
illicium anisatums	carotid sinus syncopes	0
cruciferous vegetables	hiv	0
processed apples	eczema	0
myristica fragrans	cretinism	0
usda poultry	uterine fibromas	0
mustard oil	lymphatic sarcoma	0
red meat	kidney failure	0
lemon balm tea	male breast cancer	0
sorrel	familial diffuse gastric cancer	0
irritable bowel kiwi fruit	complications of diabetes mellitus	0
chewing gums	growth hormone insensitivity syndrome	0
earl grey tea	mild cognitive impairment	0
solanum laciniatum	fusiform aneurysm	0
cannabis sativas	infantile autism	0
suggesting fruit	lung disease	0
cucumber	autistic disorder	0
retail meat	nonalcoholic fatty liver disease	0
cabbage	diffuse mixed-cell lymphomas	0
citron trees	acquired deafness	0
powdered sugar	arterial fatty streak	0
ground beef	auricular fibrillation	0
digitalis purpurea	cancer of the liver	0
jam	abdominal pain	0
prettiest fruit	cryptogenic epilepsies	0
glucose fructose syrup	darkness tremor	0
cassia tree	undifferentiated lymphoma	0
carbonated beverage	fibrocystic breast disease	0
açaí berry	thyroid disease	0
brinjal	dental plaque	0
rooibo	intermittent tremors	0
yolk	non-epileptic convulsions	0
foodstuff	myelopathy	0
antioxidant-rich foods	myocardial infarctions	0
healthiest beverages	utp hexose 1 phosphate uridylyltransferase deficiency	0
noni fruit	insulin sensitivity	0
lavandula angustifolia	neurological condition	0
lunch time	feline leukemia virus	0
sweetleaf	cysticercosis	0
gmo soybeans	colorectal cancer	0
include fennel	nervous system degenerative diseases	0
anti-inflammatory foods	feline leukemia viruses	0
baby carrots	milk sugar intolerance	0
carbonated mineral water	amyloidose	0
sausage	cretinism	0
mangifera indica	prion protein disease	0
floret	crohns disease	0
curcuma longa	lens opacities	0
crataegus monogyna	schilling-type myeloid leukemia	0
morinda citrifolias	elevated cholesterols	0
dasheen	anhedonia	0
flammulina	cancer of the rectum	0
sesamum	pulmonary thromboembolism	0
althea officinalis	v cjd (variant creutzfeldt jakob disease)	0
chenopodium quinoas	pleomorphic lymphoma	0
pimiento	uveitide	0
fava bean	androgenic alopecias	0
fenugreek seed	disc degeneration	0
horse beans	perforated appendicitis	0
morel	gut dysfunction	0
brazil nut tree	cva (cerebrovascular accident)	0
healthiest nuts	pancreatitide	0
popcorn	intraorbital meningiomas	0
grape juice	pulmonary diseases	0
silken tofu	early-onset parkinsonism	0
amomum cardamomum	cataract	0
anise	vestibular seizures	0
soft drinks	toxic megacolon	0
trigonella	diverticulum	0
elettaria cardamomums	testicular cancers	0
dietary sugars	liver neoplasm	0
virgin olive	generalized seizures	0
cardamon	unilateral headache	0
quinoa	transmissible dementias	0
syzygium	sleep initiation dysfunctions	0
vitamin	galt deficiencies	0
healthier foods	senile tremors	0
mangiferas	cancer of the tongue	0
treat	micturition syncope	0
goji berry plants	testicular cancers	0
cauliflower	migraine headaches	0
pistil	diffuse lymphoma	0
lycium barbarum	hypertension	0
romaine	paroxysmal atrial fibrillations	0
dietary fiber	severe congenital microcephalies	0
fructose corn	temporal region trauma	0
stevia	substance induced organic mental disorders	0
cycad	male impotence	0
raw foods	back pain without radiation	0
ground meat	small and large cleaved-cell lymphoma	0
turnip	microcephaly	0
cod	parasagittal meningiomas	0
eugenia jambolana	paroxysmal atrial fibrillations	0
green onions	brain benign neoplasm	0
new vitamin	developed cancer	0
melissa officinalis	mixed cell lymphoma	0
fenugreek	uterine leiomyoma	0
pickled foods	multiple myositis	0
areca catechus	temporal region traumas	0
sweetener	chronic illnesses	0
sea vegetable	anhedonia	0
official vitamin	prion-induced disorder	0
fermented cabbage	biliary calculi	0
ready-prepared food	pulmonary diseases	0
kaffir lime	fibromyalgia	0
potassium-rich foods	fibroid uterus	0
flaked coconut	salami brusher's disease	0
papaver	mixed lymphocytic histiocytic lymphoma	0
golden glow	human influenzas	0
drink milk	huntington’s disease	0
phaseolus	aura	0
placenta	irritable colon	0
triticum aestivum	intertrochanteric fractures	0
brussel sprout	chronic infectious mononucleosis-like syndrome	0
herbal tea	human t-lymphotropic virus type iii	0
berry	endotoxemia	0
ephedras	postoperative nausea and vomiting	0
banana plant	guillain-barré syndrome	0
sour fruit	skin cancer	0
legume pods	multiple meningioma	0
breakfast time	acute monocytic leukemia	0
whole foods	cervical cancer	0
agent orange	spontaneous abortion	0
da huang	hormonal dysfunction	0
dress	malignant melanoma	0
burrito	multiple meningiomas	0
kawa	cephalgia syndrome	0
triticum vulgare	mild neurocognitive disorder	0
fresh ginger	diabetic amyotrophies	0
sweetening agent	angioblastic meningiomas	0
seville orange trees	coarse tremor	0
food coloring	fine tremors	0
corn syrup	adenoviridae	0
anise tea	diabetic mononeuropathies	0
ketchup	amyloid deposit	0
cicer arietinum	germinoblastic sarcoma	0
prosopi	small cleaved-cell lymphoma	0
persimmon	neurodegenerative disorder	0
pureed apples	hansens disease	0
specific cheeses	lung diseases	0
dried fruit	mouth neoplasms	0
goji berries	perforated appendicitis	0
reindeer meat	amyloidose	0
legume family	rachitide	0
mustard seeds	ciguatera	0
ribes nigrum	pulmonary disease	0
pineapple	trochanteric fractures	0
prunus amygdalus	liver dysfunctions	0
carica	lymphoplasmacytoid lymphoma	0
wine	olfactory seizure	0
international nut	gestational diabetes mellitus	0
dairy products	huntingtons disease	0
added sweeteners	cancer of the brain	0
coleslaw	endocrine breast disease	0
acai berries	bovine lymphomas	0
dietary supplementations	experimental parkinson disease	0
organic food	celiac disease	0
sprout	tonic seizures	0
potable water	odontogenic keratocysts multiple basal cell nevi	0
dog rose berries	reticulum-cell sarcoma	0
mashed potatoes	long sleeper syndromes	0
strawberry	retained surgical tools	0
soybean proteins	chronic fatigue and immune dysfunction syndrome	0
tap water	halitosis	0
lettuce	hysterical amnesia	0
turmeric root	sharp headaches	0
chai tea	polyradiculoneuritide	0
domestic fowls	cervix cancer	0
cucurbita	corpse	0
domestic fowl	broken bones	0
eupatorium rebaudianum	human herpesvirus 4	0
barley	muscle pains	0
vaccinium macrocarpons	mucous colitides	0
wild radish	motion sickness	0
fresh basil	dyspepsia	0
lycium chinense	spontaneous abortion	0
weekly meat	muscle soreness	0
mealtime	jakob-creutzfeldt disease	0
piper nigrum	stomach ulcers	0
maize oils	colonic neoplasm	0
amlas	rete testis tumors	0
hickory tree	severe congenital microcephalies	0
deep-fry foods	oral neoplasm	0
pease	cephalgia syndromes	0
broth	cluster headache syndrome	0
kidney beans	backache	0
sour cream	cervix neoplasm	0
green lentils	deficiency diseases	0
raw meat	physical sufferings	0
chinese cinnamon	passive tremor	0
broccoli	diffuse well differentiated lymphocytic lymphoma	0
laciniate nightshades	spondyloarthritis ankylopoietica	0
cortland	hypoesthesia	0
including cloves	tumorigenese	0
dairy eggs	kidney stone	0
toxic plant	megacolon	0
star anise	periorbital headaches	0
sweet pepper	galactose 1 phosphate uridyltransferase deficiency	0
fruit juice	psammomatous meningiomas	0
potato chips	high cholesterol level	0
specific nuts	hemicrania migraine	0
sugar substitutes	near-death experience	0
juiced broccoli	horton syndrome	0
exotic fruit	mild cognitive impairments	0
carya illinoenses	deficiency disease	0
cooking oil	esophagus neoplasm	0
dietary supplement	cerebrovascular apoplexy	0
organic meat	jakob creutzfeldt syndrome	0
java plum trees	constipation	0
kawa kawas	reticulum-cell sarcomas	0
white tea	preinvasive carcinoma	0
eragrostis	neonatal tremor	0
coconut water	prostatic intraepithelial neoplasias	0
applesauce	cerebrovascular accidents	0
lycopersicon esculentum	lactose intolerance	0
cured meat	venous thromboses	0
oryza sativa	gale deficiencies	0
mangifera	polyarthritide	0
fennel	hair losses	0
hibiscus sabdariffa	intraepithelial neoplasm	0
nuclear power plants	retained surgical tools	0
citrus grandis	migraine variant	0
vicia fabas	effort syncope	0
soy food	retained surgical item	0
marsh mallow	gut dysfunction	0
secale cereale	psoriase	0
use sweeteners	penis cancer	0
paella	muscle disease	0
grape	hair loss	0
soy cheese	disorders of initiating and maintaining sleep	0
allspice	reticulosarcoma	0
goiaba	postoperative nausea	0
purslane	esophageal neoplasms	0
beetroot	kidney neoplasm	0
pistachio	norwalk-like viruses	0
ale	hysterical amnesias	0
olive tree	splitting pain	0
liquorice	fibrocystic mastopathy	0
adhatoda	anoxia	0
muffin	disk degradation	0
meal	hemangioblastic meningiomas	0
leguminosae	back pain	0
vaccinium virgatum	peanut allergies	0
spinacia oleracea	physical anhedonias	0
soybean	abdominal cramp	0
celeriac	aura	0
dried yeast	cancer of the prostate	0
ginger ale	disk degeneration	0
ananas	cancer of tonsil	0
secale	polymyositide	0
fruit and vegetable juices	epstein barr virus	0
solanum melongena	sliding esophageal hernia	0
lemon	periodontal disease	0
assai palm berries	substance use disorder	0
ginger	colitis gravis	0
drinking water	hair loss	0
morinda citrifolia	utp hexose 1 phosphate uridylyltransferase deficiency disease	0
carica papayas	motor seizure	0
emblica officinalis	sleep disorders	0
cinnamomum trees	idiopathic intracranial hypertension	0
brain-invasive pork	rheumatoid arthritis	0
garlic sauce	mucous colitis	0
black sapote	autosomal dominant. juvenile parkinson disease	0
sweet foods	fibroatheromatous plaques	0
celebration meal	heart attack	0
safflower	prostatitis	0
zea mays	salmonella infection	0
avenas	retained surgical needle	0
cantaloupe	hepatic failure	0
maple	plasmodium infection	0
dietary plant protein	paroxysmal atrial fibrillation	0
frozen broccoli	endocrine breast diseases	0
digitalis lanata	heatstroke	0
cannabis indicas	high-grade lymphoma	0
infects apples	memory deficits	0
baptisia	charcot disease	0
squash plant	thrombus	0
curcuma zedoaria	bovine leukemia virus	0
indian laburnum	gastric neoplasms	0
alfalfa sprouts	prostate neoplasm	0
ground flax	drug use disorder	0
hemlock	somatotropin hypersecretion syndromes (acromegaly)	0
grapefruit	ovarian neoplasms	0
so-called meat	epstein barr virus	0
store licorice	penile neoplasm	0
goji berry plant	delusional parasitosis	0
pancake	diffuse undifferentiated lymphomas	0
zea	multiple meningioma	0
baker's yeast	diabetes-related complications	0
silybum marianum	generalized seizures	0
squashe	liver failure	0
caryophyllus	upper respiratory infection	0
unhealthy food	tying disease	0
steamer	laron dwarfism	0
anana	benign meningioma	0
veal	polymyositis ossificans	0
shellfish	pyrexia	0
black currants	varix	0
pear	foodborne illnesses	0
cocoa butter	disorder	0
plaice	broken bones	0
wort	retro-ocular headaches	0
ovary	epileptic seizure	0
porgy	pseudocoma	0
breast milk	brains cancer	0
soy foods	mastalgia	0
fava beans	auto-immune diseases	0
pimenta diocias	juvenile-onset diabetes	0
pinto beans	idiopathic parkinson's disease	0
origanum onites	protein deficiency	0
areca	tumor of rete testis	0
lactuca sativa	preinvasive carcinoma	0
star anises	uterine cervical cancer	0
pecan tree	manic depressive psychosis	0
green tea	common bile duct gallstones	0
flammulina velutipes	polyarthritide	0
vaccinium myrtillus	pancreas cancers	0
phaseolus acutifolius	rectal neoplasms	0
fried foods	oral neoplasms	0
diospyro	progressive disorder	0
vitamin pills	kidney cancers	0
fake meat	diabetic amyotrophies	0
eggnog	fibrose	0
pimenta officinali	proliferative bronchiolitis	0
extracted fruit	jakob-creutzfeldt syndrome	0
coffee	muscle tenderness	0
alcoholic beverage	benign intracranial hypertension	0
organic foods	cattle leukemia virus	0
prosopis	experimental parkinson disease	0
plant zygotes	melanoma	0
eating fruits	postoperative nausea and vomiting	0
rheum rhaponticum	lichen rubra planus	0
melissa	glaucoma	0
woodland strawberries	polyradiculoneuropathy	0
healthiest snack	water-borne hepatitis	0
juglan	human mammary neoplasm	0
shiitake mushrooms	human papillomavirus viruses	0
thymus	malignant epithelial neoplasm	0
probiotic	oncogenic virus	0
no-calorie sweeteners	fifth phacomatoses	0
consumed chocolate	diffuse mixed small and large cell lymphoma	0
butter	cancer of the testes	0
cayenne peppers	bacterial vaginitis	0
bolete	hepatitis e	0
brew	nontropical sprue	0
dietary fats	neonatal tremors	0
coconut milk	pneumonitis	0
mastictree	degenerative neurologic diseases	0
cucumis sativus	fibroid uterus	0
calendula officinali	common cancers	0
cruciferous vegetable	micturition syncope	0
vaccinium bracteatum	atypical diffuse small lymphoid lymphoma	0
vegetable oil	lymphocytic lymphomas	0
althaea officinalis	galactosemia 3	0
big food	gluten-sensitive enteropathies	0
mastic trees	heartburn	0
rubus	hemicrania migraines	0
holy basil	pulmonary embolisms	0
chocolate bars	upper respiratory infection	0
fat milk	burkitt lymphoma virus	0
ready-prepared foods	male sterility	0
zingiber officinales	diabetic mononeuropathy simplex	0
beet	carcinoma of endometrium	0
natural vitamin	drunkenness	0
green peas	low backaches	0
infant formula	tumor of rete testis	0
baking chocolate	hiv	0
rooibos	hansen disease	0
tuna	creutzfeldt jacob disease	0
arachis hypogaea	enterocele	0
decaf	skin neoplasms	0
tea	stomach neoplasm	0
larder	nonspecific vaginitis	0
food manufacturers	gall stone	0
capsicum annuum	intracranial cns disorder	0
gluten-free diet	seizure disorders	0
soy beans	age-related maculopathies	0
citrus limon	gastro-esophageal reflux	0
almond butter	parkinson’s disease	0
plant embryos	cirrhosis	0
sweet almonds	oral disease	0
apple	male sterility	0
cereal grain	retained surgical instrument	0
dairy product	viral infections	0
trace elements	renal cancers	0
glycyrrhiza glabra	schizophrenia	0
restrict food	aura	0
orange	motion sickness	0
euterpe oleracea	bronchiolitis	0
agaricaceae	breast dysplasia	0
sushi	iron deficiency	0
linum usitatissimums	complete blindness	0
crab apples	seizure disorders	0
hamburger	motor seizures	0
grapefruit juice	thyroid neoplasms	0
haritaki fruit	colitis gravis	0
sugar maple	bipolar affective psychoses	0
blackberry	different cancer	0
wheat bran	spinal cord degenerative diseases	0
pomegranate fruit	pseudoaphakia	0
yerba mates	sphenoid wing meningioma	0
diospyros digynas	extreme hearing loss	0
cuminum cyminums	sphenoid wing meningioma	0
apple tree	circulatory failure	0
serve	plasma cell myelomas	0
radicchio	prion diseases	0
chicken salad	mixed small and large cell lymphoma	0
kola nuts	thyroid neoplasm	0
citrus	menstrual disorders	0
no noni	plegia	0
soda waters	lou gehrig disease	0
sugar maples	b12 deficiency	0
acer saccharum	myocardial infarctions	0
uncooked food	effort syncopes	0
plum tree	testis neoplasms	0
rice milk	nbcc	0
english plantains	bilateral headaches	0
pineapple juice	static tremor	0
honey	ms (multiple sclerosis)	0
concord grapes	scurvy	0
dried foods	poisoning	0
black teas	udp-galactose-4-epimerase deficiency	0
target vitamin	nonspecific vaginitis	0
beverage	fibrosis	0
whiting	male breast neoplasms	0
flax	back pains	0
hemp	insomnia disorders	0
psidium	breast neoplasm	0
cooked meat	remittent fever	0
phyllanthus emblicas	creutzfeldt jakob disease	0
wheatgrass	aortic aneurysm	0
olive trees	cretinism	0
white rice	back pain without radiation	0
chile peppers	bse (bovine spongiform encephalopathy)	0
osmanthus tea	amnesia-memory loss	0
zucchini	amyloidosis	0
macadamia	bovine lymphomas	0
snack food	udp-galactose-4-epimerase deficiencies	0
true nut	subacute spongiform encephalopathy	0
shorten	lightheadedness	0
bt corn	chronic cystic mastitis	0
monosodium glutamate	renal insufficiency	0
natto	syncopal episode	0
oreo	salami brusher's disease	0
berberi	diverticulum	0
chanterelle	penile neoplasm	0
licorice	fine tremor	0
high-phytate foods	headache syndrome	0
contaminated foods	effort syncopes	0
fortify milk	liver diseases	0
broad beans	vaginal neoplasm	0
rubus fruticosus	acromegaly	0
maguey	ischemia	0
chervil	low grade lymphoma	0
black rice	ankylosing spondylarthritis	0
common fruits	leiomyoma	0
citrus sinensis	endometriosis	0
coca cola	cardiovascular diseases	0
coriandrum sativums	reproductive sterility	0
diabetic diets	male subfertility	0
monkfish	gehrig's disease	0
guacamole	hepatic failure	0
celery root	diabetic mononeuropathies	0
texturized vegetable protein	somatotropin hypersecretion syndrome (acromegaly)	0
brewage	bladder diseases	0
taraxacum	clonic seizures	0
fermented foods	human mammary neoplasm	0
psyllium	anaplastic carcinomas	0
justicia adhatoda	intraorbital meningioma	0
cooked carrots	small cleaved cell lymphoma	0
proteus mirabilis	acne	0
white mallow	spondylitis ankylopoietica	0
copaifera	vulvar cancer	0
mentha	lymphadenopathy associated virus	0
split peas	lung neoplasms	0
rhubarb	substance dependence	0
seed	cerebrovascular apoplexy	0
triticum turgidum subsp. durum	gasser syndrome	0
kale	low backaches	0
eating almonds	cancer of testis	0
red delicious	mptp-induced experimental parkinsonism	0
food colors	esophagitide	0
red yeast rice	acidose	0
animal-based foods	paraesophageal hernias	0
carrot	gestational diabetes mellitus	0
avocado fruit	prostatic neoplasm	0
syzygium jambos	human influenzas	0
deli meat	gastro oesophageal reflux	0
candy bar	aneurysm	0
low fruit	diffuse myofascial pain syndrome	0
vegetable proteins	lichen planus	0
caramel	vertiginous seizure	0
musa	vagina cancers	0
high fructose maize syrup	semantic memory disorders	0
individual food	inflammatory bowel disease 1	0
low-calorie diet	hair loss	0
cow's milk	barrett's syndrome	0
daucus carota	crushing skull injuries	0
eating meat	bladder neoplasm	0
beer	nbcc	0
digitalis	diverticulitide	0
bread	galk deficiency	0
syzygium aromaticum	arrhythmia	0
atropa belladonna	htlv-iii	0
yeast rice	mammary dysplasia	0
vegetarianism	flatus	0
coriandrum	toxico infectious botulism	0
vaccinium corymbosum	cerebrovascular apoplexy	0
prebiotic	intestinal diseases	0
açai berries	acute infectious polyneuritis	0
malabar-nut	adenoviridae	0
sparkling waters	gall bladder disease	0
ultra-processed food	vulvar cancers	0
kombucha teas	hysterical amnesias	0
vaccinium ashei	renal neoplasms	0
frozen cranberries	oncovirinae	0
vegetable protein	emesis	0
chinese yam	palsy	0
molasse	substance use disorders	0
soy bean proteins	atheromatous plaques	0
good soybeans	resting tremor	0
black sapotes	contagious pustular dermatitides	0
sweetening agents	prevent and reverse heart disease	0
tisane	bone neoplasm	0
eating broccoli	sore throats	0
apple juice	meningotheliomatous meningiomas	0
oats	chronic insomnia	0
foeniculum vulgare	male breast neoplasms	0
garcinia mangostana	acne	0
leafy vegetables	human mammary carcinoma	0
vitis vinifera	intertrochanteric fractures	0
poisonous plants	cancer of the ovary	0
guava	primary brain neoplasm	0
fruit-shaped marshmallows	guillaine-barre syndrome	0
cassia fistula	neurologic degenerative conditions	0
dietary fat	wheat allergies	0
spearmint	hereditary galactokinase deficiency	0
common olive trees	uterine fibroma	0
olive family	zoonosis	0
fryer	spontaneous abortions	0
acaí berries	head trauma	0
so-called vegetable	gluten-sensitive enteropathy	0
unrefined plant	tremor	0
bitter nightshade	infectious diseases	0
radish	epithelioma	0
milk chocolate	polyradiculoneuropathy	0
pie	lung inflammations	0
alcohol	osteoarthritide	0
hickory nuts	olfaction disorders	0
garcinia mangostanas	metabolic acidoses	0
shan yao	vestibular seizure	0
nitrate-rich vegetables	contagious pustular dermatitis	0
citrus reticulatas	a v dissociation	0
pimenta officinalis	a-v dissociations	0
syzygium malaccense	endometriose	0
triticum turgidum	cardiovascular diseases	0
green peppers	limb cramp	0
marihuana	autoimmune diabetes	0
chia seeds	spondyloarthritis ankylopoietica	0
not-necessarily-so-healthy foods	blv	0
cookie	intestinal disease	0
soft drink	human t lymphotropic virus type iii	0
cymbopogon nardus	experimental lung inflammations	0
lentinus edodes	central obesity	0
feather meal	anal ulcer	0
oryza	reticulosarcoma	0
flavorer	spinal cord diseases	0
family vegetables	early infantile autism	0
mandarin orange trees	halitose	0
hickory nut	thrombus	0
cashew	pill rolling tremors	0
cranberry juice	substance dependence	0
offal	female sub fertility	0
curry	chronic lymphocytic leukemias	0
cucumis melo	rectal cancers	0
blueberry plant	lewy body parkinson disease	0
abelmoschus	varix	0
sardine	heart attacks	0
thymus vulgaris	cardiac failure	0
mint tea	endemic cretinism	0
catfish	bacteriophage	0
gooseberry	toxico-infectious botulism	0
nettle	peripheral arterial diseases	0
drinking tea	primary malignant brain neoplasms	0
golden delicious apples	cacosmia	0
cilantro	olfactory groove meningiomas	0
curry powder	familial tremors	0
barberry	drug allergy	0
machaerium	gastro-oesophageal reflux	0
hypericum perforatum	intracranial neoplasms	0
assai palm berry	schizophrenic disorders	0
eating eggs	insomnia disorder	0
bitter nightshades	epilepsy	0
cuminum	social anhedonia	0
wild bananas	galactosemia 2	0
soymilk	male breast carcinoma	0
chewing gum	autosomal dominant juvenile parkinsonism	0
morning meals	peripheral autoimmune demyelinating disease	0
herbal teas	histamine cephalgia	0
mangosteen	mouth cancer	0
chicken	gustatory seizures	0
allium porrum	thrombus	0
frozen fruit	strain	0
carbonated water	emesis	0
maize	texidor's twinge	0
dried plums	small noncleaved-cell lymphoma	0
rose berries	pulmonary cancers	0
include flaxseed	breast adenosis	0
granny smith	urinary tract infections	0
betel nuts	develop cancer	0
cola nitida	social anxiety disorders	0
raw food	bilateral headache	0
petroselinum	chronic airflow obstruction	0
healthy fruit	back pains	0
cinnamomum zeylanicum	male sexual impotence	0
justicia	spindle-cell carcinomas	0
citrus reticulata	sleep initiation and maintenance disorders	0
bertholletia	scorbutus	0
drink tea	acquired immune deficiency syndrome	0
shiitake mushroom	varix	0
breakfast	breast tumors	1
herb	microcephaly	0
parsley	dna injury	0
fruit juices	bacterial vaginoses	0
asparagus	acute inflammatory demyelinating polyradiculoneuropathy	0
breakfast times	itch	0
kola nut	dyschezia	0
gui zhi	fibrocystic changes of breast	0
real chocolate	global amnesia	0
healthiest apple	guillain-barre syndrome	0
spice saffron	prostatic cancers	0
english walnut	intraventricular meningiomas	0
cymbopogon	cardiovascular conditions	0
areca nuts	paroxysmal atrial fibrillations	0
group foods	male infertility	0
andean blackberry	v cjd (variant creutzfeldt jakob disease)	0
andean blackberries	guam form of amyotrophic lateral sclerosis	0
raw cranberries	periadenitis mucosa necrotica recurrens	0
nuclear power plant	cancer of vulva	0
confection	benign meningiomas	0
white pepper	benign neoplasm	0
chocolate pudding	chronic lymphoblastic leukemias	0
pithecolobium	bone fracture	0
almond tree	neoplasia	0
fagopyrum esculentum	psychophysiological insomnia	0
sour orange tree	bovine lymphoma	0
soda pop	low grade lymphoma	0
olea	familial atrial fibrillations	0
crataegus	nerve tremor	0
high-fiber food	olfactory groove meningioma	0
monitoring food	artery disease	0
vital nutrients	cervical migraine syndrome	0
incorporate cloves	syncope	0
trigonella foenum-graecums	myalgia	0
peanut	elevated cholesterol	0
milk	limb cramp	0
avena	somatotropin hypersecretion syndromes (acromegaly)	0
chamomile	hysterical amnesias	0
wisconsin milk	osteoporose	0
cassia cinnamon	myelomatose	0
processed meats	familial dementias	0
overpriced vitamin	avitaminose	0
pumpkin	small noncleaved-cell lymphomas	0
medicago sativa	headache	0
rosemary	orthostasis	0
onion	senile osteoporoses	0
black beans	thrombus	0
cider vinegar	gnathostomiase	0
amaranth	atrophy	0
anticancer plant	migraine variants	0
vegetable juices	premenstrual syndrome	0
basil	muscular cramp	0
solanum dulcamaras	thyroid neoplasm	0
cinnamon	condylomata acuminata	0
cicer	environmental cancer	0
sea bilberries	inflammatory bowel disease	0
kohlrabi	headache	0
corylus	cramp	0
corn oil	birth defect	0
sea vegetables	fibromyositis-fibromyalgia syndrome	0
triticum	hemicrania	0
hypericum perforatums	varix	0
antioxidant vitamin	histamine cephalgias	0
leaf lettuce	auto-immune disease	0
fatty meal	gastric neoplasm	0
colocasia	anhedonia	0
andira	type c oncoviruses	0
kawa kawa	stomach ulcers	0
carya	barrett epithelium	0
happy meal	cancer of the rectum	0
bad foods	udp galactose 4 epimerase deficiency disease	0
bamboo shoots	head injury	0
majorana hortensis	amyloid deposits	0
syzygium sandwicense	hereditary essential tremor	0
amla	androgenetic alopecia	0
pummelo tree	serious disease	0
yogurt	rabies viruses	0
regular carrots	cardiac diseases	0
açai berry	ileocolitis	0
tangerine tree	postural low back pain	0
soup	mammary cancers	0
apricot trees	microglandular adenosis	0
pasta	psychosis	0
dietary supplements	diabetes complications	0
lemon tree	dyschezia	0
animal-based vitamin	autosomal recessive juvenile parkinson disease	0
sweet peppers	intracranial cns disorder	0
durum wheat	pseudopelade	0
apricot	atypical chronic myeloid leukemia	0
alcoholic beverages	saturnine tremor	0
taro	pituitary dwarfism ii	0
sell meat	breast tumor	0
citrus fruits	sore throat	0
andropogon nardus	cranial pains	0
cayenne pepper	galactosemia iii	0
national meat	gastro oesophageal reflux	0
grouper	secretory meningioma	0
processed food	pulmonary thromboembolisms	0
sunflower seeds	complications of diabetes mellitus	0
rowanberry	mouth cancers	0
peach trees	infection	0
vaccinium angustifolium	congenital defects	0
avocado	new variant creutzfeldt jakob disease	0
origanum	prostatic neoplasms	0
nonfat meal	cognitive declines	0
gravy	degenerative intervertebral disks	0
juglans regia	renal insufficiency	0
exotic fruits	epstein-barr virus	0
maraschino cherry	artery disease	0
english walnuts	ocular headaches	0
humulus lupulus	breast cancers	0
phyllanthus emblica	breast malignant neoplasms	0
soda pops	semirhythmic tremors	0
pleurotus ostreatus	posterior fossa meningiomas	0
caffeinated coffee	ciguatera fish poisoning	0
convenience food	resting tremors	0
teosinte	fissure in ano	0
food allergies	acute infectious polyneuritis	0
chinese food	gasser's syndrome	0
wild celery	ph1 negative myelogenous leukemia	0
infant formulas	varicose veins	0
nut bar	head trauma	0
chinook salmon	hemicrania migraines	0
coco	mucous colitides	0
soy milk	cancer of tongue	0
roughage	spiral fracture	0
sunfish	lightheadedness	0
euterpe edulis	hansens disease	0
spaghetti	texidor's twinge	0
horse bean	diabetic asymmetric polyneuropathy	0
acer negundo	infectious mononucleosis viruses	0
sea-food	gastro esophageal reflux	0
vaccinium uliginosum	muscle disease	0
sweeten	ulcerative colitis	0
mayo	basal cell carcinoma	0
oyster mushroom	a-v dissociations	0
porphyra	contagious ecthyma	0
kangaroo meat	colon cancer	0
black tea	pulmonary inflammation	0
dark chocolate	cancer of brain	0
ephedra	neonatal tremors	0
arginine-rich foods	basal cell carcinoma	0
breast milks	vulva cancer	0
euchresta	amyloid plaques	0
eating food	hypercholesterolemia	0
pomelo tree	gale deficiency	0
ficus	varicose vein	0
rubberplant	generalized spasm	0
pecan trees	inherited human transmissible spongiform encephalopathies	0
sparkling water	disc degradations	0
drink	subacute spongiform encephalopathies	0
mustard	syndrome	0
citrus aurantiifolias	bladder cancer	0
high-fructose maize syrup	bovine lymphomas	0
dried cranberries	malignant tumor of urinary bladder	0
olea europaea	ankylosing spondyloarthritis	0
roasted almonds	classic galactosemias	0
sweet almond	transmissible spongiform encephalopathies	0
hummus	food-borne illnesses	0
national pork	common bile duct biliary calculi	0
frying foods	deficiency diseases	0
assai palms	bronchiolitide	0
whortleberry	hyperventilation syncope	0
measuring food	lung inflammations	0
saccharomyces cerevisiae	blood cancers	0
peach tree	intermediate grade lymphoma	0
worldwide fruit	hansen's disease	0
citrus bergamias	prostatic neoplasms	0
common olive tree	mouth cancers	0
refined olive	sexual dysfunction	0
common foxgloves	cancer of the pancreas	0
yellow vegetables	crushing skull injuries	0
granny smith apples	bilateral headache	0
indian laburnums	hhv-4	0
sweet basils	heart disease	0
foeniculum vulgares	rete testis tumor	0
mackerel	coronary diseases	0
almond milk	tying disease	0
pea families	degenerative intervertebral disk	0
breakfast cereals	stomatognathic disease	0
scrambled eggs	headache syndrome	0
vinegar	heart decompensation	0
prunus domestica	irritable bowel syndromes	0
frequent meals	lymphosarcoma	0
java plum tree	gluten-sensitive enteropathy	0
pimpinella anisums	manic disorder	0
french bean plants	tumor of rete testis	0
rise	rodent ulcers	0
flowering shrub	alactasia	0
chili pepper	apnea	0
jelly	psoriasis	0
brassica juncea	macular degeneration	0
paprika	overeat	0
little meat	rheumatoid spondylitis	0
flounder	virus infection	0
lavandula	drug addiction	0
shoot	periorbital headache	0
pickled vegetables	benign brain neoplasms	0
plantain	recrudescence	0
common bean plant	cancer of rectum	0
bellis	encephalon disease	0
anchovy	tactile amnesia	0
candy bars	penile cancers	0
citrus hystrices	bone fractures	0
salami	cephalgia syndromes	0
citrus medicas	mammalgia	0
actual licorice	frontal region trauma	0
golden raisins	reticulum cell sarcoma	0
cicer arietinums	memory disorder	0
mentha spicata	severe congenital microcephalies	0
jalapeno	bone neoplasms	0
acer negundos	retrovirus	0
neu5gc-rich food	cancer of uterus	0
handling meat	vulvar cancer	0
grecian foxgloves	barrett epithelium	0
dandelion	juvenile parkinson disease	0
tea plant	pregnancy-induced diabetes	0
rice	malignant epithelial tumor	0
lens culinaris	substance use disorder	0
healthy foods	creutzfeldt-jakob disease	0
aloe	jakob-creutzfeldt disease	0
junk food	episodic cluster headaches	0
chamomile tea	pyrexia	0
ground ginger	vaginal cancers	0
tepary bean	atopic diseases	0
yoghurt	infantile botulism	0
durum wheats	carcinoma of endometrium	0
bacon	apoplexy	0
pea family	anxiety disorder	0
sun-dried raisin	disorders of initiating and maintaining sleep	0
taraxacum officinale	intracranial cns disorder	0
peppermint	cadaver	0
margarine	carsickness	0
kava kava	benign prostatic hypertrophy	0
baby formulas	insulin deficiency	0
toxic plants	colon neoplasm	0
crabapple	gestational diabetes mellitus	0
canned fruit	tonsillar cancers	0
fig	intention tremors	0
lima beans	acute monocytic leukemias	0
walnut oil	necrotizing fascitides	0
drinking milk	membranous cataracts	0
carbonated mineral waters	chronic fatigue syndrome	0
preserved food	mild cognitive impairment	0
artificial sweetener	reduced sensations	0
lavender	liver steatosis	0
conventional food	intracranial meningiomas	0
chinese rhubarb	scurvy	0
unfertilized eggs	low back aches	0
century plant	membranous cataracts	0
entree	testicular tumors	0
nori	food borne diseases	0
ganja	microcephaly	0
plantago seed	bovine lymphomas	0
noncaloric sweetener	chronic obstructive airway disease	0
cream cheese	fibrocystic disease of breast	0
poenumgraecum	penile neoplasm	0
safflower oil	acute strokes	0
egg	clear cell meningioma	0
cooked broccoli	diabetic mononeuropathy	0
healthiest beverage	mad cow disease	0
atropa belladonnas	common cancer	0
black currant	human t-cell lymphotropic virus type iii	0
olive oil	sleep-related neurogenic tachypnea	0
brazil nuts	human immunodeficiency virus	0
grecian foxglove	retained surgical sponge	0
oregano	periorbital headaches	0
thymus plant	gastric ulcers	0
dark meat	parkinsonism-dementia complex of guam amyotrophic lateral sclerosis	0
dessert	landry-guillain-barre syndrome	0
licorice root	bladder neoplasms	0
wild yam	diverticulum	0
junk foods	post-ictal confusion	0
bertholletia excelsas	testis cancer	0
fatty foods	cerebrovascular apoplexy	0
candy	postural syncopes	0
tea leaves	diffuse small cleaved-cell lymphoma	0
citrus maxima	blood clots	0
cassia	fever	0
brewing tea	ekbom delusional parasitoses	0
callerya	encephalon diseases	0
afzelia	diabetic complications	0
saint johnswort	chronic fatigue and immune dysfunction syndrome	0
dried fruits	drop attacks	0
cherry	macular dystrophy	0
illicium verums	gorlin goltz syndrome	0
citrus hystrix	stroke	0
green grapes	non-hodgkins lymphoma	0
hibiscus cannabinus	early awakening	0
food supplement	nervous system degenerative diseases	0
vegetable juice	wound botulism	0
pumpkin seeds	birth weight	0
hypericum	acute confusional migraines	0
peach	female pattern baldness	0
reason food	parkinson disease	0
trace minerals	hiatus hernias	0
poultry	endometrial carcinomas	0
hot pepper	diffuse mixed cell lymphoma	0
cassia trees	pill rolling tremor	0
illicium	vagina neoplasms	0
collard	diffuse mixed small and large cell lymphoma	0
cannabis sativa	spindle cell sarcoma	0
chicken meat	bipolar disorder	0
cocoa powders	autistic disorder	0
lucerne	postoperative vomiting	0
horsemeat	age-related macular degenerations	0
cocktail	mixed lymphocytic-histiocytic lymphomas	0
allium sativum	epileptic seizure	0
cruciferous foods	peripheral artery disease	0
green beans	testis cancers	0
dioscorea batatas	fusiform aneurysms	0
pine nuts	familial parkinson disease	0
collard greens	retrovirus	0
laudable legume	pulmonary inflammation	0
gum acacia	canker sore	0
pisum sativum	galactosemia 2s	0
citrus medica	memory losses	0
origanum vulgare	deep-vein thromboses	0
thousand foods	creutzfeldt jacob disease	0
macadamia nuts	semirhythmic tremor	0
white bread	metabolic acidoses	0
eugenia aromatica	oral cancer	0
açaí berries	ileocolitis	0
soy cheeses	diffuse undifferentiated lymphoma	0
chestnut	galactose epimerase deficiencies	0
belladonna	endometrial carcinomas	0
oregano plants	genital wart	0
papaver somniferum	hypoxemia	0
bran flakes	coma	0
skim milk	hypoxemia	0
fennel seeds	rabies virus	0
venison	familial dementias	0
cocos nuciferas	autosomal dominant. juvenile parkinson disease	0
zedoary zedoaria	sciatic neuralgia	0
processed foods	varicose vein	0
oyster mushrooms	drug abuse	0
pimenta diocia	ruptured appendicitis	0
supper	cardiovascular strokes	0
plantago	terminal ileitis	0
fries	rest tremors	0
persea americana	primary brain tumors	0
alpine strawberry	urinary bladder cancer	0
euterpe	olfactory groove meningiomas	0
no coffee	common bile duct biliary calculi	0
rubus glaucus	temporal region trauma	0
flower	halitose	0
marjoram	food-borne illnesses	0
dioscorea polystachya	chronic daily headaches	0
tofu	memory disorder	0
caper	syncope	0
cola acuminata	uterus neoplasms	0
phaseolus vulgari	malignant brain neoplasm	0
plantago indica	parkinsonism-dementia complex of guam amyotrophic lateral sclerosis	0
iceberg lettuce	gallstone	0
red meats	rabies viruses	0
handling food	skin cancers	0
carbonated beverages	guam form amyotrophic lateral sclerosis	0
betel nut	familial dementias	0
ilex paraguariensis	environmental cancer	0
horsenettle	chronic illness	0
horse nettles	joint diseases	0
milkshake	spinal cord disorders	0
root	nutritional disease	0
rosa	head pains	0
jasmine tea	kidney calculus	0
tomato juice	prostate cancers	0
density foods	pulmonary embolism	0
lemon verbena	ketosis prone diabetes mellitus	0
phytonutrient-rich food	cervix cancer	0
milk thistle	peanut allergy	0
swordfish	numbness	0
concord grape	male breast enlargement	0
soy	brain vascular accident	0
antioxidant fruits	continuous tremor	0
norus	retained surgical sponges	0
piper methysticum	coronary diseases	0
tea hibiscus	chronic pain	0
pithecellobium	complete blindness	0
carthamus tinctorius	tonic seizures	0
smoked food	macular degenerations	0
cinnamomum aromaticum	familial atrial fibrillation	0
favorite meals	familial creutzfeldt-jakob disease	0
whipped cream	fever	0
clathrotropis	monocular blindness	0
sugar	painful menstruations	0
tv dinners	brain malignant neoplasms	0
spore	age related memory disorders	0
eggplant	pseudopelade	0
raphanus sativus	comatose	0
nettle tea	acquired immuno-deficiency syndromes	0
dietary soybean proteins	pyrexia	0
black walnuts	social phobias	0
jell-o	deficiency disease	0
herr	reticulum-cell sarcoma	0
actual fruit	viral disease	0
energy drinks	paraesophageal hiatal hernia	0
cannabis indica	disorientation	0
ocimum basilicum	primary fibromyalgias	0
malus domestica	fatty liver disease	0
solanum melongenas	excess cancer	0
fagopyrum	gnathostomiase	0
croaker	androgenetic alopecia	0
energy drink	dermatozoic delusion	0
nicotiana tabacums	ciliary neuralgia	0
food supplementations	creutzfeldt jakob disease	0
psidium guajavas	coad	0
dried apples	small-cell lymphoma	0
flax seed	hepatitis	0
orange trees	penile cancer	0
ready-to-eat meal	syndrome	0
hashish	male sub fertility	0
mango	vertiginous seizure	0
ice creams	intermediate-grade lymphoma	0
chard	auriculo ventricular dissociation	0
tuna fish	sliding esophageal hernia	0
plant-based foods	lichen ruber planus	0
fast foods	chronic headaches	0
dressing	malignant epithelial neoplasms	0
know nuts	mixed small and large cell lymphoma	0
crocus sativus	renal neoplasms	0
cereal	blv	0
soy beverages	coarse tremor	0
tumeric	blv	0
punica granatum	vulva neoplasms	0
cola	gastric acid reflux disease	0
elephant garlic	penis cancers	0
restructured meat	epithelioma	0
decrease meat	disc degeneration	0
different seed	gehrigs disease	0
soy bean curds	social anxiety disorders	0
pistacia	female sub-fertility	0
diabetic diet	joint disease	0
portulaca	marie-struempell disease	0
eugenia malaccensis	symptom clusters	0
fabaceae	dissociative amnesias	0
grape seeds	light headedness	0
hordeum vulgare	migraine variants	0
cultivated oats	microcephaly	0
vicia faba	periodontal diseases	0
salad	paraesophageal hernias	0
boiled broccoli	inflammatory diseases	0
foeniculum	drug allergy	0
plantago ovata	terminal ileitis	0
sugar substitute	inflammation	0
mother cells	jakob-creutzfeldt syndrome	0
apium graveolens var. rapaceum	disrupted in b-cell malignancy	0
avoid peanuts	kill cancer	0
carrot juice	oncogenic virus	0
bell peppers	neuralgic migraine	0
organ	fibromyositis fibromyalgia syndrome	0
popular fruits	todds paralysis	0
lime	gerd	0
anacardium	campylobacter infection	0
plantago arenaria	colitis	0
smoked foods	sciatica	0
carob	familial creutzfeldt jakob disease	0
crave chocolate	food-borne diseases	0
find pork	amnestic state	0
iv vitamin	muscle soreness	0
mother cell	virus infections	0
own vitamin	low-grade lymphoma	0
papaya	retro ocular headache	0
cherry plum trees	morning sickness	0
multivitamin	avitaminosis	0
chickpea	chronic airflow obstructions	0
no meat	convulsive syncopes	0
citronella	tonsillar neoplasms	0
individual candy	idiopathic polymyositides	0
plum	muscular cramps	0
cherry plum tree	mixed lymphomas	0
cinnamomum verum	uterine cervical neoplasm	0
anti-inflammatory plant	lead poisonings	0
ranking foods	cardiac diseases	0
stryphnodendron	social anhedonia	0
black coffee	peanut hypersensitivity	0
nutritional yeast	primary gh resistance	0
kava	virus disease	0
wild celeries	postoperative emeses	0
nut bars	ischemia	0
spice turmeric	retro ocular headache	0
billion eggs	stomach neoplasm	0
guibourtia	diverticulum	0
tobacco	gorlin goltz syndrome	0
soy sauce	dental diseases	0
linseed	skin rash	0
coca	fibroid tumors	0
food supplements	endometrium cancers	0
anise seed	canker sore	0
origanum majorana	cephalgia	0
sweet marjoram	acute inflammatory polyneuropathy	0
lunchtime	sciatica	0
cacao bean	chronic b-cell leukemia	0
phaseolus vulgaris	gallstone	0
white meat	early-onset parkinsonism	0
garlic	mucous colitides	0
english plantain	thyroid disorders	0
syzygium cumini	neoplasm	0
abelmoschus esculentus	recurrence	0
yam	atrioventricular dissociations	0
fungus	diabetic neuralgias	0
toronja	thermal hypesthesias	0
dried food	age related bone loss	0
thymus vulgari	vaginitis	0
bitter orange trees	brain tumors	0
cultivated oat	abdominal obesity	0
mandarin orange tree	nbcc	0
tulsi tea	pneumonitis	0
oolong tea	hysterical amnesias	0
kava kavas	myocardial ischemias	0
sunchoke	bowel disease	0
chili	non-hodgkin's lymphoma	0
eat flax	emphysema	0
hemp plants	crushing skull injury	0
bibhitaki fruit	aids virus	0
cranberry sauce	jakob-creutzfeldt disease	0
theobroma cacao	convulsive seizures	0
eupatorium rebaudianums	intracranial meningioma	0
cycad trees	respiratory tract cancer	0
molasses	androgenic alopecia	0
solanum tuberosum	multiple head injury	0
eugenia jambos	central obesity	0
neutraceutical	diabetes mellitus complication	0
dried blueberries	experimental parkinsonisms	0
contaminated meat	galactokinase deficiencies	0
japanese plums	painful menstruation	0
citrus grandi	mild neurocognitive disorders	0
longevity legumes	insomnia disorders	0
pomelo trees	nutritional disease	0
club sodas	fibrose	0
chenopodium quinoa	periodontal disease	0
poisonous plant	intractable headache	0
aloe vera	age-related memory disorder	0
oxen meat	stomach neoplasms	0
triticum spelta	uveitis	0
dangerous plants	bechterew disease	0
kombucha tea	texidor's twinge	0
alfalfa sprout	heart block	0
rabbit meat	hemangiopericytic meningioma	0
trompillo	carotid sinus syncope	0
holy basils	myocardial infarcts	0
french fries	darkness tremors	0
whole grains	ovary cancer	0
hydroponic basil	vagina cancer	0
higher vegetable	gehrig disease	0
healthy nuts	schizophreniform disorder	0
collard green	low back pain	0
added nuts	heart diseases	0
pinto bean	postoperative nausea	0
elettaria cardamomum	communicable diseases	0
suggesting apple	periodontal disease	0
american meat	cancer of pancreas	0
dietary proteins	lung neoplasm	0
areca catechu	familial tremor	0
marijuana	muscular rheumatism	0
fast food	causes cancers	0
tomato sauce	cot deaths	0
raspberry	cll lymphoplasmacytoid lymphomas	0
apium graveolens	burkitt's lymphoma virus	0
green pepper	hydrophobia	0
cumin	atypical cluster headache	0
rutabaga	circulatory collapse	0
breakfast cereal	cognitive dysfunction	0
prunus persica	light headedness	0
chipotle	subwakefullness syndromes	0
plant aril	creutzfeldt-jakob disease	0
include apples	scurvy	0
foie gras	hyperphagia	0
lamb chops	epimerase deficiency galactosemias	0
pummelo trees	drug addiction	0
triticum durum	prostate neoplasm	0
mirobalanus embilicas	cardiovascular disease	0
squash plants	fusiform aneurysms	0
foenumgraecum	galactose-1-phosphate uridylyltransferase deficiency	0
dioscorea	senile osteoporosis	0
sesame seeds	thyroid disorders	0
milk proteins	acquired immunodeficiency syndrome	0
assai palm	hansen's disease	0
chili peppers	rectum cancer	0
cold-steeping tea	drug use disorders	0
white mallows	intracranial cns disorders	0
food poisonings	cardiac sudden death	0
solanum	mixed lymphoma	0
fragaria	papillomaviridae	0
miso	early awakening	0
milk protein	fibroid tumors	0
snail meat	vagina cancer	0
nonus	osteoarthritide	0
dietary protein	esophageal cancers	0
anacardium occidentales	jaundice	0
processing meat	bladder tumors	0
horse nettle	lymphocytic leukemia	0
fiddlehead ferns	hepatitis e	0
common plant	clear cell meningiomas	0
cardamom	fatty liver	0
bell pepper	fighting cancer	0
whole grain cereal	inflammatory bowel disease	0
chinese cinnamons	foodborne disease	0
chilli pepper	breast carcinomas	0
chile pepper	metabolic acidosis	0
food and drug administration	painful menstruation	0
salmonella-infected eggs	cancer of colon	0
snacktime	splitting pains	0
cannabi	premenstrual syndromes	0
persea	experimental parkinsonisms	0
sea food	fibromyoma	0
unfiltered coffee	bilateral sciatica	0
lemon balm	hemorrhoid	0
flesh foods	clonic seizure	0
cocoanut	beriberi	0
healthy food	lymphoblastic leukemia	0
ilex paraguarienses	small-cell lymphomas	0
dried apricots	metastasis	0
anacardium occidentale	ramsay hunt paralysis syndrome	0
ready soybeans	renal cancers	0
nutmeg	ekbom delusional parasitoses	0
fagopyrum tataricum	milk sugar intolerance	0
frozen spinach	age-related macular degeneration	0
healthy snacks	back pain with radiation	0
plant zygote	rectal neoplasm	0
tree nuts	prostate cancers	0
fenugreek seeds	diffuse lymphomas	0
cider	breast malignant tumors	0
purple rice	carcinoma	0
sticker	amyotrophic lateral sclerosis	0
cocoa plant	tumor	0
raphanus raphanistrum	acquired immunodeficiency syndrome virus	0
millet	diabetic amyotrophies	0
alpine strawberries	cystic breast disease	0
carya illinoensis	mottled enamel	0
cacao	familial dementia	0
curried tofu	prostatic cancers	0
drug administration united states food	acquired immunologic deficiency syndrome	0
acid-binding vegetables	prostate cancers	0
indian gooseberry	clear cell meningiomas	0
texturized soy proteins	cognitive decline	0
cleistocalyx	human flu	0
faba bean	small noncleaved cell lymphoma	0
rheum tanguticum	undifferentiated lymphomas	0
gala apples	retained surgical sponge	0
high fructose corn syrup	mesothelioma	0
betel	post-traumatic osteoporoses	0
plant embryo	chronic daily headache	0
buttermilk	dysosmia	0
plantago psyllium	light headedness	0
marjoram plants	utp-hexose-1-phosphate uridylyltransferase deficiency disease	0
food allergy	higher cancer	0
little saffron	age related memory disorders	0
turmeric	substance use disorder	0
cultivated radish	fibrocystic mastopathy	0
antioxidant food	mammary cancers	0
baked potato	spindle cell sarcomas	0
aspartame	rectum neoplasms	0
deep-fried foods	short sleeper syndromes	0
diet	cancer of vagina	0
curcuma longas	ankylosing spondyloarthritides	0
squid	prostate cancers	0
eat chocolate	kidney insufficiency	0
rooibos tea	retained surgical sponges	0
color	back aches	0
mentha piperita	frontal region traumas	0
plant capsule	male pattern baldness	0
ready prepared foods	amnesia memory loss	0
texturized vegetable proteins	testis cancers	0
pleurotus	lassitude	0
sweet basil	psychogenic parasitoses	0
spinach	mild cognitive impairments	0
pistachio nut trees	mechanical low back pain	0
ocimum basilicums	dysmenorrhea	0
amorpha	barrett's esophagus	0
norovirus food	birth weights	0
eating nuts	neoplasm metastases	0
crab apple	constipation	0
dinner time	non-hodgkin's lymphoma	0
boiled eggs	cervical neoplasms	0
kiwi	superficial head injury	0
calling eggs	gustatory seizure	0
leek	arrhythmia	0
soya milk	premenstrual syndrome	0
sockeye salmon	gnathostoma infections	0
myristica fragran	creutzfeldt-jakob syndrome	0
prunis communis	gluten sensitive enteropathy	0
stuff	celiac disease	0
st. johnswort	feline lymphoma viruses	0
foxglove	chronic fatigue and immune dysfunction syndrome	0
marsh mallows	symptom clusters	0
cocoa	phlebothrombose	0
lemon grasses	cephalalgia	0
octopus	cjd (creutzfeldt-jakob disease)	0
filbert	sleep related neurogenic tachypnea	0
dried apple	neurologic degenerative diseases	0
saint johns wort	intertrochanteric fractures	0
poppy seed	childhood obesity	0
seville orange tree	intraepithelial neoplasms	0
nutrient-dense foods	temporal region trauma	0
swiss chard	tying disease	0
acai berry	gastric neoplasm	0
bottled water	acquired immuno deficiency syndrome	0
drinking orange	non-epileptic convulsions	0
pumpkin pie	dyslipidemia	0
pistachio nut tree	mechanical low back pain	0
walnut	tactile hypesthesias	0
poultry products	drug abuse	0
woodland strawberry	ekbom delusory parasitoses	0
moose meat	premenstrual tensions	0
crowberry	stroke	0
camomile	phlebothrombose	0
drinking coffee	passive tremors	0
mastic tree	breast diseases	0
solanum laciniatums	neurotic anxiety states	0
prunus dulcis	environmental cancer	0
food company	gynecomastia	0
pyrus	human herpesvirus 4 (gamma)	0
edible grain	cancer of stomach	0
inadequate fruit	non-hodgkin's lymphoma	0
pizza	autoimmune disorders	0
navy beans	familial creutzfeldt jakob disease	0
sugary foods	breast tumor	0
bean sprouts	leprosy	0
macadamia nut	kidney neoplasms	0
canned foods	memory loss	0
frier	gastric acid reflux	0
shiitake	rickets	0
almond oil	new variant creutzfeldt jakob disease	0
philadelphia cream cheese	lactose intolerance	0
citrus paradisi	male pattern baldness	0
crocus	low back pain	0
eugenia cumini	renal cancers	0
raw tomatoes	breast neoplasms	0
pea	post-traumatic osteoporoses	0
edible grains	infertility	0
pudding	ductal carcinoma	0
diospyros digyna	auricular fibrillation	0
tachigalia	social phobia	0
halibut	ebv	0
dinnertime	vestibular seizures	0
cocoa plants	testicular cancers	0
raisin bran	age-related osteoporosis	0
petroselinum crispum	kanner syndrome	0
cassia fistulas	kidney calculi	0
undercooked meat	exudative bronchiolitis	0
hop	cephalgia syndrome	0
coconut	sprue	0
portulaca oleraceas	drug allergies	0
cooked meats	hypercapnia	0
warm milk	primary malignant brain neoplasms	0
gluten	varice	0
healthy snack	appendicitis	0
broccoli raab	familial guillain-barre syndrome	0
arugula	vaginal cancer	0
tangerine trees	mild neurocognitive disorders	0
baby formula	ph1-negative myelogenous leukemias	0
punicaceae	dementia with amyotrophic lateral sclerosis	0
turkey meat	eczematous dermatitis	0
almond trees	non hodgkins lymphoma	0
narrow-leaved plantain	mild cognitive impairment	0
snack foods	monocular blindness	0
nut	hypolactasia	0
plant arils	liver steatoses	0
fresh fruits	stomach neoplasms	0
brassica	primary fibromyalgias	0
alfalfa	fights cancer	0
processed meat	fatty liver disease	0
sweet orange	norwalk-like viruses	0
brassica nigra	endometrium carcinomas	0
cereal grains	epileptic seizures	0
low vitamin	multiple meningiomas	0
vitis	dementia	0
mesquite	prion induced disorder	0
texturized soy protein	cancer of the penis	0
cured meats	toxic megacolon	0
green teas	breast adenosis	0
healthiest vegetable	migraine disorders	0
carbonated waters	hot flashes	0
wild yams	delusional parasitoses	0
thyme	brief reactive psychosis	0
component spices	sudden onset diabetes mellitus	0
roselle	aphthous ulcer	0
hemp plant	arthritis	0
raw alfalfa	gastric neoplasm	0
box elders	adolescent gynecomastia	0
lemon balms	prostate neoplasms	0
sesame	muscle spasm	0
sauerkraut	micturition syncopes	0
seltzer waters	pancreas neoplasms	0
organ meats	small noncleaved-cell lymphomas	0
sweet potatoes	epithelial cancer	0
elettaria	gale deficiencies	0
narrow-leaved plantains	cancer of the bladder	0
caryophyllus aromaticus	cancer of the thyroid	0
capparis	cancer of breast	0
euterpe oleracea mart.s	celiac sprue	0
apium graveolens var. dulce	experimental lung inflammations	0
butternut squash	enzootic bovine leukoses	0
ceylon cinnamon	auditory seizure	0
beta vulgaris	ruptured appendicitis	0
squash seeds	growth hormone insensitivity syndrome	0
bhang	male pattern alopecia	0
fuji apples	primary malignant brain tumors	0
cucumis melos	central obesity	0
brown rice	granulomatous colitis	0
prenatal vitamins	mild cognitive impairments	0
chilli peppers	testicular cancers	0
rubus idaeus	male breast enlargement	0
daily nut	colonic cancer	0
rheum officinale	familial atrial fibrillations	0
dairy yogurt	parkinson’s disease	0
blueberry	jakob creutzfeldt disease	0
squash	inflammatory polyneuropathy acutes	0
aspalathus linearis	auriculo ventricular dissociation	0
hot sauce	testicular neoplasm	0
euterpe precatoria	premenstrual tension	0
lens plant	abdominal migraine	0
hot peppers	cervicitis	0
pecan	diabetic mononeuropathy	0
apple trees	disrupted in b-cell malignancy	0
red wine	lactose malabsorption	0
soy bean curd	multiple myositis	0
health nuts	gastric ulcer	0
red lentils	benign prostatic hypertrophy	0
biometal	vestibular seizure	0
trace mineral	migratory pain	0
nutriceutical	muscular spasm	0
black raspberries	focal seizure	0
humulus	hypertension	0
red onions	retained surgical item	0
cappari	low grade lymphoma	0
jambolan plum tree	lou-gehrigs disease	0
citrus aurantium	right-sided heart failure	0
solanum tuberosums	recrudescence	0
stem vegetables	postviral fatigue syndromes	0
butter milk	cancer of the bone	0
amygdalus communis	arthralgia	0
ultra-processed foods	lung cancers	0
health food	vertiginous seizures	0
maple syrup	endometrium carcinoma	0
red rice	human cancer	0
intoxicant	exudative bronchiolitis	0
eugenia sandwicensis	undifferentiated lymphomas	0
pistacia lentiscus	elevated cholesterol	0
indian corn	gluten sensitive enteropathy	0
organic milk	hirsutism	0
healthiest foods	torsion fracture	0
algarrobo	halitose	0
rye	lactose intolerance	0
raw broccoli	saturnine tremors	0
aquatic food	gastroesophageal reflux disease	0
almond	prostate cancers	0
table salt	b-cell leukemia	0
okra	parkinsons disease	0
zinger tea	variant creutzfeldt-jakob disease	0
empty calorie foods	convulsive seizure	0
holy basil tea	syncopal vertigos	0
mushroom	bacterial vaginitis	0
fat foods	hypercholesteremia	0
pomegranate seeds	malignant meningiomas	0
linum	liver neoplasms	0
term vegetable	gerd	0
maize oil	gastric acid reflux disease	0
antioxidant foods	migratory pains	0
artificial sweeteners	osteoarthritis	0
bilberry	gustatory seizures	0
vaccinium bracteatums	rectal cancers	0
nicotiana tabacum	lung cancer	1
pepsi	heart attacks	0
calendula officinalis	low-grade lymphoma	0
cupcake	hypoesthesia	0