
soft drinks	unilateral headaches	0
cacao bean	parietal region trauma	0
eating almonds	anhedonia	0
bamboo shoots	fever	0
hemp plant	drug hypersensitivities	0
prunus domestica	somatotropin hypersecretion (acromegaly) syndromes	0
sell meat	autosomal recessive juvenile parkinson disease	0
hashish	cancer of bladder	0
yellow vegetables	backache	0
rice	guam form amyotrophic lateral sclerosis	0
nicotiana tabacums	tongue cancer	0
low-fat diet	dna injuries	0
opium poppies	guam disease	0
vaccinium angustifolium	johnes disease	0
corn syrup	small round structured viruses	0
floret	intestinal disease	0
beet	varix	0
dietary fibers	broken bone	0
skim milk	acute confusional migraines	0
crabapple	undifferentiated lymphoma	0
low-calorie diet	gluten-sensitive enteropathy	0
grapefruit juice	testis cancer	0
juglan	ciguatera	0
toxic plant	encephalon disease	0
melissa	lung inflammation	0
canned fruit	stokes-adams syncopes	0
psidium guajavas	hemolytic-uremic syndrome	0
plantago lanceolata	baldness	0
apricot trees	degenerative neurologic disorder	0
different seed	psychogenic parasitosis	0
sweet basils	cva (cerebrovascular accident)	0
whipped cream	pustular psoriasis of palms and soles	0
eating nuts	multiple myelomas	0
processed foods	visceral obesity	0
sweet basil	cancer of the vulva	0
food colors	acute infectious polyneuritis	0
illicium	intraepithelial neoplasm	0
yolk	baldness	0
ready-prepared food	amyloid deposits	0
orange trees	esophagus cancer	0
sweet foods	acute stroke	0
pear	age-related maculopathies	0
shan yaos	acute monoblastic leukemia	0
raw meat	tubal abortion	0
english plantain	inflammatory diseases	0
horse nettle	recurrence	0
piper nigrum	chronic fatigue and immune dysfunction syndrome	0
quinoa	cervix neoplasm	0
portulaca	crohn's enteritis	0
citronella	human mammary neoplasm	0
chicken	gorlin syndrome	0
beta vulgari	bladder diseases	0
breakfast cereal	central obesity	0
mirobalanus embilica	tick bites	0
wild bananas	rhabdomyolysis	0
mustard oil	chronic fatigue syndrome	0
tofu	inflammatory disease	0
carbonated beverage	tumor of rete testis	0
pisum sativum	semantic memory disorder	0
potato	burkitt lymphoma virus	0
catfish	primary brain tumors	0
malus domestica	colitide	0
nicotiana	long sleeper syndrome	0
vaccinium myrtillus	zoonosis	0
green peas	metastasis	0
papaver somniferum	diffuse lymphocytic lymphoma	0
milk proteins	pancreatic neoplasm	0
processed meats	neuritic plaques	0
organic foods	cardiac failure	0
dress	lung cancer	0
extracted fruit	autoimmune condition	0
caper	sterility	0
consumer protection scientific committee on food	cephalgia syndrome	0
fresh basil	crushing skull injury	0
box elders	auricular fibrillation	0
maple	chronic lymphoblastic leukemias	0
assai palm berries	hemolytic-uremic syndrome	0
lentinus edodes	udpglucose 4 epimerase deficiency disease	0
orange	non-epileptic convulsion	0
corn oils	bovine spongiform encephalitis	0
pasta	idiopathic parkinson's disease	0
sweetening agents	kanners syndrome	1
peach trees	female sub-fertility	0
crowberry	unilateral headaches	0
eugenia caryophyllata	essential tremor	0
citrus fruits	lens opacity	0
taraxacum	bladder cancer	0
brazil nut tree	hypoxemia	0
green tea	uterine leiomyoma	0
jerusalem artichokes	muscular cramp	0
bean	uterine neoplasm	0
fat milk	hyperpigmentation	0
thousand foods	prediabete	0
seville orange tree	generalized headache	0
lavandula	non-alcoholic fatty liver disease	0
euterpe precatoria	tongue cancers	0
foeniculum	cancer of the brain	0
linum usitatissimum	rachitide	0
eugenia sandwicensis	kidney insufficiencies	0
whole grains	tactile amnesias	0
sour orange tree	aphthous ulcers	0
dietary sucrose	osteoarthrose	0
abelmoschus	intention tremors	0
holy basils	feminization	0
red yeast rice	angiomatous meningiomas	0
whortleberry	mixed lymphocytic-histiocytic lymphoma	0
chipotle	visceral obesity	0
snack foods	parkinson disease	0
triticum durum	neuralgic migraine	0
solanum laciniatum	non b hepatitis enterically transmitted non a	0
plant foods	uterine neoplasms	0
plantago psyllium	ekbom delusional parasitosis	0
human milk	stomach cancer	0
cranberry	blood cancer	0
food coloring	muscular rheumatism	0
beef	anaplastic carcinomas	1
corn	acromegaly	0
melissa officinali	high cholesterol levels	0
probiotic	diffuse small cleaved cell lymphoma	0
kohlrabi	breast tumors	0
cilantro	neuritic plaque	0
processed apples	high blood pressure	0
peppermint	acute monoblastic leukemia	0
red rice	autoimmune disorders	0
kawa	anaplastic carcinoma	0
dietary soybean proteins	bewilderment	0
plantago ovata	near-death experience	0
chinese food	intraventricular meningioma	0
sugary foods	bovine leukoses	0
capsicum	cardiogenic syncope	0
little saffron	tonsillar neoplasm	0
noni fruit	burning pains	0
four nuts	sleep-related neurogenic tachypnea	0
fried foods	leanness	0
monkfish	pancreatitide	0
new candy	fibroid uterus	0
worldwide fruit	lymphosarcoma	0
aspartame	extreme hearing loss	0
elephant garlic	cjd (creutzfeldt-jakob disease)	0
individual candy	galactose 1 phosphate uridyl transferase deficiency disease	0
common foxglove	hyperpigmentation	0
chilli pepper	cerebrovascular strokes	0
trace mineral	lymphocytic leukemia	0
preserved foods	dental diseases	0
topical ginger	allergic diseases	0
pecan	parietal region trauma	0
regular olive	lung diseases	0
organ meats	chronic fatigue syndrome	0
turnip	bacterial infection	0
dried peas	chronic daily headaches	0
purple grape	craniocerebral injury	0
cooked meats	legal blindness	0
plant arils	brain vascular accident	1
macadamia	plasma cell myeloma	0
diospyros digynas	convulsion	0
adhatoda	diabetes complication	0
prunus dulcis	water-borne hepatitis	0
poultry	penis cancer	0
chervil	dysmenorrhea	0
mentha x piperita	tongue neoplasms	0
pineapple	sleep wake disorder	0
fryer	benign prostatic hyperplasia	0
acer saccharums	cephalodynia	0
mandarin orange trees	dizzyness	0
bell peppers	brains cancer	0
infant formula	preventable cancers	0
true nut	colorectal neoplasm	0
apricot tree	bechterews disease	0
drink	bladder cancer	0
fagopyrum	rhabdomyolys	0
crocus	sharp headache	0
raw foods	human mammary carcinoma	0
veal	leprosy	0
alcoholic beverages	esophageal neoplasm	0
soy proteins	severe congenital microcephalies	0
st. john's wort	mixed lymphomas	0
flower	massive tremors	0
illicium anisatums	prostatic neoplasms	0
frozen broccoli	v-cjd (variant-creutzfeldt-jakob disease)	0
da huang	polyradiculoneuropathy	0
thymus	right-sided heart failure	0
silken tofu	muscular spasms	0
capsicum annuum	prostatic cancer	0
hummus	diffuse small cleaved-cell lymphoma	0
osmanthus	philadelphia negative myeloid leukemia	0
buckwheat	granulomatous enteritis	0
potassium-rich foods	cancer of liver	0
frozen cranberries	reduced sensations	0
berry	congenital myxedema	0
avocado fruit	acute strokes	0
secale	icterus	0
sandwich	retained surgical item	0
carthamus tinctorius	occipital region trauma	0
mother cell	periodontal disease	0
scrambled eggs	migraine variant	0
plantain	cardiac arrhythmias	0
common fruits	sudden cardiac death	0
soy sauce	bilateral headache	0
stevia	viral hepatitis	0
mealtime	goiter	0
barley coffee	lens opacity	0
broccoli	endometrial carcinoma	0
cinnamomum zeylanicum	osteoarthrosis deformans	0
dog rose	fighting cancer	0
chocolate pudding	aphthous ulcer	0
cereal grains	spindle cell sarcomas	0
hibiscus	a v dissociation	0
soy cheeses	hepatitis e	0
callerya	primary brain tumors	0
baking chocolate	cjd (creutzfeldt jakob disease)	0
tomato	gnathostomiasis	0
soybean proteins	sleep disorder	0
vaccinium corymbosum	infant botulisms	0
bell pepper	toxic megacolon	0
pretzel	intraorbital meningiomas	0
dietary fiber	bilateral sciatica	0
ground meat	cancer of stomach	0
oryza sativa	sphenoid wing meningioma	0
kawa kawa	rhabdomyolys	0
coco	parkinsonism	0
baby spinach	hiccup	0
red wine	dental diseases	0
pistil	diverticula	0
edible grains	germinoblastic sarcomas	0
soy	uterine cervical neoplasms	0
origanum vulgare	gastroesophageal reflux	0
zucchini	growth hormone insensitivity syndrome	0
cherry plum tree	hepatitide	0
legume pods	hyperventilation syncopes	0
breakfast times	paratuberculose	0
sugar substitute	rodent ulcers	0
peach tree	diabetes-related complication	0
usda poultry	small round structured viruses	0
anacardium occidentales	impaired sensation	0
berberi	juvenile-onset diabetes mellitus	0
dangerous plants	polyp	0
anchovy	male sexual impotence	0
horsebean	fatigue	0
shoot	guam form of amyotrophic lateral sclerosis	0
flax seeds	relapse	0
pudding	frontal region traumas	0
plum tree	male pattern baldness	0
alfalfa	galactose epimerase deficiencies	0
herr	hip fractures	0
club soda	meningiomatosis	0
dinnertime	focal seizures	0
rowanberry	age related maculopathies	0
uncooked foods	impaired sensation	0
tap water	gehrig disease	0
filtered coffee	huntington’s disease	0
honey	fusiform aneurysms	0
bitter nightshade	nonalcoholic steatohepatitis	0
mentha	hypoxemia	0
healthy snack	rheumatoid spondylitis	0
french fries	varicose veins	0
marjoram	idiopathic polymyositides	0
flammulina	johne's disease	0
organic food	guillaine barre syndrome	0
mustard plants	diabetic autonomic neuropathies	0
lavender	skin neoplasms	0
goji berry	androgenic alopecia	0
chestnut	cancer of mouth	0
black currants	rete testis tumor	0
common bean plant	involuntary quivers	0
popcorn	necrotizing fascitides	0
nightshade	disorder	0
citrus sinenses	spontaneous abortion	0
healthy fruit	cough	0
ready prepared foods	prion-induced disorders	0
eating eggs	anosmia	0
dairy product	rectal tumors	0
honeybush tea	abdominal pains	0
steak	common colds	0
vegetarianism	postoperative emeses	0
irritable bowel kiwi fruit	non epileptic convulsion	0
crocus sativus	parkinson’s disease	0
black walnuts	sterility	0
baby formula	unhealthy conditions	0
sparkling waters	bladder tumors	0
kombucha tea	intracranial cns disorder	0
crab apple	cancer of the vulva	0
cocos nucifera	udp galactose 4 epimerase deficiency disease	0
longevity legumes	epithelioid sarcoma	0
plum	small round structured viruses	0
not-necessarily-so-healthy foods	galk deficiency	0
contaminated foods	nonhodgkins lymphoma	0
grape juice	gallbladder diseases	0
broth	breast adenosis	0
purple rice	breast carcinomas	0
taking vitamin	western diseases	0
cocktail	syncopal vertigo	0
artificial butter	female pattern baldness	0
solanum tuberosums	chronic headache	0
linum	galactokinase deficiency	0
green grapes	anxiety disorder	0
msg	craniocerebral injuries	0
cassia	spatial memory disorder	0
kawa kawas	gasser syndrome	0
foodstuff	human immunodeficiency viruses	0
maraschino cherry	bone neoplasms	0
marjoram plants	lyssa	0
cream cheese	orf	0
saint johnswort	udp-galactose-4-epimerase deficiency disease	0
nori	dwarfism	0
emblica officinali	renal calculi	0
grape seeds	oncovirinae	0
rubus glaucus	experimental lung inflammations	0
high-fructose maize syrup	spinal cord degenerative diseases	0
syzygium jambolanum	headache syndrome	0
healthiest vegetable	gluten sensitive enteropathy	0
aspalathus linearis	reverse cancer	0
amlas	unilateral headache	0
flaxseed	mechanical low back pain	0
durum wheat	non-epileptic convulsion	0
reason food	gehrig disease	0
international nut	udp-galactose-4-epimerase deficiency diseases	0
banana	mental disorder	0
lunch times	substance abuse	0
cynara scolymus	episodic cluster headaches	0
cocoa butter	kidney insufficiency	0
healthiest snack	colon neoplasms	0
banana plants	cerebrovascular stroke	0
jalapeno	gossypiboma	0
ocimum sanctum	splitting pains	0
poppy seeds	fibroid uterus	0
allium cepa	non b hepatitis enterically transmitted non a	0
liquor	endometrial carcinoma	0
cherry plum trees	benign meningiomas	0
lemon verbena	alopecia	0
jelly	long sleeper syndrome	0
morinda citrifolias	cervix cancer	0
silybum marianum	dyspepsia	0
drink milk	parkinson's disease	0
carica	auditory seizures	0
meal	premature births	0
healthiest fruits	cardiac dysrhythmia	0
no noni	diffuse myofascial pain syndrome	0
phaseolus vulgaris	visual seizure	0
cocoanut	thrombose	0
citrus paradisi	elevated cholesterols	0
almond trees	western diseases	0
raw broccoli	primary fibromyalgia	0
trigonella foenum graecum	androgenic alopecias	0
consumed chocolate	primary gh resistance	0
coconut milk	psychotic disorder	0
cassia tree	carsickness	0
plant zygote	renal neoplasms	1
sparkling water	inflammatory bowel disease	0
jell-o	lou gehrig disease	0
fructose corn	back pain with radiation	0
dark meat	zoonotic infectious disease	0
no coffee	recurrent low back pain	0
abelmoschus esculentus	erectile dysfunction	0
biometal	microglandular adenoses	0
rosemary	transitional meningioma	0
indian laburnum	effort syncopes	0
aquatic food	acute autoimmune neuropathy	0
animal-based foods	disc degenerations	0
algarrobo	cardiovascular disease	0
eat flax	regional ileitides	0
espresso	endometrial carcinoma	0
candy	heatstroke	0
licorice	foodborne botulisms	0
prunus armeniaca	familial juvenile parkinsonism	0
plantago arenaria	hemicrania	0
betel	graves disease	0
secale cereale	memory losses	0
acer negundo	thyroid adenoma	0
dragon fruit	pyrexia	0
colorful foods	heart failure	0
turkey meat	cancer of the ovary	0
sushi	syncopal vertigo	0
saint johns wort	kidney cancers	0
sweet pepper	sexual dysfunction	0
legume pod	fusiform aneurysms	0
bergamot	ciguatera poisoning	0
kiwi fruits	hypospadia	0
spicy food	encephalon disease	0
foeniculum vulgares	toxico-infectious botulism	0
phaseolus vulgari	involutional osteoporosis	0
soy cheese	amaurosis	0
soymilk	utp hexose 1 phosphate uridylyltransferase deficiency disease	0
lamb chops	endometrial carcinomas	0
sour fruit	unhealthy conditions	0
phyllanthus emblicas	b-cell chronic lymphocytic leukemia	0
andean blackberry	small-cell lymphomas	0
oatmeal	type 1 diabetes mellitus	0
spearmint	renal cancers	0
fruit-shaped marshmallows	renal cancer	0
proteus mirabilis	lyme disease	0
artificially-flavored corn	heart attacks	0
poultry product	tonic seizures	0
specific cheeses	smell disorders	0
amygdalus communis	non-epileptic convulsion	0
citrus grandis	pancreatic neoplasm	0
sweetener	intraepithelial prostatic neoplasias	0
horse bean	deformity	0
fiddlehead ferns	parietal region trauma	0
hypericum perforatum	polyp	0
lemon trees	intracranial central nervous system disorders	0
whole foods	insulin-dependent diabetes mellitus	0
leafy vegetables	meningiomatosis	0
tepary bean	autosomal recesssive juvenile parkinsonism	0
colophospermum	recurrent brain tumors	0
apple trees	breast adenosis	0
maize oils	angiomatous meningioma	0
flammulina velutipes	philadelphia negative myeloid leukemia	0
whale meat	birth defect	0
undercooked meat	stomatognathic disease	0
green onions	thermal hypesthesia	0
trace elements	venous thrombosis	0
boiled eggs	myelogenous leukemia	0
canned food	androgenetic alopecia	0
lycopersicon esculentum	premenstrual tensions	0
rooibos tea	cardiovascular stroke	0
alpine strawberries	atrial fibrillation	0
mustard	death	0
pomegranate seeds	eczematous dermatitides	0
citrus fruit	primary fibromyalgias	0
brazil nuts	udpglucose hexose-1-phosphate uridylyltransferase deficiency	0
faba beans	bladder cancer	0
pistachio nut trees	bechterew disease	0
eggnog	cancer of the cervix	0
tea hibiscus	lower back pains	0
wheatgrass	kidney diseases	0
incorporate cloves	acquired immuno-deficiency syndrome	0
high fructose maize syrup	ekbom delusory parasitosis	0
dietary protein	cognitive retention disorder	0
nutmeg	short sleeper syndromes	0
lens plant	barrett epithelium	0
mastic tree	kill cancer	0
apple tree	retained surgical sponge	0
jalapeno pepper	cervix cancers	0
kidney bean	broken bones	0
dinner time	rna tumor viruses	0
maize oil	vagina neoplasms	0
horsenettle	arthropathy	0
sorrel	renal failures	0
apium graveolens	scurvy	0
punicaceae	exudative bronchiolitis	0
sugar-sweetened beverages	grave’s disease	0
smoked foods	autosomal recesssive juvenile parkinsonism	0
turmeric	breast cystic diseases	0
radicchio	amyloid deposits	0
soy milk	cancer of the uterine cervix	0
alfalfa sprout	amyloidose	0
brussels sprouts	gustatory seizure	0
frozen spinach	open head injuries	0
potato chips	extreme hearing loss	0
allium sativum	galactosemia 2	0
chenopodium quinoas	fatty liver	0
safflower oil	atheromatous plaques	0
ephedra	aids virus	0
confection	brain diseases	0
healthier foods	low backache	0
triticum spelta	new variant creutzfeldt-jakob disease	0
trace element	disc degeneration	0
frying foods	pustulosis of palms and soles	0
so-called meat	peanut allergies	0
natto	pharyngitis	0
yerba mate	chronic obstructive lung disease	0
cider	acute strokes	0
jelly beans	episodic cluster headache	0
pepper	reducing cancer	0
trigonella foenum-graecums	chronic headache	0
junk foods	thyroid neoplasm	0
stevia rebaudianas	parodontosis	0
soy beans	kahler disease	0
green lentils	pregnancy induced diabetes	0
portulaca oleracae	hereditary galactokinase deficiencies	0
grecian foxgloves	microglandular adenosis	0
areca nuts	galactose-1-phosphate uridylyltransferase deficiencies	0
sustenance	lou-gehrigs disease	0
teff	felv	0
indian gooseberries	growth hormone receptor deficiency	0
food poisonings	mental deterioration	0
garcinia mangostana	clonic seizures	0
anise seed	cancer of stomach	0
vegetable proteins	udp-galactose-4-epimerase deficiencies	0
rubus idaeus	reproductive sterility	0
butternut squash	abdominal obesities	0
zea	neurologic degenerative disease	0
norovirus food	tonsillar cancer	0
sunchoke	gestational diabetes	0
horse nettles	malignant tumor of breast	0
brewage	brain benign neoplasm	0
black sapote	artery disease	0
cuminum	substance induced organic mental disorders	0
hordeum vulgare	male sterility	0
vaccinium bracteatum	meningioma	0
grecian foxglove	impaired sensations	0
emblica officinalis	sore throat	0
cappari	carcinomatosis	0
guibourtia	parkinson’s disease	0
suggesting fruit	sphenoid wing meningiomas	0
croaker	olfactory groove meningioma	0
mango	pituitary dwarfism ii	0
glycyrrhiza glabra	prion induced disorder	0
herbal teas	fibromyositis-fibromyalgia syndromes	0
marshmallow	familial dementias	0
organic meat	age related osteoporosis	0
psidium	symptom cluster	0
pease	adolescent gynecomastia	0
blueberry plants	metastatic cancer	0
persimmon	early diagnosis of cancer	0
chard	manic disorders	0
diospyro	cervix neoplasm	0
cruciferous foods	non b hepatitis enterically transmitted non a	0
food supplementations	back pains	0
brain-invasive pork	brain malignant neoplasms	0
dioscorea batatas	salami brusher's disease	0
plantago indica	cancer of esophagus	0
cranberry sauce	elevated cholesterol	0
red delicious	neurodegenerative disorder	0
gluten	cancer of thyroid	0
rose hips	benign neoplasms	0
kangaroo meat	congenital abnormality	0
pomegranate fruit	atherosclerose	0
morinda citrifolia	foodborne illnesses	0
rise	infant obesity	0
fragaria vesca	zoonotic diseases	0
taraxacum officinale	cancer of colon	0
ranking foods	nonhodgkins lymphoma	0
pimenta diocia	aneurysm	0
restructured meat	perioral tremors	0
yam	infant botulism	0
apple	visceral obesity	0
chicken meat	back ache	0
brew	senile paranoid dementias	0
organ	posterior fossa meningioma	0
mentha spicata	dissociative amnesia	0
beet greens	uterine fibroids	0
supper	emphysema	0
infant formulas	heart disease	0
olive	drop attacks	0
millet	vestibular seizure	0
ground ginger	juvenile-onset diabetes	0
fermented foods	mixed lymphomas	0
oregano plants	preterm birth	0
pistachio nut tree	esophageal reflux	0
syzygium jambos	long sleeper syndrome	0
poppy	deglutitional syncopes	0
dasheen	gout	0
roasted almonds	gall stones	0
carya	testis neoplasm	0
rosehip	galactosemia iii	0
egg	cancer of cervix	0
cocoa powders	acute cerebrovascular accidents	0
vegetable juice	environmental cancer	0
orange tree	arterial fatty streak	0
mastic trees	postviral fatigue syndromes	0
shellfish	osteoporose	0
stevia rebaudiana	disc degenerations	0
glucose-fructose syrup	johne disease	0
nuclear power plant	pseudotumor cerebri	0
walnut	epithelial cancer	0
citrus-based fruits	sliding hiatal hernias	0
eugenia jambolana	gorlin-goltz syndrome	0
poisonous plant	cognitive dysfunction	0
woodland strawberry	foodborne botulism	0
persea	breast cancers	0
mandarin orange tree	gingivitis	0
triticum	hiatus hernia	0
chinese cinnamons	infant obesity	0
yogurt	emphysema	0
trompillo	autism	0
mustard plant	peanut hypersensitivity	0
prebiotic	bse (bovine spongiform encephalopathy)	0
parsley	microglandular adenoses	0
pomelo trees	auriculo-ventricular dissociation	0
rye bread	genital warts	0
added nuts	human herpesvirus 4	0
basil	parasagittal meningiomas	0
hot peppers	scorbutus	0
mackerel	benign meningiomas	0
whole wheat	marie struempell disease	0
white wine	cysticercose	0
carduus marianus	vertex headaches	0
animal-based vitamin	back ache	0
mirobalanus embilicas	anthrax	0
almond	gehrig disease	0
amaranth	minor head injuries	0
cooked tomatoes	arthropathy	0
applesauce	continuous tremors	0
stryphnodendron	benign brain neoplasm	0
snack food	degenerative neurologic disorder	0
betel nut	disk degradation	0
apium graveolens var. dulce	malignant epithelial neoplasm	0
sea-food	pseudocoma	0
assai palms	tonsillar cancers	0
candy bar	endometrial neoplasm	0
phaseolus acutifolius	acquired immunodeficiency syndromes	0
hemlock	posterior fossa meningiomas	0
ready-prepared foods	virus disease	0
tree nuts	diabetic neuralgias	0
garlic sauce	male breast carcinoma	0
piper methysticum	hyperthermia	0
cycad trees	fibromyalgia fibromyositis syndrome	0
calendula	olfactory seizures	0
roundup-ready soybeans	memory loss	0
foeniculum vulgare	situational syncope	0
cannabis indica	myelopathy	0
scallion	uterine neoplasm	0
pimpinella anisum	prostatic intraepithelial neoplasia	0
faba bean	child obesity	0
sweet orange	chronic daily headache	0
raw cranberries	b cell leukemia	0
soda waters	mixed lymphoma	0
coriandrum	udp galactose 4 epimerase deficiency	0
dried foods	postoperative emesis	0
grilled meat	cognitive retention disorders	0
petroselinum crispums	vulvar cancers	0
pithecolobium	temporal region trauma	0
cassia fistula	mad cow diseases	0
carya illinoenses	limb tremors	0
cassia trees	thermal hypesthesia	0
seafood	familial atrial fibrillation	0
arginine-rich foods	female sterility	0
bean sprout	gnathostomiasis	0
dandelion	metastatic cancer	0
açai berry	gastro-oesophageal reflux	0
high-fructose corn	uterine cancers	0
popular fruits	oncogenic viruses	0
ketchup	non-alcoholic fatty liver disease	0
chickpea	early detection of cancer	0
high-fiber food	enzootic bovine leukoses	0
elettaria cardamomum	foreign body	0
origanum onites	rectal neoplasms	0
dried fruits	landry-guillain-barre syndrome	0
saffron	condylomata acuminata	0
mushroom	retained surgical sponges	0
prunus salicina	malignant brain neoplasms	0
pimiento	diabetic neuropathies	0
commercial milk	iddm	0
pumpkin	hemangioblastic meningioma	0
strawberry	eczematous dermatitis	0
morning meals	degenerative neurologic disorder	0
herbal tea	spindle-cell carcinomas	0
morinda	intervertebral disc degeneration	0
favorite meals	cognitive retention disorder	0
foenumgraecum	right-sided heart failure	0
nut bar	disk degradations	0
zedoary zedoarias	rest tremors	0
solanum lycopersicum	metastatic cancer	0
tarragon	rectal cancers	0
spore	visual seizure	0
sweetened cereal	cancer of the tonsil	0
red meat	headache syndrome	0
soup	fatty liver disease	0
oyster mushrooms	rectum cancers	0
pineapple juice	uterine cervical cancers	0
hypericum	multiple head injuries	0
arecas	plasmodium infection	0
betel nuts	xanthomatous meningioma	0
preserved food	brain diseases	0
fig	esophageal hernias	0
syrup	pulmonary diseases	0
sesame seeds	heart attack	0
nutritional yeast	sore throats	0
acer	non alcoholic fatty liver disease	0
fenugreek seed	leukemogenic virus	0
isoglucose	brittle diabetes mellitus	0
macadamia nuts	rheumatoid arthritis	0
oat	legal blindness	0
citron tree	dizziness	0
wheat bran	malignant meningiomas	0
sea bilberry	diabetes complications	0
plant zygotes	ciguatera	0
clathrotropis	cva (cerebrovascular accident)	1
white rice	bladder diseases	0
horsemeat	mastalgia	0
clove	substance use disorder	0
whole grain cereal	hernia	0
juiced broccoli	sliding hiatal hernias	0
sunfish	neurotic anxiety states	0
carbonated drink	early awakening	0
raisin	tonsillar cancer	0
diet	progressive disorder	0
national pork	amyloidose	0
persea americanas	common bile duct gall stones	0
haritaki fruit	familial atrial fibrillations	0
almond butter	sleep wake disorder	0
carrot juice	rectal neoplasm	0
lentil	male sexual impotence	0
whole grain cereals	post-traumatic osteoporosis	0
meal time	insomnia	0
pleurotus ostreatus	disc degradations	0
sea food	hypesthesia	0
low vitamin	thrombus	0
okra	heart failure	0
own vitamin	appendicitis	0
caramel	memory disorders	0
tempeh	human mammary neoplasms	1
include apples	brain diseases	0
rose berries	fibromyositis fibromyalgia syndrome	0
garden radish	carotid sinus syncope	0
gmo soybeans	symptom cluster	0
cocoa plants	osteoarthritis	0
indian laburnums	exanthem	0
pea	intraventricular meningioma	0
cola	small non-cleaved-cell lymphoma	0
grouper	fusiform aneurysms	0
flavourer	galactokinase deficiency diseases	0
infects apples	burkitts lymphoma virus	0
lycium	bladder diseases	0
hibiscus cannabinus	chronic fatigue-fibromyalgia syndromes	0
soy bean proteins	epithelial cancer	0
deli meats	rectum neoplasm	0
sweetleaf	steatosis of liver	0
filbert	congenital myxedema	0
cherry	benign prostatic hyperplasia	0
corn oil	iron deficiency	0
bilberry	zoonotic diseases	0
cucurbita	aortic aneurysms	0
energy drink	dental fluoroses	0
cleistocalyx	cancer of the pancreas	0
cupcake	eczematous dermatitides	0
dark chocolate	migratory pains	0
pizza	breast carcinoma	0
plant-based nutrients	schilling-type myeloid leukemia	0
wild celery	mammary cancer	0
kava kava	seizure disorder	0
chinese cassias	gnathostomiase	0
marsh mallow	deep venous thromboses	0
wheat	chronic b-cell leukemia	0
maguey	male impotence	0
plum trees	infectious mononucleosis virus	0
humulus lupulus	eye diseases	0
cola acuminata	preinvasive carcinoma	0
triticum vulgare	mental disorder	0
kava kavas	pediatric cancers	0
ilex paraguarienses	precordial catch	0
actual fruit	drug habituation	0
pleurotus	polyarthritide	0
paella	vaginitis	0
cumin	cephalgia syndromes	0
acacia tree	penis cancer	0
tobacco	adenomatous polyp	0
antioxidant-rich foods	muscle disease	0
table salt	cancer of bone	0
dairy eggs	xanthomatous meningioma	0
wild yams	syncopal episode	0
oxen meat	androgenetic alopecia	0
kenaf	celiac disease	0
food supplements	benign brain neoplasm	0
fat foods	endocrine breast disease	0
hibiscus sabdariffa	fibroid	0
red cabbage	gall bladder diseases	0
dioscorea polystachya	myelomatosis	0
olive family	alopecia	0
margarine	polyarthritide	0
grape	nanism	0
ribes nigrum	generalized headache	0
papaver	secretory meningiomas	0
lycium chinense	fighting cancer	0
bran flakes	malignant epithelial tumors	0
aloe	cerebrovascular accidents	0
healthy food	nausea	0
carbonated water	brain tumors	0
elettaria	ph1-negative myelogenous leukemia	0
coca cola	crushing skull injuries	0
licorice root	lymphoma	0
marihuana	toxico infectious botulism	0
frying meat	chromosome 6-linked autosomal recessive parkinsonism	0
ocimum basilicum	olfactory groove meningiomas	0
edible grain	delusory parasitoses	0
tea	prostatic intraepithelial neoplasia	0
narrow-leaved plantains	plasmodium infection	0
avoid peanuts	itch	0
plant-based foods	male infertility	0
tepary beans	foodborne disease	0
oreo	papillary meningiomas	0
tomato juice	parkinson disease	0
placenta	age related macular degeneration	0
milk thistle	myelopathy	0
solanum dulcamaras	vestibular seizure	0
big food	galactose epimerase deficiency	0
handling meat	serious disease	0
calendula officinalis	charcot disease	0
coffee	avitaminose	0
squashe	tongue cancers	0
beetroot	syncopal vertigos	0
mangosteen	inflammatory bowel disease	0
coconut oil	acquired immunodeficiency syndromes	0
retail meat	wheat allergy	0
raphanus sativus	steatohepatitide	0
citrus medicas	malignant epithelial tumor	1
medicago sativa	cervical migraine syndrome	0
offal	adenomatous polyps	0
leguminosae	acute autoimmune neuropathy	0
soda pops	mixed-cell lymphomas	0
hibiscus tea	crushing pains	0
vicia fabas	foodborne diseases	0
vegetable juices	fibromyositis-fibromyalgia syndromes	0
ground beef	thrombose	0
kola nut	human mammary carcinomas	0
ginger ale	bses (bovine spongiform encephalopathy)	0
dried fruit	paraesophageal hernias	0
musa	cretinism	0
healthiest nuts	joint pains	0
carbonated mineral water	cognitive impairments	0
foie gras	guillain barre syndrome	0
including cloves	jaundice	0
natural vitamin	minor head injury	0
healthy foods	precordial catch syndrome	0
stem vegetables	lung cancers	0
cayenne pepper	psychogenic parasitosis	0
cooked carrots	polymyositis ossificans	0
cooking meat	acute cerebrovascular accidents	0
regular carrots	undifferentiated carcinoma	0
euterpe oleracea	todds paralysis	0
prunis communis	a v dissociation	0
cookie	precordial catch syndrome	0
juglans nigra	different cancer	0
sunflower seeds	macular degeneration	0
density foods	polyradiculoneuropathy	0
kidney beans	adenovirus	0
fast foods	creutzfeldt-jakob syndrome	0
new york coalition for healthy school food	campylobacter infections	0
ganja	rectum neoplasm	0
erythroxylon	preventable cancers	0
shiitake	skin disease	0
food allergy	constrictive bronchiolitides	0
domestic fowl	skin neoplasm	0
green teas	fibroid	0
baked potato	degenerative neurologic disorder	0
fenugreek	pustulosis palmaris et plantaris	0
cannabis sativas	iodine deficiency	0
brown sugar	hemangiopericytic meningioma	0
thymus plant	intervertebral disc degeneration	0
elettaria cardamomums	age-related bone losses	0
assai palm berry	renal failure	0
vaccinium macrocarpons	cll lymphoplasmacytoid lymphomas	0
blackberry	iddm	0
powdered ginger	breast fibrocystic disease	0
sea vegetables	age related memory disorders	0
flounder	arthritide	0
term vegetable	ovary cancer	0
cinnamomum aromaticum	heat stroke	0
cruciferous vegetables	v cjd (variant creutzfeldt jakob disease)	0
cicer arietinums	fibroid tumor	0
citrus aurantiums	preterm births	0
fabaceae	small cleaved cell lymphoma	0
banana plant	nerve tremor	0
warm milk	reticulosarcoma	0
spinacia oleracea	migratory pain	0
brussel sprout	primary growth hormone resistance	0
big apples	psoriase	0
moose meat	intervertebral disc degeneration	0
sour orange trees	brain benign neoplasms	0
prosopis	radiating pain	0
zea mays	female sterility	0
delonix	rabies virus	0
chewed coca	vulva cancers	0
english walnuts	spindle cell carcinoma	0
century plant	cjd (creutzfeldt-jakob disease)	0
salami	skin cancers	0
andean blackberries	substance-induced organic mental disorders	0
plant embryos	udpglucose hexose-1-phosphate uridylyltransferase deficiency	0
healthiest beverage	breast fibrocystic change	0
red onions	pituitary dwarfism iis	0
lemon	migraine disorders	0
avena	pseudotumor cerebri	0
ovary	coarse tremors	0
nicotiana tabacum	hyperpigmentation	0
chanterelle	reticulum cell sarcoma	0
saccharomyces cerevisiae	retained surgical item	0
mangifera indica	breast malignant tumors	0
weed	myocardial ischemias	0
health nuts	microcystic meningiomas	0
aspalathus	mptp-induced experimental parkinsonism	0
peach	lymphadenopathy-associated viruses	0
red peppers	acute inflammatory polyradiculoneuropathies	0
ground flax	psychotic disorder	0
phaseolus	colitis gravis	0
anise tea	diffuse small cleaved-cell lymphoma	0
curry powder	congestive heart failure	0
wild celeries	respiratory tract infections	0
cranberry juice	rest tremors	0
sour cream	colorectal neoplasms	0
açaí berries	somatotropin hypersecretion syndrome (acromegaly)	0
sugar substitutes	pancreatic neoplasm	0
melissa officinalis	breast disease	0
prettiest fruit	drug use disorders	0
granny smith	aphthae	0
exotic fruit	utp-hexose-1-phosphate uridylyltransferase deficiency disease	0
bertholletia	atypical chronic myeloid leukemia	0
pinto bean	degenerative neurologic disorders	0
tumeric	anxiety disorder	0
black pepper	acute fulminating multiple sclerosis	0
acai berries	constrictive bronchiolitides	0
daily nut	oxygen deficiency	0
dioscorea opposita	zoonotic diseases	0
cooked broccoli	single seizure	0
collard greens	kidney disease	0
sockeye salmon	mammary cancer	0
raw food	seizure disorder	0
pumpkin pie	phlebothrombosis	0
black walnut	neoplasm metastases	0
cacao	t virus	0
bolete	zoonotic infectious disease	0
tea leaves	stomatognathic disease	0
assai palm	multiple head injuries	0
common foxgloves	anxiety disorders	0
willow tree	gossypiboma	0
official vitamin	familial atrial fibrillation	0
tuna	scorbutus	0
cassia cinnamon	epithelial cancers	0
raw poultry	rectal tumors	0
mother cells	heart blocks	0
acer negundos	fibromyositis fibromyalgia syndrome	0
purple potatoes	kidney stone	0
chlorella	dementia with amyotrophic lateral sclerosis	0
english walnut	cancer of the uterine cervix	0
squash plants	mental deterioration	0
soya milk	male pattern baldness	0
macadamia nut	phlebothrombosis	0
dietary plant proteins	igf-1 deficiency	0
roselle	cancer of the testes	0
cocos nuciferas	confusional states	0
chicken salad	todd paralysis	0
chamomile oil	toxic megacolon	0
salt-free diet	chronic fatigue disorders	0
tv dinners	retroviridae	0
seville orange trees	benign brain neoplasms	0
arugula	hay fever	0
low-salt diet	inflammatory polyneuropathy acutes	0
cymbopogon	different cancer	0
pistacia	gestational diabetes	0
milkshake	severe congenital microcephaly	0
kaffir lime	familial creutzfeldt-jakob diseases	0
yeast rice	neoplasm metastases	0
carbonated beverages	prostate disease	0
solanum tuberosum	gehrig disease	0
soy bean curd	leanness	0
vaccinium ashei	renal neoplasm	0
collard green	central obesity	0
allium porrum	human mammary neoplasm	0
maple syrup	halitosis	0
olive oil	benign essential tremor	0
rye	udp-galactose-4-epimerase deficiencies	0
common olive tree	vulvar neoplasms	0
navy beans	lou gehrig disease	0
cucumis melo	meningioma	0
sesame oils	acute inflammatory polyradiculoneuropathies	0
weekly meat	overeat	0
low meat	hemangioblastic meningioma	0
vicia faba	bladder neoplasm	0
caffeinated coffee	parkinsonism	0
animal food	autosomal recessive juvenile parkinsonism	0
diospyros digyna	pregnancy pernicious vomiting	0
chewing gums	thrombus	0
aubergine	gestational diabetes	0
rooibo	male infertility	0
cow's milk	cjd (creutzfeldt jakob disease)	0
ficus	mastitis	0
soy protein	oxygen deficiencies	0
holy basil tea	barretts esophagus	0
processed food	decreased cancer	0
lens plants	secondary fibromyalgias	0
malabar nut	pneumonitis	0
wort	marie struempell disease	0
glycyrrhiza	female infertility	0
cultivated oats	arrythmia	0
dessert	intracranial cns disorders	0
cultivated oat	iddm	0
fava bean	cephalgia syndromes	0
solanum dulcamara	amnestic state	0
indian corn	mechanical low back pain	0
lipomul	vaginal cancers	0
pepsi	mixed small and large cell lymphoma	0
feather meal	tactile hypesthesias	0
cereal grain	limb cramp	0
chamomile tea	stokes adams syncope	0
snacktime	benign meningiomas	0
antioxidant food	orthostatic headaches	0
canned foods	peripheral artery disease	0
chewing gum	hemicrania migraine	0
mustard seeds	cataract	0
carica papaya	appendicitis	0
shan yao	diffuse undifferentiated lymphomas	0
hickory nuts	intermediate-grade lymphoma	0
green peppers	prostatic intraepithelial neoplasms	0
andira	galt deficiencies	0
jambolan plum trees	pancreas cancers	0
rheum officinale	generalized spasm	0
split peas	degenerative neurologic disorders	0
pickled foods	increase cancer	0
bagel	infectious mononucleosis viruses	0
green beans	hemangioblastic meningioma	0
baby carrots	seizure disorders	0
flavoring	peripheral arterial disease	0
amomum cardamomum	elevated cholesterols	0
artificial sweeteners	endometrial cancer	0
happy meal	gastroesophageal reflux	0
prunus amygdalus	tonic-clonic seizure	0
açaí berry	severe congenital microcephaly	0
monitoring food	autosomal recessive juvenile parkinsonism	0
include fennel	hemicrania migraines	0
myristica fragran	human t cell lymphotropic virus type iii	0
jalapeno peppers	stroke	0
fungus	nerve tremors	0
real chocolate	esophageal neoplasms	0
fagopyrum esculentum	mental deteriorations	0
nut butter	colon disease	0
sesame	fibroadenoma	0
eugenia jambos	utp-hexose-1-phosphate uridylyltransferase deficiency disease	0
dressing	substance abuse	0
texturized soy proteins	cancer of brain	0
beverage	paratuberculosis	0
dog rose berries	cardiovascular stroke	0
pancake	v-cjd (variant-creutzfeldt-jakob disease)	0
ribe	severe congenital microcephalies	0
norus	autosomal dominant. juvenile parkinson disease	0
cured meats	autoimmune diseases	0
amomum cardamomums	cerebrovascular accident	0
golden glow	intertrochanteric fractures	0
soy bean curds	brain tumor	0
candy bars	cephalodynia	0
citrus maxima	hemorrhoid	0
baby formulas	frontal region trauma	0
cocoa powder	superficial head injuries	0
endive	esophagus cancer	0
bread mold	age-related osteoporosis	0
measuring food	orthostasis	0
pea family	temporal region trauma	0
mastictree	ankylosing spondylarthritis	0
dietary proteins	anoxemia	0
syzygium malaccense	pharyngitide	0
lactuca sativa	arterial dysfunction	0
kavas	bovine leukoses	0
pistacia vera	strain	0
gooseberry	alactasia	0
frozen fruit	high blood pressure	0
beta vulgaris	amnesia-memory losses	0
radish	voice box cancer	0
suggesting apple	cerebral convexity meningiomas	0
nonus	epithelial cancer	0
soy food	passive tremors	0
yoghurt	age related osteoporosis	0
andropogon nardus	inflammatory diseases	0
gum acacia	wart	0
new vitamin	fusiform aneurysm	0
onion	premenstrual syndrome	0
artificial sweetener	schilling-type myeloid leukemia	0
cortland	mixed lymphocytic-histiocytic lymphomas	0
citron trees	multiple myositis	0
dietary fat	creutzfeldt jakob syndrome	0
sprout	encephalopathy	0
squash plant	osteoarthrose	0
thymus plants	vaginal cancers	0
cantaloupe	breast cancer	0
cannabis sativa	lichen planus	0
sesame oil	vaginitis	0
yerba mates	ketosis-prone diabetes mellitus	0
chinese cinnamon	resting tremors	0
oryza	essential tremors	0
pea families	iron deficiency	0
legume family	fights cancer	0
flax seed	hepatic cancers	0
contamination meat	non-hodgkins lymphoma	0
bottled water	tumor virus	0
saffron crocus	epstein barr virus	0
fenugreek seeds	crushing pain	0
brown rice	premenstrual syndromes	0
sweet marjoram	paraesophageal hernia	0
cinnamon	nonalcoholic fatty liver	0
steamer	cancer of the prostate	0
milk thistles	insulin sensitivity	0
white mallow	prostatic adenoma	0
garlic	colonic inertia	0
apple juice	pseudotumor cerebri	0
food and drug administration	fibrositis	0
eragrostus	barrett esophagus	0
hemp plants	brain cysticercosis	0
brassica	breast carcinoma	1
illicium anisatum	barrett epithelium	0
blueberry	proliferative bronchiolitis	0
roughage	respiratory tract infections	0
arachis hypogaea	spinal cord degenerative diseases	0
whole grain	low-grade b-cell malignancy	0
organic milk	childhood obesity	0
peanut butter	varicose vein	0
fed beef	ciguatera poisonings	0
chinese yam	diabetes-related complications	0
texturized soy protein	cervical migraine syndrome	0
burrito	megacolon	0
soy yogurt	avitaminose	0
digitalis	ache	0
broad beans	gehrig disease	0
ale	phlebothrombosis	0
seed	phlebothrombosis	0
euterpe oleracea mart.s	mouth and tooth diseases	0
citrullus	male pattern alopecia	0
bt corn	small noncleaved cell lymphoma	0
shorten	burkitts lymphoma virus	0
sea bilberries	female sub-fertility	0
barberry	female sub-fertility	0
drinking coffee	ph1 negative myeloid leukemia	0
neutraceutical	kidney diseases	0
lycium barbarum	biliary calculi	0
tachigalia	liver dysfunction	0
cocoa	primary brain tumor	0
nut butters	primary malignant brain neoplasms	0
pimenta officinali	dermatozoic delusion	0
salmonella-infected eggs	memory losses	0
cinnamomum trees	tongue neoplasm	0
ocimum tenuiflorum	central nervous system cysticercosis	0
ananas	intermediate grade lymphoma	0
star anises	anal ulcers	0
gala apples	cystic disease of breast	0
myristica fragrans	hormonal dysfunction	0
sweet peppers	brain vascular accidents	0
poultry products	hhv-4	0
ephedras	central nervous system intracranial disorders	0
study lavender	high cholesterol levels	0
common plant	galactokinase deficiency	0
antioxidant-rich food	suppuration	0
high fructose corn syrup	pulmonary inflammations	0
cymbopogon nardus	venous thromboses	0
atropa belladonnas	inflammatory bowel disease 1	0
healthiest apple	fever	0
mock meats	uterine neoplasms	0
liquorice	brain neoplasm	0
pummelo tree	airsickness	0
currant	cataract	0
daucus carota	acute inflammatory polyneuropathies	0
st. johnswort	burkitts lymphoma virus	0
breakfast	landry guillain barre syndrome	0
pummelo trees	hepatic cancer	0
purple cabbage	visceral obesity	0
miso	galactose epimerase deficiency	0
avenas	cholera	0
leaf lettuce	relapse	0
emphasizes vegetables	hortons syndrome	0
black raspberries	schizophreniform disorder	0
tisane	pulmonary inflammation	0
areca	non-epileptic convulsions	0
cuminum cyminum	chronic pain	0
agave	chronic fatigue-fibromyalgia syndromes	0
convenience foods	polyarthritide	0
apium graveolens var. rapaceum	recurrent brain tumor	0
anti-inflammatory plant	malignant primary brain neoplasms	0
crataegus monogynas	pneumonitis	0
spaghetti	cerebrovascular strokes	0
ready-to-eat meals	hemicrania migraine	0
dioscorea villosa	chronic daily headache	0
osmanthus tea	pill rolling tremor	0
rheum	testis neoplasm	0
paprika	ramsay hunt paralysis syndrome	0
garcinia mangostanas	insulin resistance	0
carob	guillain-barré syndrome	0
ultra-processed food	early detection of cancer	0
apricot	cystic breast disease	0
nitrate-rich vegetables	viral hepatitis	0
baker's yeast	infertility	0
ultra-processed foods	crushing skull injury	0
black rice	blood cancers	0
drinking tea	brain malignant neoplasms	0
cabbage	birth weights	0
swiss chard	acute infectious polyneuritis	0
lettuce	indigestion	0
turmeric root	human mammary carcinoma	0
healthiest beverages	food-borne disease	0
celery	massive tremors	0
energy drinks	vaginal discharges	0
food supplement	infantile colic	0
white mallows	bacterial vaginoses	0
bhang	occipital trauma	0
java plum tree	action tremors	0
cooking oil	preventable cancers	0
good soybeans	severe mental disorders	0
bread	udp-galactose-4-epimerase deficiency disease	0
areca catechu	lactose malabsorption	0
sweet marjorams	hay fever	0
prunus cerasifera	prion induced disorder	0
triticum aestivum	necrotizing fascitis	0
sugar maples	memory disorders	0
empty calorie foods	generalized seizure	0
goiaba	sleep wake disorder	0
green pepper	colic	0
eating fruits	proteinuria	0
lunch time	autosomal recessive juvenile parkinsonism	0
toxic plants	diffuse lymphocytic lymphoma	0
peanut	progressive disorder	0
use sweeteners	plegia	0
breakfast cereals	stomatognathic disease	0
frequent meals	obesity	0
billion eggs	premature births	0
chili peppers	age-related maculopathies	0
toronja	encephalon disease	0
so-called vegetable	ciliary body spasm	0
gravy	pneumonitis	0
bok choy	paratuberculose	0
vital nutrients	cognitive impairment	0
food company	plasmodium infections	0
nettle	lung inflammations	0
nut	corpse	0
opium poppy	widespread chronic pain	0
rooibos	hypersensitivity	0
high-fat meal	transmissible spongiform encephalopathy	0
rheum rhaponticum	heart block	0
sweet potatoes	contusion	0
boiled broccoli	pancreas neoplasms	0
sauerkraut	feline leukemia virus	0
dioscorea	age-related maculopathies	0
acer saccharum	nonalcoholic fatty liver	0
ready soybeans	acute cerebrovascular accidents	0
rabbit meat	human influenzas	0
national meat	prostatic hypertrophy	0
poppy seed	olfactory groove meningiomas	0
citrus grandi	drug use disorders	0
nut bars	chronic infectious mononucleosis-like syndrome	0
added sweeteners	stomach cancer	0
lima beans	single seizure	0
lemon balms	neurodegenerative disorder	0
capparis	non-hodgkin's lymphoma	0
sugar maple	emesis	0
wisconsin milk	high-grade lymphomas	0
pimenta diocias	age related maculopathies	0
lemon balm	head injury	0
trigonella	enterocele	0
celery root	pancreatic cancer	0
unhealthy food	aneurysm	0
amorpha	recurrent brain tumor	0
curcuma longa	prostatic adenomas	0
sun-dried raisin	air sickness	0
garbanzo	age-related maculopathy	0
earl grey tea	acute inflammatory demyelinating polyneuropathy	0
poultry meat	cancer of esophagus	0
chile peppers	sore throat	0
malabar-nut	gestational diabetes	0
incorporates cloves	gallbladder diseases	0
nuclear power plants	paraesophageal hiatal hernia	0
laciniate nightshade	deep-vein thromboses	0
afzelia	b cell chronic lymphocytic leukemia	0
breast milk	kidney diseases	0
sweeten	esophageal neoplasms	0
specific nuts	oncornavirus	0
cuminum cyminums	acne vulgaris	0
milk chocolate	manic state	0
chai tea	aortic aneurysm	0
euterpe edulis	spondyloarthritis ankylopoietica	0
raspberry	mouth neoplasm	0
syzygium cumini	small lymphocytic lymphoma	0
dried pomegranate	dental disease	0
durum wheats	acute inflammatory polyradiculoneuropathy	0
eugenia malaccensis	guillaine-barre syndrome	0
little meat	infectious diseases	0
prenatal vitamins	neoplasm	0
fast food	kahler disease	0
seltzer water	endometrial neoplasm	0
vitamin pills	hereditary galactokinase deficiencies	0
salsa	sleeplessness	0
food additives	tumorigenesis	0
mentha spicatas	tongue neoplasm	0
plant capsules	hysterical amnesias	0
monosodium glutamate	colorectal cancers	0
eat chocolate	chronic b cell leukemia	0
safflower oils	upper respiratory infections	0
unrefined plant	irritable colon	0
dried apples	deep vein thromboses	0
fagopyrum tataricum	pancreas cancer	0
ice creams	gnathostoma infections	0
saint john's wort	muscle soreness	0
powdered sugar	guam form of amyotrophic lateral sclerosis	0
oyster mushroom	infant botulism	0
last meal	cryptogenic epilepsy	0
convenience food	amnestic state	0
black currant	intracranial cns disorder	0
citrus aurantium	itch	0
mayo	craniocerebral traumas	0
olive oils	pseudocoma	0
blossom	viral diseases	0
taro	small-cell lymphomas	0
citrus sinensis	heart attacks	0
origanum	cardiogenic syncope	0
raphanus	craniocerebral trauma	0
walnut oil	human t-cell leukemia virus type iii	0
deli meat	tonsillar cancer	0
french bean plants	gynecomastia	0
piper methysticums	sub-fertility	0
golden delicious	uterine fibromas	0
vegetable oil	human papillomavirus virus	0
baptisia	tumorigenese	0
whiting	dyspepsia	0
drug administration united states food	cataract	0
poenumgraecum	angioblastic meningiomas	0
celebration meal	hypermelanosis	0
pithecellobium	leukemogenic virus	0
alpine strawberry	somatotropin (acromegaly) hypersecretion syndrome	0
cycad	brain cancers	0
grapefruit	oncovirinae	0
portulaca oleraceas	chronic airflow obstructions	0
wolfberry	cognitive dysfunction	0
purine-rich plant	skin cancers	0
almond tree	retroviridae	0
alcohol	congenital myxedema	0
larder	amyloidose	0
arachis	painful menstruation	0
dietary plant protein	sliding hiatal hernia	0
jam	ankylosing spondylarthritis	0
buttermilk	nevoid basal cell carcinoma syndrome	0
kale	cancer of breast	1
holy basil	influenza	0
pistachio	barrett metaplasia	0
eggplant	cardiovascular strokes	0
coriandrum sativum	brain neoplasm	0
calling eggs	uterine fibromas	0
individual food	autistic disorders	0
adding blueberries	malignancy	0
pistacia lentiscus	breast malignant neoplasms	0
fruit juices	global amnesias	0
citrus	back pains	0
spinach	neurodegenerative disorder	0
fennel seeds	serious disease	0
avocado	situational syncopes	0
eating meat	myeloma multiple	0
herb	forehead traumas	0
machaerium	abdominal obesities	0
lemon grasses	sudden cardiac arrests	0
sea vegetable	renal cancer	0
maize syrup	tonsil cancer	0
vitis vinifera	convulsive syncopes	0
beer	zoonosis	0
digitalis lanata	huntington’s disease	0
molasse	hiccup	0
fake meat	non-b hepatitis enterically-transmitted non-a	0
solanum melongenas	early diagnosis of cancer	0
hemp	tonic-clonic seizures	0
pyrus	degenerative arthritides	0
lime	iddm	0
nettle tea	psoriasis	0
raw tomatoes	endometrial cancers	0
romaine lettuce	toxico-infectious botulism	0
rubberplant	fatty liver	0
soy beverage	hemangioblastic meningioma	0
althaea officinalis	diabetic neuropathy	0
chocolate bars	cardiovascular strokes	0
dietary supplements	salami brusher's disease	0
allspice	sea sickness	0
hickory nut	generalized spasm	0
zingiber officinale	galt deficiency	0
pureed apples	sunburn	0
no-calorie sweeteners	vertebrogenic pain syndrome	0
fennel	malaria	0
chili	acute confusional migraine	0
mashed potatoes	schilling type myeloid leukemia	0
unfiltered coffee	leucocythaemia	0
curcuma zedoarias	parkinsonian syndrome	0
star anise	birth weights	0
maize	migratory pain	0
sugar water	bone cancer	0
red pepper	fibromyalgia fibromyositis syndrome	0
lard	ovary cancers	0
flowering shrub	single seizure	0
petroselinum crispum	basal cell epithelioma	0
crunch berries	hereditary galactokinase deficiencies	0
saint john wort	psammomatous meningiomas	0
purslane	infantile autism	0
intoxicant	age related maculopathy	0
humulus	cryptogenic epilepsy	0
dinner	coarse tremors	0
high-phytate foods	primary brain neoplasm	0
amla	delusional parasitosis	0
marijuana	generalized spasms	0
oats	cerebral strokes	0
althaea	macular degeneration	0
acai berry	benign neoplasms	0
citrus limon	iddm	0
mint tea	asthma	0
dietary supplement	human influenzas	1
coconut	mammalgia	0
barley	inappropriate growth hormone secretion syndrome (acromegaly)	0
noncaloric sweetener	gastric ulcer	0
belladonna	galactose-1-phosphate uridylyltransferase deficiency	0
big meals	diabetes complication	0
carbonated mineral waters	drug allergy	0
anise	peripheral demyelinating autoimmune disease	0
eupatorium rebaudianum	premature births	0
jasmine tea	pneumonitide	0
syzygium aromaticum	circulatory failure	0
adhatoda vasica	cerebrovascular accidents	0
food poisoning	occipital traumas	0
oregano	intervertebral disc degeneration	0
food manufacturers	small cleaved-cell lymphoma	0
romaine	motor seizure	0
red lentils	periodontal disease	0
vitis	non-hodgkin lymphoma	0
crataegus	testis neoplasm	0
coriander	fibrosis	0
black coffee	tonic clonic seizures	0
cider vinegar	lou gehrig's disease	0
ceylon cinnamon	posterior fossa meningioma	0
theobroma cacao	deep venous thromboses	0
lens culinaris	breast pain	0
euterpe	hereditary galactokinase deficiency	0
raphanus raphanistrum	pancreas neoplasm	0
sweet almond	malignant brain neoplasms	0
linum usitatissimums	mixed-cell lymphomas	0
drinking milk	spiral fractures	0
eugenia aromatica	testicular neoplasms	0
texturized vegetable protein	cognitive impairment	1
pimenta	sleep initiation and maintenance disorders	0
spice turmeric	avitaminosis	0
mesquite	hiatal hernia	0
trace minerals	hiatal hernia	0
citrus aurantiifolia	phlebothrombose	0
molasses	epithelial cancers	0
diabetic diet	hypoxemia	0
chenopodium quinoa	delusory parasitosis	0
bibhitaki fruit	polymyositide	0
fresh meat	mastitis	0
soy beverages	inflammatory diseases	0
gui zhi	cervicitis	0
teosinte	botulism	0
dried cranberries	experimental lung inflammations	0
colocasia	e-b virus	0
berberis	leanness	0
seltzer waters	blood clots	0
rose	intraepithelial carcinoma	0
alcoholic beverage	fetal iodine deficiency disorder	0
rutabaga	breast cystic disease	0
olive trees	membranous cataracts	0
thymus vulgaris	atrial fibrillations	0
plant embryo	physical anhedonia	0
hazelnut	basal cell carcinoma	0
decaffeinated tea	polyradiculoneuropathy	0
handling food	udpglucose 4 epimerase deficiency disease	0
squid	senile paranoid dementia	0
veggie	alzheimer’s disease	0
dried yeast	crib death	0
horse beans	atheromatous plaques	0
lavandula angustifolia	regional ileitis	0
fragaria	seizure disorder	0
justicia	cat leukemia viruses	0
curcuma zedoaria	head injury	0
prosopi	galactosemia	0
phyllanthus emblica	vaginal discharges	0
target vitamin	wheat hypersensitivity	0
pork	tonsillar cancer	0
dried blueberries	varicose vein	0
pimenta officinalis	small lymphocytic lymphoma	0
marjoram plant	premenstrual syndrome	0
carica papayas	cervix neoplasms	0
anacardium	rna tumor viruses	0
narrow leaved plantain	brain cancer	0
fatty foods	arthritide	0
mangifera	convulsive syncopes	0
corn sugar	plasma cell myeloma	0
anticancer plant	bacterial vaginosis	0
snack	familial diffuse gastric cancer	0
tulsi tea	intractable headache	0
chewing fruit	paraesophageal hernias	0
chocolate	carcinoma in situ	0
pumpkin seeds	occipital region traumas	0
soda water	osteoarthritide	0
decrease meat	brain disorders	0
cassia fistulas	malignant meningioma	0
healthier meat	plasma-cell myeloma	0
collard	diabetic polyneuropathy	0
dietary fats	joint pains	0
daily fruit	familial tremor	0
fava beans	granulomatous enteritis	0
entree	b12 deficiency	0
black beans	bipolar affective psychoses	0
food additive	rhabdomyolys	0
kiwi	hypoxemia	0
hickory tree	johne's disease	0
pecan trees	intracranial cns disorder	0
wild radish	sciatic neuralgia	0
chile pepper	alactasia	0
ice cream	cervix neoplasm	0
swordfish	hair loss	0
seven nutrients	copd	0
vitamin	prostatic neoplasm	1
soy bean	fibroatheromatous plaque	0
olive tree	cognitive dysfunctions	0
sausage	rabies	0
healthy nuts	bladder tumor	0
linseed	osteoporose	0
ready-to-eat meal	skin neoplasms	0
processed meat	passive tremors	0
texturized vegetable proteins	obesity in childhood	0
wine	infant botulisms	0
cruciferous vegetable	nervous system degenerative diseases	0
narrow-leaved plantain	anthrax	0
orange juice	pharyngitide	0
cardamom	aphthous stomatitis	0
java plum trees	syncopal episodes	0
silybum marianums	continuous tremors	0
cheese	anaplastic carcinoma	0
inadequate fruit	plasma cell myelomas	0
squash	female sub fertility	0
milk	postoperative emesis	0
bacon	lav-htlv-iii	0
blueberry plant	craniocerebral injuries	0
triticum turgidum subsp. durum	myelomatosis	0
nutriceutical	sprain	1
chinese cassia	paraesophageal hernias	0
chia seeds	cat leukemia virus	0
hordeum	static tremors	0
solanum melongena	episodic cluster headaches	0
solanum laciniatums	lewy body parkinson disease	0
different fruits	bovine leukosis	0
açai berries	congenital myxedema	0
table sugar	gout	0
vaccinium uliginosum	guillaine-barre syndrome	0
sticker	deep-vein thrombosis	0
fruit and vegetable juices	syndrome	1
english plantains	headache disorder	0
bean sprouts	cognitive decline	0
rheum tanguticum	intervertebral disk degeneration	0
ginger	kidney cancers	0
granny smith apples	head traumas	0
celeriac	diabetic mononeuropathies	0
vaccinium macrocarpon	angioblastic meningioma	0
persea americana	influenza in humans	0
component spices	pernicious vomiting of pregnancy	0
marsh mallows	jakob-creutzfeldt syndrome	0
nutrient-dense foods	memory losses	0
emphasize plant	female pattern baldness	0
areca catechus	small non-cleaved-cell lymphomas	0
neu5gc-rich food	limb cramps	0
cayenne	meningotheliomatous meningioma	0
carrot	secondary fibromyalgias	0
restrict food	parasagittal meningiomas	0
iceberg lettuce	recurrent brain tumor	0
plant capsule	granulomatous enteritis	0
curried tofu	galactose 1 phosphate uridyl transferase deficiency disease	0
punica granatum	hansen's disease	0
peppermint oil	cluster headache syndrome	0
dried apricots	migraine headache	0
oregano plant	acquired blindness	0
find pork	early awakening	0
milk protein	chronic diseases	0
trigonella foenum-graecum	short sleeper syndromes	0
know nuts	feline lymphoma viruses	0
asparagus	juvenile parkinsonisms	0
hot sauce	postoperative emesis	0
sweet almonds	common bile duct calculi	0
eating food	body weights	0
halibut	nonorganic insomnia	0
laciniate nightshades	heart diseases	0
family vegetables	diabetic neuralgias	0
fatty meal	infant gynecomastia	0
pickled vegetables	gall stone	0
citrus medica	heart blocks	0
rosa	bovine leukemia	0
largest meal	breast fibrocystic changes	0
iv vitamin	lung inflammation	0
fagopyrum sagittatum	kidney neoplasm	0
almond oil	uterine neoplasm	0
crab apples	tick bites	0
cashew	arthropathy	0
curcuma	non-hodgkin's lymphoma	0
concord grape	penile neoplasm	0
healthy snacks	hepatocellular cancer	0
fuji apples	stokes-adams syncope	0
french bean plant	polyarthralgia	0
chinese rhubarb	lou gehrig's disease	0
alfalfa sprouts	chronic b-cell leukemias	0
cannabi	prion protein disease	0
woodland strawberries	mucous colitides	0
california avocado	jakob-creutzfeldt disease	0
club sodas	bovine leukoses	0
prunus persica	light headedness	0
golden delicious apples	dna injury	0
hot pepper	substance use disorders	0
soy foods	symmetric diabetic proximal motor neuropathy	0
carbonated waters	lumbago	0
malus	skin disease	0
recommend tea	chronic insomnia	0
treat	senile osteoporoses	1
antioxidant vitamin	thyroid cancer	0
mangifera indicas	joint disease	0
unfertilized eggs	obesity	0
pinto beans	migraine	0
brewed coffee	syncopal episodes	0
drinking water	intermediate grade lymphoma	0
citrus bergamias	blindness	0
bitter orange trees	pharyngitide	0
majorana hortensis	near-death experience	0
ocimum basilicums	gerd	0
brassica nigra	hereditary galactokinase deficiencies	0
lemon balm tea	painful diabetic neuropathies	0
plantago seed	kidney insufficiency	0
lemon tree	colorectal carcinomas	0
salmonella food	epithelioid sarcomas	0
health food	chronic headache	0
meal times	fibromyositis fibromyalgia syndrome	0
dinner times	persistent tremor	0
caryophyllus	colorectal tumors	0
actual licorice	bacterial vaginosis	0
pine nuts	coronary disease	0
venison	syncopal episodes	0
hop	blood cancers	0
laudable legume	infant botulisms	0
nutraceutical	hansens disease	0
corylus	pustulosis palmaris et plantaris	0
flavorer	fatty liver	0
almond milk	arthropathy	0
squash seeds	breast carcinomas	0
pimpinella	amnestic states	0
syzygium sandwicense	prostate neoplasms	0
aloe vera	study cancer	0
organic plants	hereditary galactokinase deficiencies	0
caryophyllus aromaticus	spondylarthritis ankylopoietica	0
contaminated meat	acquired immunodeficiency syndromes	0
chamomile oils	celiac disease	0
safflower	ovary cancers	0
fresh ginger	ekbom psychogenic parasitosis	0
dietary sugars	dementia praecox	0
bitter orange tree	cva (cerebrovascular accident)	1
cod	tongue neoplasm	0
acid-binding vegetables	physical anhedonias	0
multivitamin	retro ocular headache	0
portulaca oleracea	faint	0
olea	limb cramps	0
root	human papilloma virus	0
citrus reticulata	obesity in adolescence	0
cucumis sativus	endometrium cancers	0
goji berry plant	hemolytic jaundice	0
goji berries	infant botulisms	0
hydroponic basil	saccular aneurysm	0
goji berry plants	higher cancer	0
dairy yogurt	muscle spasm	0
sugar	spiral fractures	0
frier	drug use disorder	0
cicer	diarrhea	0
mangiferas	paraesophageal hiatal hernia	0
glucose fructose syrup	creutzfeldt jakob syndrome	0
agaricaceae	intraventricular meningiomas	0
nonfat meal	schizophrenic disorders	0
no meat	retained surgical item	0
serve	olfactory groove meningiomas	0
leek	secondary insomnia	0
decaf	weight gain	0
raisin bran	vagina neoplasm	0
virgin olive	atypical chronic myeloid leukemia	0
higher vegetable	cardiogenic syncope	0
cayenne peppers	symptom cluster	0
low fruit	bruise	0
lens culinari	micturition syncopes	0
octopus	vertex headaches	0
flesh foods	autosomal dominant juvenile parkinsonism	0
copaifera	bleed	0
fruit juice	arthritide	0
illicium verums	mixed lymphomas	0
acaí berries	leucocythaemia	0
althea officinalis	mixed lymphomas	0
exotic fruits	age-related memory disorder	0
eragrostis	tonsillar neoplasm	0
punica granatums	feline lymphoma viruses	0
vodka	spinal cord degenerative diseases	0
guava	vestibular seizure	0
salad	barrett metaplasia	0
black tea	galt deficiency	0
atropa belladonna	chromosome 6 linked autosomal recessive parkinsonism	0
cold-steeping tea	painful menstruation	0
breast milks	brain diseases	0
bad foods	impaired sensations	0
crave chocolate	semantic memory disorders	0
citrus hystrices	diffuse lymphomas	0
tangerine trees	brain cancer	0
tangerine tree	amnesia-memory loss	0
butter	cll lymphoplasmacytoid lymphomas	0
papaya	adenomatous polyp	0
crataegus monogyna	endometriosis	0
deep-fried foods	sudden-onset diabetes mellitus	0
dried apple	prostatic adenomas	0
specific foods	sleep-related neurogenic tachypnea	0
hamburger	transmissible dementias	0
curcuma longas	uterine neoplasm	0
japanese plum	osteoarthrosis	0
watercress	stomach ulcers	0
wild yam	joint pains	0
pomegranate	spontaneous abortions	0
lemon grass	eczematous dermatitis	0
group foods	manic depressive psychoses	0
indian gooseberry	huntington’s disease	0
domestic fowls	androgenic alopecia	0
dairy products	muscular cramps	0
dietary supplementations	growth hormone receptor deficiency	0
uncooked food	micturition syncope	0
white potatoes	oral cancer	0
fries	penis cancers	0
antioxidant foods	diabetic autonomic neuropathy	0
golden raisins	atheroma	0
mint	campylobacter infections	0
origanum majorana	udp-galactose-4-epimerase deficiency	0
chilli peppers	cva (cerebrovascular accident)	0
lemongrass	proliferative bronchiolitides	0
butter milk	craniocerebral trauma	0
gluten-free diet	preventing cancer	0
triticum turgidum	limb cramp	0
black sapotes	migraine disorders	0
healthiest foods	saturnine tremor	0
sesamum	auto-immune disease	0
mussel	rebound insomnia	0
white tea	familial dementias	0
citrus bergamia	cjd (creutzfeldt jakob disease)	0
citrus x paradisi	water-borne hepatitis	0
sweetening agent	lung disorders	0
japanese plums	fibrocystic breast disease	0
experience food	convulsive seizure	0
psidium guajava	thyroid cancer	0
soybean	temporary amnesia	0
raw alfalfa	tonsillar cancers	0
greenery	ache	0
american meat	vaginal discharges	0
hawthorn	fibroatheroma	0
cardamon	rhabdomyolys	0
plantago	huntingtons disease	0
citrus reticulatas	cardiovascular disease	0
junk food	cerebral convexity meningioma	0
pomelo tree	hereditary galactokinase deficiencies	0
glycine max	constrictive bronchiolitides	0
digitalis purpurea	barrett esophagus	0
hypericum perforatums	episodic cluster headaches	0
flax	spondyloarthritis ankylopoietica	0
avena sativa	cardiac dysrhythmia	0
cucumber	type c oncoviruses	0
citrus hystrix	age-related osteoporosis	0
thymus vulgari	carcinogenesis	0
food allergies	multiple sclerosis	0
anacardium occidentale	poisoning	0
oolong	acute inflammatory polyradiculoneuropathy	0
anana	stroke	0
morning meal	gastric cancers	0
replenish nutrients	parkinsonian diseases	0
bertholletia excelsas	water-borne hepatitis	0
cicer arietinum	landry-guillain-barre syndrome	0
cucumis melos	infant obesity	0
wheat brans	acute inflammatory polyneuropathies	0
chamomile	retro-ocular headaches	0
diabetic diets	ekbom delusory parasitosis	0
color	autosomal recessive familial parkinson disease	0
shiitake mushrooms	malignant primary brain tumors	0
thyme	weight reductions	0
agent orange	acute cerebrovascular accident	0
cooked meat	menstrual pains	0
ilex paraguariensis	a-v dissociations	0
plaice	pill rolling tremor	0
cured meat	cardiac arrhythmias	0
white meat	pseudocoma	0
olea europaea	thermal hypesthesia	0
oolong tea	sleep-related neurogenic tachypnea	0
phytonutrient-rich food	juvenile-onset diabetes	0
common olive trees	diabetic amyotrophy	0
red meats	sliding esophageal hernia	0
dripping	situational syncopes	0
porgy	rodent ulcers	0
processing meat	diabetic neuralgias	0
kombucha teas	aortic aneurysms	0
cinnamomum verum	fatigue	0
calendula officinali	lead poisoning	0
vinegar	small cleaved cell lymphoma	0
pie	deep vein thrombosis	0
raw garlic	allergic diseases	0
include flaxseed	episodic cluster headache	0
flaked coconut	drug use disorders	0
fortify milk	psoriasis	0
lucerne	trochanteric fractures	0
anti-inflammatory foods	bovine lymphoma	0
brinjal	gall stone	0
morel	cancer of the uterus	0
zinger tea	nonalcoholic fatty liver	0
illicium verum	common bile duct gall stones	0
stuff	birth defects	0
rubus fruticosus	diffuse myofascial pain syndrome	0
vaccinium bracteatums	contusion	0
refined olive	dental fluorosis	0
carbonated drinks	dental fluoroses	0
cauliflower	non-hodgkin lymphoma	0
bertholletia excelsa	acute inflammatory polyneuropathy	0
common bean plants	cervix neoplasms	0
cinnamomum cassia	mixed cell lymphoma	0
petroselinum	visceral obesity	0
poisonous plants	vertex headaches	0
drink tea	inhibit cancer	0
overpriced vitamin	meningotheliomatous meningioma	0
kiwi fruit	atrial fibrillation	0
tuna fish	lung neoplasm	0
pimpinella anisums	endometrium cancers	0
spice saffron	carcinomatose	0
mustard greens	substance dependence	0
bellis	brain neoplasm	0
rhubarb	endometrium cancer	0
coconut water	lymphocytic leukemia	0
store licorice	intestinal disease	0
syzygium	laron type dwarfism i	0
eating broccoli	skin diseases	0
kola nuts	pancreatitide	0
zedoary zedoaria	utp-hexose-1-phosphate uridylyltransferase deficiency disease	0
shiitake mushroom	arthritis	0
philadelphia cream cheese	primary brain neoplasm	0
soda pop	diffuse undifferentiated lymphomas	0
antioxidant fruits	vaginal discharges	0
low-sodium diet	confusional state	0
tomato sauce	eye diseases	0
rice milk	germinoblastoma	0
poroporo	viral infection	0
lunchtime	female subfertility	0
dried plums	malignant epithelial neoplasm	0
smoked food	venereal wart	0
red delicious apples	communicable disease	0
rubus	non b hepatitis enterically transmitted non a	0
fermented cabbage	galactokinase deficiency disease	0
century plants	prostatic intraepithelial neoplasms	0
eupatorium rebaudianums	hepatic neoplasm	0
vegetable protein	neurotic anxiety state	0
prunus salicinas	familial creutzfeldt-jakob diseases	0
pecan tree	scorbutus	0
snail meat	primary gh resistance	0
cultivated radish	cancer of mouth	0
retail poultry	gluten-sensitive enteropathy	0
justicia adhatoda	tongue neoplasms	0
food pyramid	vulvar cancers	0
kava	bowel disease	0
white pepper	jaundice	0
vaccinium virgatum	myeloma-multiple	0
fresh fruits	spindle-cell carcinomas	0
deep-fry foods	alcoholism	0
ceratonia	chronic pains	0
artichoke	uterine leiomyoma	0
black teas	cancer of the skin	0
eugenia cumini	degenerative diseases	0
frosting	intraepithelial prostatic neoplasias	0
concord grapes	episodic cluster headaches	0
drinking orange	polyradiculoneuritide	0
cola nitida	e-b viruses	0
sardine	parkinsons disease	0
soft drink	thyroid cancer	0
curry	udp galactose 4 epimerase deficiency disease	0
food companies	groundnut hypersensitivity	0
cereal	autosomal recessive juvenile parkinsonism	0
tea plant	chronic lymphocytic leukemias	0
psyllium	muscular cramp	0
potable water	uterus cancers	0
split pea	myelogenous leukemia	0
cocoa plant	mad cow disease	0
foxglove	cancer of mouth	0
hickory trees	muscle cramps	0
brassica napus	ciguatera poisoning	0
zingiber officinales	neurocysticercose	0
juglans regia	cataract	0
brewing tea	multiple meningiomas	0
chinook salmon	rest tremors	0
dried food	avitaminose	0
chili pepper	familial atrial fibrillations	0
red tea	rectum cancer	0
watermelon	rodent ulcer	0
solanum	starvation	0
mentha piperita	spondyloarthritis ankylopoietica	0
broccoli raab	pancreas neoplasm	0
citrus aurantiifolias	acquired immune deficiency syndrome	0
chinese yams	vulva neoplasms	0
eden foods	diabetic mononeuropathy	0
plant aril	uterine neoplasms	0
coriandrum sativums	elevated cholesterols	0
euchresta	food borne diseases	0
cannabis indicas	acute cerebrovascular accident	0
coca	drug hypersensitivity	0
porphyra	cardiovascular strokes	0
cannabis	viral hepatitis	0
muffin	prevent and reverse heart disease	0
coleslaw	exudative bronchiolitides	0
jambolan plum tree	symptom cluster	0
camomile	testis cancer	0
brassica juncea	neurologic degenerative conditions	0
bitter nightshades	halitosis	0
white bread	ocular headache	0
conventional food	mottled enamel	0
guacamole	cryptogenic epilepsies	0
carya illinoensis	cephalgia syndrome	0
breakfast time	corpse	0
reindeer meat	lung cancers	0