
pummelo trees	respiratory tract infections	0
bertholletia excelsas	male sexual impotence	0
gooseberry	mania	0
carica papayas	hhv-4	0
sunchoke	tick bites	0
paella	e b virus	0
bilberry	pus	0
fryer	tonsillar neoplasm	0
vitamin pills	lung neoplasm	0
split peas	convulsion	0
hibiscus	tick bites	0
red delicious	deglutitional syncopes	0
high fructose maize syrup	corpse	0
chipotle	heart decompensation	0
preserved food	tongue neoplasm	0
four nuts	water-borne hepatitides	0
seltzer water	trochanteric fractures	0
capsicum	familial juvenile parkinsonism	0
acai berry	cervix neoplasms	0
organic foods	low-grade b-cell malignancy	0
plant embryos	experimental parkinson disease	0
andropogon nardus	primary malignant brain tumors	0
ice creams	central obesities	0
dietary supplement	male breast neoplasms	0
cannabis sativa	severe mental disorder	0
pineapple	tongue neoplasms	0
corn oils	water borne hepatitis	0
sour orange trees	mastodynia	0
soy beverage	cancer of the testis	0
romaine	plasmodium infection	0
nonus	zoonotic infectious diseases	0
green grapes	skin cancers	0
antioxidant food	tonsillar neoplasms	0
golden raisins	carotid sinus syncopes	0
cycad trees	breast pains	0
carica papaya	joint diseases	0
teosinte	undifferentiated carcinomas	0
bagel	oncogenesis	0
foxglove	cow disease	0
sweetened cereal	anaplastic carcinomas	0
lunchtime	rachitis	0
food coloring	generalized seizure	0
drug administration united states food	osteoarthritide	0
citrus medica	carcinomatose	0
vegetable juices	acute inflammatory polyradiculoneuropathy	0
salmonella-infected eggs	bacterial vaginoses	0
stevia	craniocerebral injury	0
thymus vulgaris	protein deficiencies	0
collard green	generalized spasm	0
eugenia jambolana	male pattern alopecia	0
diospyro	food borne diseases	0
sweetening agents	manic state	0
pecan tree	massive tremors	0
zingiber officinale	female infertility	0
cider vinegar	non hodgkin lymphoma	0
kawa kawa	pattern baldness	0
banana	newborn gynecomastia	0
cooked tomatoes	human t-cell leukemia virus type iii	0
sockeye salmon	drop attack	0
squash seeds	prostatic intraepithelial neoplasm	0
persea americana	human cancer	0
jelly	laron syndrome	0
spice saffron	breast diseases	0
norus	diabetic polyneuropathies	0
rosemary	zoonotic diseases	0
sea bilberries	neurocysticercose	0
coconut oil	premature aging	0
cymbopogon	pancreas neoplasms	0
justicia adhatoda	age-related bone losses	0
cod	bladder cancers	0
vegetarianism	early onset parkinsonism	0
eat flax	erectile dysfunction	0
allium porrum	cancer of testis	0
rutabaga	bladder neoplasms	0
fenugreek	high cholesterol level	0
anticancer plant	colicky pain	0
soft drinks	ovarian cancer	0
dioscorea villosa	pancreatitide	0
cilantro	endometriose	0
cicer arietinums	intracranial meningioma	0
cardamon	familial guillain-barre syndrome	0
triticum durum	chronic obstructive lung disease	0
phyllanthus emblicas	infant obesity	0
sour orange tree	fatty liver	0
camomile	central nervous system intracranial disorders	0
anti-inflammatory foods	seizure disorder	0
entree	mixed small and large cell lymphoma	0
fat milk	terminal cancer	0
baby carrots	cysticercose	0
agaricaceae	paroxysmal atrial fibrillation	0
incorporates cloves	stomach cancer	0
hibiscus sabdariffa	subtrochanteric fractures	0
table sugar	atypical diffuse small lymphoid lymphoma	0
soy sauce	cognitive retention disorder	0
soy cheeses	parkinson's disease	0
individual food	water stress	0
orange tree	symmetric diabetic proximal motor neuropathy	0
raw food	multiple myositides	0
mandarin orange tree	human t cell lymphotropic virus type iii	0
healthy snack	cancer of tonsil	0
kombucha tea	growth hormone receptor defect	0
kidney beans	mottled enamel	0
almond	fibrocystic changes of breast	0
snail meat	tor-driven diseases	0
poultry meat	todd's paralysis	0
medicago sativa	degenerative diseases	0
dairy product	lung inflammations	0
cranberry juice	chronic b cell leukemia	0
anacardium	carcinomatose	0
hemp	galactosemia 3	0
prunus salicina	grave’s disease	0
own vitamin	thrombus	0
beverage	cot deaths	0
healthier foods	rna tumor viruses	0
malabar-nut	soft tissue sarcoma	0
black beans	gehrigs disease	0
asparagus	dementia	0
olea europaea	menstrual pains	0
aloe vera	muscular cramp	0
healthiest beverage	gastric acid reflux disease	0
lentinus edodes	liver cancer	0
dietary fibers	cataract	0
fagopyrum	colonic inertia	0
avenas	thermal hypesthesias	0
candy bars	retained surgical instrument	0
find pork	ekbom delusory parasitosis	0
high fructose corn syrup	mixed lymphoma	0
lard	familial dementia	0
durum wheat	mad cow diseases	0
soy beans	galactosemia 2s	0
new candy	congenital abnormality	0
sweet peppers	throbbing headache	0
portulaca oleraceas	cryptogenic epilepsy	0
st. john's wort	ciliary body spasms	0
bitter orange tree	skin neoplasm	0
bad foods	pneumonia	0
oxen meat	gustatory seizure	0
high-fructose corn	ovary cancer	0
onion	spatial memory disorders	0
chamomile tea	orf	0
vicia faba	influenza in humans	0
white rice	hysterical amnesias	0
white mallows	intervertebral disk degenerations	0
ribe	venous thromboses	0
dioscorea opposita	ekbom delusional parasitoses	0
pumpkin seeds	low-grade lymphoma	0
bell pepper	sneezing	0
andean blackberries	shock	0
brew	nonorganic insomnia	0
gluten	hiccough	0
nutrient-dense foods	abdominal cramp	0
triticum turgidum	polyradiculoneuritide	0
yerba mates	intraepithelial prostatic neoplasias	0
wheat brans	right sided heart failure	0
aspalathus linearis	galactose-1-phosphate uridyltransferase deficiencies	0
greenery	tussive syncope	0
carica	polyarthritis	0
anise tea	somatosensory seizure	0
big food	convulsive syncopes	0
kiwi fruit	psychotic disorders	0
leafy vegetables	cll lymphoplasmacytoid lymphoma	0
allium sativum	paraosmia	0
capsicum annuum	chronic b-cell leukemia	0
rowanberry	landry guillain barre syndrome	0
vaccinium myrtillus	disc degradation	0
red cabbage	early detection of cancer	0
food companies	lav-htlv-iii	0
caper	senile tremors	0
regular olive	hirsutism	0
citrus hystrices	human t cell lymphotropic virus type iii	0
bean	involuntary quivers	0
replenish nutrients	juvenile-onset diabetes mellitus	0
chewing gum	recurrent brain tumors	0
strawberry	anaplastic carcinoma	0
eating broccoli	sleep wake disorders	0
soymilk	birth defects	0
trigonella	polymyositis	0
roasted almonds	female subfertility	0
component spices	carcinomatose	0
dinner times	severe mental disorder	0
blueberry plant	infant gynecomastia	0
bread mold	breast carcinoma	0
sparkling waters	dental disease	0
kola nuts	impaired sensation	0
meal time	strains and sprains	0
dark meat	hyperemesis gravidarum	0
mock meats	brain tumor	0
plant foods	hypovolemic shock	0
plantago psyllium	varix	0
mesquite	reduced sensation	0
tea leaves	water-borne hepatitides	0
aubergine	undifferentiated lymphomas	0
added sweeteners	udp-galactose-4-epimerase deficiencies	0
cruciferous foods	congenital hypothyroidism	0
fatty foods	bruise	0
dioscorea polystachya	benign essential tremor	0
diabetic diet	lichen planus	0
english plantain	mental deteriorations	0
juiced broccoli	pleomorphic lymphoma	0
eating eggs	heart attack	0
cocoa plants	rheumatoid arthritis	0
english walnuts	macular dystrophies	0
retail meat	hypospadia	0
drinking tea	national cancer	0
low vitamin	gossypiboma	0
blackberry	fibroadenoma	0
fresh basil	chronic b-lymphocytic leukemias	0
hypericum perforatums	scurvy	0
cannabis sativas	sensory seizures	0
porgy	age-related maculopathy	0
french bean plant	cancer of the breast	0
tea hibiscus	infant gynecomastia	0
sweet orange	microglandular adenoses	0
narrow-leaved plantains	penile cancer	0
dietary plant proteins	somatosensory seizures	0
elettaria cardamomums	kidney stones	0
origanum vulgare	child obesity	0
soya milk	atopic disease	0
avocado fruit	beriberi	0
milkshake	condylomata acuminata	0
crunch berries	benign prostatic hypertrophy	0
horse nettles	weight gains	0
atropa belladonna	secretory meningioma	0
soy milk	spinal cord degenerative diseases	0
use sweeteners	venereal wart	0
coriandrum sativum	androgenetic alopecia	0
pear	small cleaved-cell lymphoma	0
hummus	olfaction disorder	0
black currant	gnathostoma infection	0
chinese cassias	environmental cancer	0
fortify milk	early detection of cancer	0
healthiest apple	kahler disease	0
prunus cerasifera	itch	0
vital nutrients	diffuse small cleaved-cell lymphoma	0
linseed	pancreas neoplasm	0
include apples	bronchial asthma	0
dried pomegranate	barrett syndrome	0
cashew	seizure	0
dressing	esophagitide	0
gmo soybeans	physical anhedonia	0
avocado	myocardial infarction	0
cycad	galactokinase deficiencies	0
dangerous plants	feline leukemia virus	0
wild yams	crib death	0
sugar-sweetened beverages	symmetric diabetic proximal motor neuropathy	0
ice cream	retained surgical instruments	0
ground meat	common bile duct gallstones	0
portulaca	fifth phacomatoses	0
drink milk	drug use disorders	0
processed meats	heat strokes	0
althaea	diabetic complication	0
yoghurt	kanner's syndrome	0
guibourtia	auto-immune disease	0
japanese plums	low backache	0
persea	deficiency diseases	0
eat chocolate	food hypersensitivity	0
exotic fruits	bone fracture	0
euterpe oleracea	rectal neoplasms	0
faba beans	ph1-negative myelogenous leukemias	0
ultra-processed food	renal cancer	0
hazelnut	anemia	0
malus	acne	0
thyme	deep-venous thromboses	0
nutriceutical	food hypersensitivity	0
turmeric root	carcinomatosis	0
fast food	retinitis	0
foeniculum vulgare	breast malignant tumors	0
alpine strawberry	oral disease	0
flammulina	endometrial neoplasm	0
happy meal	persistent atrial fibrillations	0
mint tea	tumor viruses	0
crataegus monogyna	continuous tremors	0
target vitamin	benign neoplasm	0
food additive	tongue neoplasms	0
little meat	post traumatic osteoporosis	0
wine	darkness tremors	0
willow tree	urinary bladder diseases	0
açaí berry	colitis gravis	0
processed apples	small lymphocytic lymphoma	0
elettaria	type c oncovirus	0
natto	stomatognathic diseases	0
anise seed	headache disorder	0
vaccinium bracteatum	kidney cancer	0
raw garlic	rhabdomyolys	0
veggie	insulin dependent diabetes mellitus 1	0
crabapple	fibromyositis-fibromyalgia syndromes	0
curcuma zedoaria	brain neoplasms	0
calendula officinali	intraventricular meningioma	0
frosting	generalized spasm	0
sugar substitutes	starvation	0
chinese food	endocrine breast disease	0
orange	ekbom dermatozoic delusion	0
linum usitatissimums	breast malignant neoplasm	0
vaccinium ashei	darkness tremor	0
poultry products	gustatory seizure	0
brain-invasive pork	tongue cancers	0
whole grain	chest pain	0
cacao bean	common cancer	0
lycium barbarum	visceral steatoses	0
corn oil	infectious mononucleosis virus	0
bean sprouts	malignant meningioma	0
cooking oil	muscular cramps	0
apple juice	tonsillar neoplasms	0
black walnuts	prion induced disorder	0
horse nettle	chronic daily headaches	0
mangifera indicas	deep venous thromboses	0
parsley	carcinogenese	0
pineapple juice	cephalgia syndrome	0
narrow leaved plantain	rupture	0
popcorn	encephalopathy	0
pecan	ekbom delusory parasitoses	0
rose berries	hemolytic-uremic syndrome	0
coriandrum sativums	atherogenesis	0
dinnertime	colic	0
chamomile oil	kidney neoplasms	0
reindeer meat	muscle spasm	0
processed foods	non-hodgkin lymphoma	0
teff	lymphosarcoma	0
glycyrrhiza	nonhodgkins lymphoma	0
black currants	malignant primary brain neoplasms	0
molasse	cardiogenic syncopes	0
cranberry sauce	virus disease	0
belladonna	complete hearing loss	0
secale cereale	low back ache	0
breakfast	common cold	0
coriandrum	essential tremors	0
food poisonings	subtrochanteric fractures	0
malabar nut	food borne diseases	0
cuminum cyminum	lens opacities	0
narrow-leaved plantain	bovine lymphosarcomas	0
opium poppies	sneezing	0
lactuca sativa	fibroatheroma	0
skim milk	myelomatosis	0
iceberg lettuce	limb tremor	0
colocasia	granulomatous colitis	0
calendula	rectal neoplasm	0
prosopi	intervertebral disk degeneration	0
syzygium cumini	liver diseases	0
healthy snacks	pseudocoma	0
earl grey tea	craniocerebral traumas	0
malus domestica	gasser syndrome	0
monitoring food	cancer of rectum	0
hickory nuts	nafld	0
frozen broccoli	generalized headache	0
specific foods	endometriose	0
ready-prepared food	non-hodgkins lymphoma	0
drinking orange	vertebrogenic pain syndromes	0
mandarin orange trees	thyroid carcinomas	0
rhubarb	cardiovascular strokes	0
citrus paradisi	olfaction disorders	0
seed	phlebothrombose	0
plant arils	limb cramps	0
bertholletia	single seizures	0
lycium chinense	acquired immunodeficiency syndrome virus	0
tuna fish	body weights	0
poisonous plants	drug hypersensitivity	0
muffin	auriculo ventricular dissociation	0
healthiest nuts	prostate cancers	0
herbal tea	intracranial neoplasms	0
garlic sauce	tick bite	0
cereal grain	malignant primary brain tumors	0
cocoa powders	cluster headache syndrome	0
gum acacia	pulmonary disorder	0
vaccinium macrocarpons	renal insufficiency	0
proteus mirabilis	type c oncovirus	0
collard greens	paraesophageal hernias	0
contaminated meat	juvenile parkinson disease	0
root	sudden infant death	0
breakfast cereal	oncogenic viruses	0
cassia	temporal region trauma	0
neutraceutical	kidney stone	0
sweet pepper	undifferentiated carcinoma	0
erythroxylon	tumorigenesis	0
papaya	craniocerebral traumas	0
dietary sugars	anxiety disorders	0
fried foods	bovine lymphosarcomas	0
oyster mushrooms	norwalk like viruses	0
century plant	neonatal tremor	0
licorice	zoonotic diseases	0
beta vulgaris	transmissible spongiform encephalopathies	0
spicy food	encephalopathy	0
alpine strawberries	atrial fibrillation	0
garden radish	open head injury	0
gravy	mad cow diseases	0
crocus sativus	guam form amyotrophic lateral sclerosis	0
breakfast time	post traumatic osteoporosis	0
dog rose	galactokinase deficiencies	0
moose meat	lymphadenopathy associated virus	0
pimpinella	acute confusional migraine	0
citrullus	hypersensitivity	0
woodland strawberry	ph1-negative myeloid leukemias	0
carbonated waters	allergic reaction	0
filtered coffee	infant botulisms	0
pomegranate fruit	breast cystic diseases	0
olive	encephalopathy	0
citrus hystrix	vagina cancers	0
canned fruit	venous thrombosis	0
quinoa	stomatognathic disease	0
color	weight gain	0
squash plants	delusional parasitoses	0
chia seeds	non-hodgkin lymphoma	0
common plant	experimental parkinson diseases	0
lipomul	lower back pain	0
seville orange tree	pill rolling tremor	0
nutmeg	emphysema	0
pickled foods	benign neoplasms	0
hydroponic basil	endometriose	0
drink	neuralgic migraine	0
whale meat	body weight	0
unfertilized eggs	gnathostoma infection	0
new york coalition for healthy school food	ache	0
syzygium malaccense	bone neoplasm	0
anchovy	diabetic mononeuropathies	0
goji berry plant	age-related maculopathy	0
solanum laciniatum	cardiac sudden death	0
so-called meat	breast diseases	0
leaf lettuce	voice box cancer	0
hibiscus tea	arterial fatty streak	0
anti-inflammatory plant	foreign body	0
high-fiber food	malignant lymphomas	0
agent orange	multiple myeloma	0
jalapeno	pneumonitide	0
ground beef	coad	0
good soybeans	autoimmune condition	0
pine nuts	dizzyness	0
triticum vulgare	postpartum sterility	0
pinto bean	hyperventilation syncopes	0
biometal	cancer of brain	0
maple	endometrial neoplasms	0
mealtime	memory loss	0
black pepper	ph1 negative myeloid leukemia	0
andean blackberry	non-b hepatitis enterically-transmitted non-a	0
fruit juices	fights cancer	0
lucerne	lou gehrig's disease	0
flower	block cancer	0
infant formulas	ekbom delusional parasitoses	0
dried foods	hirsutism	0
cinnamomum trees	limb tremors	0
eugenia caryophyllata	spindle cell carcinoma	0
orange juice	barrett syndrome	0
copaifera	mental deteriorations	0
sugar	stomach neoplasm	0
dietary proteins	degenerative intervertebral disk	0
antioxidant-rich food	abdominal pains	0
white bread	lewy body parkinson disease	0
prettiest fruit	head traumas	0
ready prepared foods	feminization	0
whortleberry	small noncleaved-cell lymphoma	0
foie gras	amnesia memory loss	0
purple cabbage	mixed-cell lymphoma	0
whole grain cereals	spondyloarthritis ankylopoietica	0
canned foods	persistent tremor	0
banana plants	peripheral arterial diseases	0
fermented cabbage	small-cell lymphoma	0
filbert	feline leukemia virus	0
emblica officinali	dermatozoic delusions	0
noncaloric sweetener	memory disorders	0
avena sativa	penis cancers	0
citrus grandi	mammary dysplasia	0
intoxicant	chronic fatigue disorders	0
artificial sweeteners	retained surgical item	0
leek	paraesophageal hernias	0
including cloves	syncopal episodes	0
chocolate	pseudotumor cerebri	0
carrot juice	sleep-related neurogenic tachypnea	0
coconut	retained surgical sponge	0
eragrostus	inflammatory polyneuropathy acutes	0
noni fruit	aneurysm	0
citron trees	chronic b-cell leukemia	0
trompillo	communicable diseases	0
mentha piperita	cognitive impairment	0
tap water	prostatic intraepithelial neoplasias	0
solanum melongenas	acute strokes	0
apium graveolens var. rapaceum	subtrochanteric fractures	0
baking chocolate	lichen rubra planus	0
shan yaos	arterial fatty streaks	0
sunflower seeds	fissure in ano	0
syzygium jambos	severe mental disorder	0
plantain	unhealthy conditions	0
euchresta	well differentiated lymphocytic lymphoma	0
milk thistle	corpse	0
dandelion	johne's disease	0
assai palms	testicular tumors	0
apium graveolens	intractable headache	0
nut	benign essential tremors	0
pumpkin pie	virus disease	0
so-called vegetable	cancer of ovary	0
density foods	action tremor	0
durum wheats	mad cow disease	0
soy bean	coronary diseases	0
candy bar	thyroid disorders	0
kava kava	infection	0
foodstuff	gasser's syndrome	0
punicaceae	mental deteriorations	0
rooibo	cancer of lung	0
citrus fruit	non hodgkin's lymphoma	0
dripping	tumorigenesis	0
hypericum perforatum	vitamin deficiency	0
soy bean curds	barrett's esophagus	0
chinook salmon	darkness tremor	0
new vitamin	sudden cardiac arrests	0
fake meat	muscular spasm	0
baby formulas	cancer of the colon	0
white pepper	spongiform encephalopathies	0
lens plants	food borne diseases	0
grecian foxgloves	sudden cardiac arrest	0
common bean plant	dermatozoic delusion	0
food and drug administration	halitose	0
larder	renal calculus	0
processed food	guam form of amyotrophic lateral sclerosis	0
citrus fruits	circulatory failure	0
hypericum	t viruses	0
frozen fruit	reticuloendotheliosis virus	0
avena	postoperative nausea and vomiting	0
cantaloupe	alzheimer’s disease	0
sugar water	chronic b lymphocytic leukemia	0
japanese plum	hair losses	0
bellis	smell disorders	0
suggesting fruit	pulmonary embolism	0
chile pepper	plasma-cell myelomas	0
piper nigrum	craniocerebral injuries	0
stryphnodendron	bilateral sciatica	0
lavender	cancer of stomach	0
chicken	galactose-1-phosphate uridyl-transferase deficiency disease	0
wolfberry	human papilloma viruses	0
black walnut	superficial head injury	0
ranking foods	grave’s disease	0
silybum marianums	vaginal neoplasms	0
aspalathus	superficial head injuries	0
french fries	hot flashes	0
citrus sinensis	spindle cell sarcomas	0
broccoli	bilateral headache	0
fermented foods	human t-lymphotropic virus type iii	0
dairy yogurt	kidney neoplasms	0
table salt	dental disease	0
eating almonds	anal ulcer	0
corn syrup	schizophreniform disorder	0
purple potatoes	prostate cancer	0
norovirus food	gout	0
rubus idaeus	numbness	0
butternut squash	penile cancers	0
fatty meal	texidor twinge	0
chard	gluten enteropathy	0
high-phytate foods	multiple myelomas	0
cooking meat	periadenitis mucosa necrotica recurrens	0
arecas	weight losses	0
safflower oils	lightheadedness	0
dried food	early awakening	0
cymbopogon nardus	lung cancers	0
low-calorie diet	rhabdomyolysis	0
health nuts	birth defect	0
celebration meal	cat leukemia virus	0
chinese yams	sneeze	0
chicken meat	lung inflammation	0
sesame	temporal region traumas	0
ready-to-eat meals	amnesia-memory losses	0
actual fruit	exudative bronchiolitides	0
eugenia sandwicensis	gallbladder disease	0
kidney bean	muscle tremor	0
brussels sprouts	burn	0
frequent meals	peripheral demyelinating autoimmune disease	0
dasheen	tumor of rete testis	0
citronella	bilateral headaches	0
amorpha	joint pains	0
texturized soy proteins	cancer of the brain	0
rise	degenerative disease	0
margarine	virus disease	0
taraxacum	galactose-1-phosphate uridyltransferase deficiency	0
beet greens	infertility	0
pimenta diocias	near-death experience	0
adhatoda vasica	chronic b-cell leukemia	0
rheum officinale	fibrous meningiomas	0
chlorella	peanut allergy	0
prunis communis	myelomatosis	0
solanum melongena	massive tremors	0
soda pop	todd's paralysis	1
coca	condylomata acuminata	0
acacia tree	parkinsonism	0
silken tofu	precordial catch	0
indian laburnums	polyp	0
glycine max	male breast cancer	0
jalapeno peppers	sliding hiatal hernias	0
pea families	small-cell lymphomas	0
phaseolus acutifolius	tonsillar neoplasm	0
berberi	sprains and strains	0
plantago	mixed lymphomas	0
vitis vinifera	crohn's disease	0
chili pepper	neoplasm	0
grapefruit juice	ulcerative colitis	0
diabetic diets	pharyngitide	0
trigonella foenum-graecums	circulatory collapse	0
lens plant	ciguatera poisoning	0
placenta	somatotropin hypersecretion syndromes (acromegaly)	0
pyrus	pustular psoriasis of palms and soles	0
neu5gc-rich food	muscle pains	0
dark chocolate	prevent and reverse heart disease	0
wheat bran	motor seizure	0
guacamole	zoonotic infectious disease	0
anise	mastitis	0
green beans	human influenza	0
vegetable proteins	chronic infectious mononucleosis-like syndrome	0
goiaba	colonic cancers	0
lunch time	blood cancer	0
shiitake	prediabetic state	0
marjoram plant	benign prostatic hyperplasia	0
common fruits	erectile dysfunction	0
currant	prion protein diseases	0
humulus lupulus	non-alcoholic fatty liver disease	0
turkey meat	deep venous thrombosis	0
haritaki fruit	syncopal episode	0
olea	amnestic state	0
artichoke	ciguatera fish poisoning	0
aspartame	lung neoplasm	0
pudding	epstein barr virus	0
lemon	diabetic amyotrophy	0
virgin olive	igf-1 deficiency	0
tangerine tree	acquired immuno deficiency syndrome	0
acer negundo	precordial catch	0
tomato sauce	metastasis	0
gala apples	light-headedness	0
eating meat	amyloidose	0
different fruits	peripheral autoimmune demyelinating disease	0
monkfish	renal insufficiencies	0
animal-based foods	galactokinase deficiency diseases	0
dairy products	subtrochanteric fractures	0
sausage	sinusitide	0
alfalfa	serious disease	0
citrus aurantiifolia	auditory seizure	0
caffeinated coffee	infant gynecomastia	0
unrefined plant	extreme hearing loss	0
decaffeinated tea	disorders of initiating and maintaining sleep	0
powdered ginger	reactive confusion	0
mirobalanus embilicas	orthostasis	0
atropa belladonnas	prostatic adenoma	0
food colors	muscular spasms	0
hot pepper	hernia	0
vinegar	recurrent low back pain	0
almond tree	stroke	0
oreo	cardiovascular stroke	0
antioxidant vitamin	hepatitis	0
zinger tea	sore throats	0
soda pops	convulsive seizure	0
coleslaw	iron overload	0
broad beans	memory disorders	0
sauerkraut	pancreatic cancers	0
raw alfalfa	limb cramps	0
machaerium	metastatic cancer	0
common foxglove	light-headedness	0
national pork	generalized spasms	0
handling meat	pulmonary disease	0
calendula officinalis	gastro-oesophageal reflux	0
almond milk	lactose intolerance	0
whole foods	adenomatous polyp	0
betel	basal cell nevus syndrome	0
chilli peppers	allergic reaction	0
ginger ale	deaf-mutism	0
texturized vegetable proteins	amaurosis	0
grouper	cephalodynia	0
floret	pulmonary cancers	0
brussel sprout	thrombus	0
eggnog	severe mental disorder	0
hordeum	guillain barre syndrome	0
juglans nigra	blood cancer	0
pinto beans	coronary heart diseases	0
rye bread	low back pain	0
oryza	neurologic degenerative disease	0
berberis	congenital defects	0
sesame oils	symmetric diabetic proximal motor neuropathy	0
açai berries	small cleaved cell lymphoma	0
healthy foods	acne	0
flammulina velutipes	uterus cancers	0
lima beans	ovary cancers	0
jambolan plum trees	creutzfeldt jakob disease	0
frying meat	macular degenerations	0
breakfast times	age related osteoporosis	0
assai palm	disorientation	0
ocimum sanctum	low-grade lymphoma	0
rye	tonic-clonic seizure	0
cruciferous vegetable	muscle disease	0
fresh meat	common cancers	0
soda waters	manic depressive psychosis	0
soy food	abdominal migraine	0
barley	cholera	0
wild radish	somatotropin hypersecretion (acromegaly) syndromes	0
chervil	blindness	0
flaked coconut	breast malignant neoplasms	0
prunus amygdalus	short sleeper syndromes	0
carbonated drinks	single seizure	0
kangaroo meat	experimental parkinson disease	0
low fruit	cancer of uterus	0
fabaceae	hepatic failure	0
food additives	secretory meningiomas	0
baby spinach	acute confusional migraines	0
soup	neoplasia	0
healthiest fruits	inappropriate gh secretion syndrome (acromegaly)	0
msg	myelomatose	0
glucose-fructose syrup	persistent tremors	0
holy basils	goiter	0
sparkling water	malignant lymphoma	0
afzelia	mental disorders	0
bolete	central nervous system degenerative diseases	0
green pepper	intermediate-grade lymphoma	0
black sapotes	cluster headache syndrome	0
mangosteen	small and large cleaved-cell lymphoma	0
java plum trees	drug hypersensitivities	0
octopus	encephalon disease	0
mastictree	brain disease	0
apple tree	guam disease	0
white wine	gnathostomiasis	0
scrambled eggs	graves disease	0
isoglucose	lumbago	0
kale	upper respiratory infections	0
infant formula	renal failure	0
silybum marianum	fatty liver disease	0
black sapote	endometrium carcinoma	0
group foods	diabetes-related complications	0
sell meat	lead poisonings	0
majorana hortensis	sleep-related neurogenic tachypnea	0
uncooked foods	kidney neoplasms	0
plantago lanceolata	brain cancer	0
wild celeries	artery disease	0
healthiest foods	pediatric cancers	0
pancake	zoonosis	0
nicotiana	beriberi	0
coffee	mptp induced experimental parkinsonism	0
justicia	gastro esophageal reflux	0
irritable bowel kiwi fruit	pediatric obesity	0
soybean	convulsive syncopes	0
nut bars	impaired sensation	0
legume pod	manic-depressive psychoses	0
curcuma	macular degeneration	0
lemon balm tea	iritide	0
cicer arietinum	high-grade lymphomas	0
soy protein	amyotrophic lateral sclerosis	0
raw broccoli	social phobias	0
wild yam	age-related maculopathies	0
barley coffee	autosomal dominant juvenile parkinson disease	0
squashe	long sleeper syndrome	0
horsenettle	wheat hypersensitivity	0
caryophyllus	e-b virus	0
porphyra	galactosemia iii	0
low-sodium diet	sleep disorders	0
texturized soy protein	skin cancer	0
citrus aurantium	brittle diabetes mellitus	0
tea	autosomal recessive parkinsonism	0
bergamot	pulmonary cancer	0
pecan trees	polyradiculoneuritide	0
corylus	hypospadia	0
nitrate-rich vegetables	ph1 negative myeloid leukemia	0
incorporate cloves	foodborne botulism	0
zea mays	fifth phacomatosis	0
coconut milk	chronic fatigue syndrome	0
cassia fistulas	hypercholesteremia	0
bottled water	cardiovascular strokes	0
added nuts	pulmonary inflammation	0
lentil	malignant lymphomas	0
conventional food	nbcc	0
bran flakes	ductal carcinomas	0
worldwide fruit	motor seizure	0
opium poppy	intestinal disease	0
carya illinoenses	thyroid disorders	0
ceratonia	diverticulitide	0
include fennel	diabetic autonomic neuropathy	0
milk thistles	hirsutism	0
syzygium	inappropriate growth hormone secretion syndrome (acromegaly)	0
nonfat meal	neoplasm metastases	0
artificial sweetener	neurologic degenerative diseases	0
wort	diabetic mononeuropathies	0
drinking milk	diffuse mixed-cell lymphomas	0
sustenance	bladder disease	0
eugenia cumini	fighting cancer	0
white potatoes	juvenile onset diabetes	0
red rice	aura	0
healthy fruit	vagina neoplasm	0
cooked meats	precordial catch	0
oregano	hiatus hernias	0
coriander	amyloid deposits	0
laciniate nightshade	mastalgia	0
liquorice	preterm birth	0
cocoa plant	goiter	0
crab apple	throbbing headaches	0
plum	ebv	0
lavandula angustifolia	gehrig's disease	0
cooked carrots	zoonotic disease	0
cuminum cyminums	age-related macular degeneration	0
different seed	cerebral convexity meningiomas	0
thymus plant	cerebrovascular stroke	0
poisonous plant	gasser's syndrome	0
fruit juice	lead poisonings	0
fat foods	craniocerebral traumas	0
potassium-rich foods	frontal region traumas	0
sunfish	craniocerebral injury	0
sesamum	paratuberculose	0
salami	myelomatosis	0
dried apple	oxygen deficiency	0
sugary foods	senile plaque	0
pistacia	rabies virus	0
jerusalem artichokes	psammomatous meningiomas	0
hickory nut	age related bone loss	0
tarragon	chronic cluster headache	0
rheum rhaponticum	celiac sprue	0
toronja	liver cancers	0
dried plums	lung disease	0
basil	acute autoimmune neuropathy	0
curcuma zedoarias	food-borne diseases	0
carya	food hypersensitivity	0
flavourer	microlissencephaly	0
cheese	periadenitis mucosa necrotica recurrens	0
healthiest snack	confusional states	0
hemp plants	central obesity	0
red delicious apples	grippe	0
domestic fowls	cephalgia syndromes	0
mastic trees	limb tremor	0
grilled meat	basal cell carcinomas	0
brewed coffee	social anxiety disorder	0
trace mineral	lung disease	0
trigonella foenum-graecum	air sickness	0
tea plant	tumor viruses	0
ganja	botulism	0
chewing fruit	renal insufficiencies	0
junk foods	fatty liver disease	0
hordeum vulgare	infant obesity	0
kaffir lime	irritable bowel syndromes	0
carbonated mineral waters	intraepithelial prostatic neoplasia	0
orange trees	ponv	0
dietary soybean proteins	temporary amnesia	0
cauliflower	non alcoholic fatty liver disease	0
cassia tree	vertebrogenic pain syndromes	0
chinese rhubarb	upper respiratory tract infections	0
goji berry	precordial catch syndrome	0
purple grape	auriculo-ventricular dissociation	0
ceylon cinnamon	hemangioblastic meningioma	0
unfiltered coffee	muscle tremors	0
no meat	variant creutzfeldt-jakob disease	0
cuminum	intermediate-grade lymphomas	0
salt-free diet	weight losses	0
veal	social phobia	0
kawa	myelomatosis	0
zingiber officinales	birth defects	0
common olive trees	postoperative nausea	0
algarrobo	transient blindness	0
dried apricots	atherosclerotic plaques	0
herr	uterine cervical cancer	0
bok choy	genital warts	0
plant aril	malignant primary brain neoplasms	0
pepsi	prostate neoplasm	0
stevia rebaudiana	oxygen deficiencies	0
trace minerals	chest pain	0
fava beans	mastalgia	0
cocktail	nonhodgkin lymphoma	0
portulaca oleracea	urinary tract infection	0
mentha spicata	als (amyotrophic lateral sclerosis)	0
carbonated drink	cjd (creutzfeldt-jakob disease)	0
nicotiana tabacums	hypovolemic shock	0
cannabi	prediabetic state	0
treat	insulin-dependent diabetes mellitus	0
stuff	weight loss	0
melissa officinalis	psychosis	0
processed meat	microcephaly	0
diet	prelingual deafness	0
milk	gallbladder disease	0
betel nut	viral disease	0
poppy seeds	anal ulcers	0
smoked food	colitide	0
poultry	olfactory seizure	0
carbonated water	viral hepatitis	0
lemon grass	common cold	0
origanum onites	bovine leukosis	0
healthiest beverages	physical anhedonia	0
pea	sphenoid wing meningiomas	0
dried fruit	deep venous thromboses	0
golden delicious apples	dairy product intolerance	0
peach	stomach cancer	0
yogurt	gastric cancer	0
morel	vulva cancer	0
mangifera	experimental lung inflammation	0
corn sugar	substance abuses	0
caryophyllus aromaticus	oral cancer	0
know nuts	ovarian cancers	0
smoked foods	autosomal dominant juvenile parkinson disease	0
cynara scolymus	galk deficiency	0
egg	uveitis	0
abelmoschus	campylobacter infections	0
fagopyrum sagittatum	human mammary neoplasms	0
pease	cluster headache syndromes	0
gui zhi	gout	0
calling eggs	feline lymphoma viruses	0
marsh mallow	reduced sensation	0
maize oils	dental diseases	0
infects apples	steatohepatitis	0
american meat	esophageal cancers	0
goji berries	exudative bronchiolitides	0
feather meal	car sickness	0
indian corn	glaucoma	0
cola nitida	female pattern baldness	0
cherry plum trees	constrictive bronchiolitis	0
soy	ankylosing spondylitis	0
origanum	cardiovascular disease	0
brassica napus	sciatic neuralgia	0
rubberplant	cancer of endometrium	0
allspice	intraventricular meningiomas	0
buckwheat	hepatitide	0
pimpinella anisums	infectious disease	0
zedoary zedoarias	deep venous thromboses	0
celeriac	bovine lymphosarcoma	0
dinner time	prion disease	0
cucumis melos	auditory seizure	0
pithecellobium	psammomatous meningiomas	0
cocoa powder	neurotic anxiety state	0
glucose fructose syrup	senile osteoporoses	0
oryza sativa	wheat allergy	0
thousand foods	postpartum sterility	0
ribes nigrum	ankylosing spondylitis	0
chinese cinnamon	hypercapnia	0
pomegranate	fibroid tumors	0
syzygium aromaticum	substance use disorder	0
healthy nuts	menstrual pain	0
english plantains	sudden onset diabetes mellitus	0
phaseolus	carcinoma in situ	0
granny smith apples	pulmonary cancer	0
individual candy	food hypersensitivity	0
euterpe edulis	prostatitis	0
food allergies	faint	0
red peppers	human immunodeficiency virus	0
okra	autism	0
sweetener	cardiac death	0
whole grain cereal	bovine leukemias	0
psidium guajava	impotence	0
dioscorea batatas	type 1 diabetes	0
retail poultry	esophagus neoplasms	0
ultra-processed foods	galactose-1-phosphate uridyltransferase deficiencies	0
sticker	fusiform aneurysms	0
indian laburnum	tumor viruses	0
phaseolus vulgari	somatosensory seizures	0
papaver somniferum	colonic inertia	0
chile peppers	myocardial infarct	0
confection	craniocerebral injury	0
mango	lymphocytic lymphoma	0
dietary protein	gluten-sensitive enteropathy	0
emphasizes vegetables	skin neoplasms	0
nettle	prion-induced disorder	0
eden foods	low-grade lymphomas	0
crocus	contagious pustular dermatitis	0
hickory tree	headache syndromes	0
weekly meat	convulsive seizure	0
illicium	anoxemia	0
shorten	liver steatosis	0
cultivated oats	multiple head injuries	0
healthier meat	progressive disorder	0
acer negundos	experimental parkinsonism	0
chestnut	abdominal obesity	0
golden glow	obesity in adolescence	0
sour fruit	brain benign neoplasms	0
shiitake mushroom	rhabdomyolysis	0
chanterelle	semantic memory disorder	0
phyllanthus emblica	kidney diseases	0
green tea	delusory parasitosis	0
eugenia aromatica	fibroatheromatous plaques	0
candy	tonsil cancer	0
granny smith	spindle-cell carcinomas	0
broth	mammalgia	0
breakfast cereals	familial atrial fibrillation	0
peppermint oil	horton's syndrome	0
actual licorice	diabetes complication	0
digitalis	norwalk like viruses	0
spinacia oleracea	kidney calculus	0
yeast rice	myelogenous leukemia	0
diospyros digyna	non alcoholic fatty liver disease	0
digitalis lanata	acquired immunodeficiency syndrome virus	0
linum usitatissimum	fibrocystic mastopathy	0
marihuana	testicular cancers	0
foeniculum	develop cancer	0
oats	barrett metaplasia	0
apium graveolens var. dulce	coronary heart disease	0
deep-fry foods	cognitive retention disorders	0
texturized vegetable protein	hepatic neoplasms	0
carob	zoonotic infections	0
soy cheese	brain cancer	0
poroporo	gall bladder diseases	0
pickled vegetables	drug hypersensitivity	0
cassia fistula	peripheral arterial disease	0
cucumis sativus	postoperative nausea and vomiting	0
oatmeal	xanthomatous meningiomas	0
solanum dulcamaras	plasma cell myelomas	0
tomato	fibroatheromatous plaques	0
dietary supplements	abdominal pains	0
big meals	sarcopenia	0
sweetleaf	liver dysfunctions	0
amlas	spindle cell sarcomas	0
consumed chocolate	hansens disease	0
low-salt diet	food-borne disease	0
cinnamomum verum	gum disease	0
stevia rebaudianas	utp hexose-1-phosphate uridylyltransferase deficiency	0
da huang	pneumonitis	0
billion eggs	intervertebral disc degeneration	0
whipped cream	oral neoplasms	0
coco	steatohepatitide	0
piper methysticum	hypertension	0
arginine-rich foods	dermatozoic delusion	0
vegetable juice	colorectal tumors	0
syzygium jambolanum	gorlin syndrome	0
olive tree	muscle cramp	0
chocolate bars	heart block	0
largest meal	excess cancer	0
nutritional yeast	b-cell chronic lymphocytic leukemia	0
clathrotropis	stomach ulcer	0
fuji apples	cancer of kidney	0
coconut water	human t cell lymphotropic virus type iii	0
salad	poisoning	0
seven nutrients	lyssa	0
organic milk	guam form amyotrophic lateral sclerosis	0
mashed potatoes	pill rolling tremor	0
assai palm berries	vaginal neoplasms	0
oregano plant	dissociative amnesia	0
prosopis	parkinsonism-dementia complex of guam amyotrophic lateral sclerosis	0
cola	kanners syndrome	0
potato	cognitive declines	1
plant zygote	fibroatheromatous plaques	0
licorice root	rabies viruses	0
eugenia jambos	utp-hexose-1-phosphate uridylyltransferase deficiency disease	0
green teas	drug habituation	0
carthamus tinctorius	infantile autism	0
triticum turgidum subsp. durum	chronic airflow obstruction	0
safflower	gehrig disease	0
mustard plants	aids viruses	0
fennel	retinitis	0
cocos nucifera	crushing skull injuries	0
prunus armeniaca	paratuberculose	0
oat	headache disorders	0
amla	menstrual pain	0
specific nuts	flatulence	0
macadamia nut	hair losses	0
fenugreek seeds	focal seizures	0
fruit-shaped marshmallows	craniocerebral injuries	0
natural vitamin	temporal region trauma	0
brewage	cervix cancers	0
soybean proteins	iritide	0
snack	hortons syndrome	0
miso	premenstrual syndromes	0
java plum tree	chronic b lymphocytic leukemia	0
plant capsules	dissociative amnesia	0
dietary sucrose	infantile autism	0
whole wheat	tonic seizure	0
guava	gluten enteropathy	0
junk food	semirhythmic tremors	0
uncooked food	bipolar affective psychosis	0
broccoli raab	cancer of the esophagus	0
oregano plants	autosomal dominant. juvenile parkinson disease	0
undercooked meat	legal blindness	0
morinda	barretts esophagus	0
hop	non-b hepatitis enterically-transmitted non-a	0
ocimum basilicums	spindle cell carcinoma	0
cayenne pepper	neurologic degenerative condition	0
salsa	abdominal migraine	0
persimmon	bleed	0
tepary bean	a-v dissociation	0
juglan	senile osteoporoses	0
consumer protection scientific committee on food	prion protein disease	0
sweet marjoram	acquired immune deficiency syndrome virus	0
seltzer waters	monocytic leukemia	0
tv dinners	primary growth hormone resistance	0
indian gooseberries	rodent ulcers	0
dried yeast	retained surgical sponges	0
jelly beans	graves disease	0
raphanus	infantile obesity	0
morning meals	aphthous ulcers	0
pimenta diocia	gnathostomiase	0
term vegetable	brain malignant neoplasm	0
hemlock	nonalcoholic steatohepatitides	0
lemon grasses	lichen planus	0
pimenta officinali	leprosy	0
citrus limon	spasm	0
daily nut	pneumonitis	0
grecian foxglove	inflammatory disease	0
antioxidant fruits	migraine headaches	0
rheum tanguticum	circulatory failure	0
food pyramid	diabetic complications	0
pepper	esophagus cancer	0
ficus	gastro-esophageal reflux	0
millet	fetal iodine deficiency disorder	0
romaine lettuce	lung diseases	0
amygdalus communis	familial guillain-barre syndrome	0
fruit and vegetable juices	reducing cancer	0
raisin bran	stroke	0
soy beverages	microcystic meningioma	0
low-fat diet	spasm	0
squash plant	aura	0
food manufacturers	low back aches	0
cookie	growth hormone receptor defect	0
longevity legumes	brain neoplasms	0
dioscorea	johne's disease	0
citrus-based fruits	cervicitis	0
common foxgloves	memory disorder	0
food company	burn	0
mangiferas	prostatic cancer	0
vaccinium uliginosum	lichen rubra planus	0
iv vitamin	generalized spasms	0
cannabis indicas	lewy body parkinson disease	0
areca nuts	parkinsons disease	0
lycium	polymyositide	0
cured meat	type c oncovirus	0
sardine	manic depressive psychoses	0
saint johnswort	human papillomavirus virus	0
frier	deep-vein thromboses	0
peach trees	galactosemia	0
artificial butter	rectal tumors	0
macadamia nuts	hypermelanosis	0
pistachio nut tree	flatus	0
white meat	neuralgic migraine	0
tobacco	occipital trauma	0
pumpkin	lung inflammation	0
healthy food	cow disease	0
plum tree	radiating pain	0
syrup	acquired immune deficiency syndrome	0
boiled eggs	headache disorders	0
brazil nut tree	gastric ulcer	0
vicia fabas	metastasis	0
ovary	somatotropin (acromegaly) hypersecretion syndromes	0
multivitamin	acute infectious polyneuritis	0
food supplements	hyperventilation syncopes	0
olive trees	monocytic leukemia	0
peppermint	intracranial central nervous system disorders	0
nut butter	vitamin deficiencies	0
pretzel	air sickness	0
sugar maple	diabetic neuralgias	0
trigonella foenum graecum	hepatitis	0
collard	polymyositis ossificans	0
marjoram	confusional state	0
syzygium sandwicense	leukovirus	0
national meat	congenital defects	0
crataegus	painful menstruation	0
fungus	proliferative bronchiolitis	0
high-fat meal	back pain without radiation	0
cortland	galactose-1-phosphate uridyltransferase deficiency	0
little saffron	early onset parkinson disease autosomal recessive	0
garlic	halitosis	0
deep-fried foods	muscle tremors	0
unhealthy food	autosomal dominant juvenile parkinsonism	0
radicchio	memory loss	0
horsebean	fibrose	0
plantago ovata	norwalk like viruses	0
apricot trees	hydrophobia	0
favorite meals	bilateral sciatica	0
cardamom	brain disease	0
diospyros digynas	sliding esophageal hernia	0
wisconsin milk	pustulosis of palms and soles	0
sweetening agent	reproductive sterility	0
cooked meat	allergic reactions	0
maple syrup	bone cancer	0
corn	gluten sensitive enteropathy	0
delonix	postoperative nausea	0
wheatgrass	chronic fatigue disorders	0
dietary fats	acute monoblastic leukemias	0
chicken salad	adenoviridae	0
overpriced vitamin	recurrent brain tumor	0
fast foods	inhibit cancer	0
marjoram plants	birth defect	0
health food	weight losses	0
seville orange trees	superficial head injuries	0
curcuma longa	anxiety neuroses	0
vegetable protein	icterus	0
golden delicious	cerebrovascular apoplexy	0
chewed coca	cataract	0
tuna	fights cancer	0
reason food	fibrocystic breast disease	0
secale	new variant creutzfeldt jakob disease	0
blueberry	vitamin deficiency	0
arachis hypogaea	royal free disease	0
cereal grains	paraesophageal hiatal hernias	0
sweet marjorams	cancer of the brain	0
cinnamon	oral cancers	0
crowberry	diverticulitis	0
sea vegetables	exanthem	0
big apples	epithelial cancers	0
popular fruits	gorlin-goltz syndrome	0
cream cheese	preterm birth	0
eugenia malaccensis	muscular cramp	0
anana	olfaction disorder	0
crab apples	right sided heart failure	0
cultivated oat	secondary fibromyalgia	0
brown rice	migratory pain	0
steamer	aphthous ulcer	0
sea bilberry	pill rolling tremor	0
cocoa butter	fissure in ano	0
baptisia	hemorrhoid	0
dairy eggs	pustular psoriasis of palms and soles	0
red tea	acute monoblastic leukemias	0
navy beans	diabetes mellitus complications	0
fagopyrum tataricum	cancer of brain	0
bean sprout	spindle-cell carcinoma	0
illicium anisatums	sharp headache	0
maize syrup	neurocysticercose	0
raw poultry	juvenile parkinson disease	0
scallion	migraine disorder	0
yerba mate	physical anhedonia	0
triticum aestivum	deglutitional syncopes	0
fragaria vesca	bilateral headache	0
dinner	epileptic seizure	0
sour cream	cognitive dysfunctions	0
anacardium occidentales	tussive syncopes	0
venison	liver neoplasm	0
flax seed	serious disease	0
red wine	uterine cervical cancers	0
lemon verbena	childhood onset obesity	0
hickory trees	muscular cramps	0
linum	acute coryza	0
pasta	uterine cervical neoplasms	0
raspberry	impotence	0
spinach	cardiac disease	0
cocoanut	barrett esophagus	0
flavoring	minor head injury	0
no coffee	benign brain neoplasm	0
club soda	guillaine-barre syndrome	0
potato chips	stomach neoplasm	0
acer saccharum	benign intracranial hypertension	0
bertholletia excelsa	mammary cancers	0
areca catechus	hypertension	0
crave chocolate	sphenoid wing meningioma	0
cayenne	ramsay hunt paralysis syndrome	0
sugar maples	breast disease	0
chili	kidney disease	0
red yeast rice	amnesia-memory losses	0
morinda citrifolias	insomnia disorders	0
emblica officinalis	royal free disease	0
myristica fragran	e b virus	0
ground ginger	vulvar cancers	0
cranberry	vaginal cancer	0
taraxacum officinale	gastro esophageal reflux	0
swiss chard	wheat hypersensitivities	0
fed beef	male sub-fertility	0
avoid peanuts	sleep-related neurogenic tachypnea	0
vaccinium angustifolium	microcystic meningioma	0
psyllium	sinusitide	0
apple	protein deficiency	0
digitalis purpurea	rash	0
decrease meat	schizophreniform disorder	0
dog rose berries	anoxia	0
citrus grandis	gall stone	0
whole grains	pancreatic cancers	0
cured meats	skin neoplasms	0
english walnut	cranial pains	0
boiled broccoli	barretts esophagus	0
plantago arenaria	meningiomatosis	0
leguminosae	ketosis prone diabetes mellitus	0
oolong	infarction	0
lemon tree	contagious pustular dermatitis	0
macadamia	liver diseases	0
eupatorium rebaudianum	kidney neoplasms	0
common bean plants	severe gh insensitivity	0
contamination meat	senile osteoporoses	0
grapefruit	malignant lymphoma	0
walnut	excess cancer	0
woodland strawberries	multiple head injury	0
ground flax	crohn’s disease	0
fries	ischemic heart diseases	0
tree nuts	heat strokes	0
whiting	liver disease	0
fenugreek seed	bacterial vaginitides	0
beer	colon disease	0
deli meats	intermittent tremor	0
ilex paraguariensis	testis neoplasm	0
areca	low backache	0
green peppers	acute inflammatory polyneuropathies	0
toxic plant	amyloidose	0
last meal	guam form amyotrophic lateral sclerosis	0
mother cell	bronchial asthma	0
molasses	pancreas cancers	0
cinnamomum cassia	hemolytic jaundices	0
pistil	muscle disease	0
mentha spicatas	pyorrhea alveolaris	0
monosodium glutamate	muscle disease	0
breast milk	acidose	0
red meats	short sleep phenotype	0
sweet basils	prostatic intraepithelial neoplasias	0
euterpe	viral diseases	0
barberry	visceral steatoses	0
chili peppers	air sickness	0
myristica fragrans	human mammary neoplasm	0
saffron crocus	necrotizing fascitides	0
food supplementations	retained surgical needle	0
cruciferous vegetables	communicable disease	0
chamomile	sinusitide	0
marijuana	benign brain neoplasms	0
solanum dulcamara	uveitide	0
energy drinks	female sub-fertility	0
raisin	infectious mononucleosis virus	0
herbal teas	high-grade lymphoma	0
pimenta	drop attack	0
dessert	psychophysiological insomnia	0
dietary fiber	senile plaque	0
black raspberries	spinal meningiomas	0
assai palm berry	precordial catch	0
plant zygotes	htlv-iii	0
cinnamomum aromaticum	cancer of cervix	0
citrus maxima	degenerative intervertebral disks	0
frozen cranberries	galactose-1-phosphate uridyltransferase deficiency	0
phytonutrient-rich food	goiter	0
solanum tuberosums	severe mental disorder	0
crataegus monogynas	dysfunction	0
mustard	venereal warts	0
measuring food	lobar pneumonias	0
brewing tea	nonalcoholic fatty livers	0
nuclear power plants	different cancer	0
canned food	hypermelanose	0
alfalfa sprout	prostatic neoplasm	0
legume family	male infertility	0
arugula	epstein barr virus	0
milk chocolate	weight gain	0
apple trees	hemolytic-uremic syndrome	0
pistacia vera	senile tremor	0
thymus	thyroid carcinomas	0
jell-o	mouth neoplasms	0
cupcake	ekbom delusional parasitosis	0
kombucha teas	horton syndrome	0
laudable legume	oncogenic viruses	0
dietary fat	endometrial cancer	0
edible grains	cardiovascular disease	0
jalapeno pepper	spinal cord disorder	0
serve	ruptured appendicitis	0
cacao	ovary neoplasms	0
bell peppers	heart decompensation	0
eggplant	obesity in childhood	0
ephedras	fibrositis	0
antioxidant foods	cysticercosis	0
almond trees	lactose malabsorption	0
brassica juncea	primary brain neoplasm	0
dietary supplementations	nephrolith	0
prebiotic	senile osteoporosis	0
solanum lycopersicum	colic	0
recommend tea	heart attack	0
melissa officinali	well differentiated lymphocytic lymphoma	0
tulsi tea	hepatocellular cancer	0
capparis	esophageal neoplasm	0
amaranth	stomach cancers	0
nicotiana tabacum	uterine fibroids	0
bread	microglandular adenoses	0
turnip	scorbutus	0
berry	colon neoplasm	0
tofu	ciguatera	0
energy drink	cancer of the penis	0
potable water	carcinoma in situ	0
sweet basil	macular degenerations	0
chinese yam	juvenile parkinsonism	0
ananas	virus disease	0
dried blueberries	lightheadedness	0
grape	apoplexy	0
dried cranberries	colitis gravis	0
rice	polyradiculoneuritis	0
plantago indica	cancer of the pancreas	0
philadelphia cream cheese	amyloidosis	0
ephedra	renal failures	0
daucus carota	rest tremor	0
seafood	chronic lymphoblastic leukemia	0
olive oil	urticaria	0
ocimum basilicum	cerebral convexity meningioma	0
poenumgraecum	global amnesias	0
spore	reticulolymphosarcoma	0
french bean plants	non b hepatitis enterically transmitted non a	0
soy bean proteins	brain neoplasms	0
lemon trees	a-v dissociations	0
lemon balms	myalgic encephalomyelitis	0
indian gooseberry	esophageal neoplasm	0
shellfish	respiratory tract infections	0
saccharomyces cerevisiae	contagious ecthyma	0
zedoary zedoaria	delusional parasitoses	0
amomum cardamomum	spondylarthritis ankylopoietica	0
peanut butter	microglandular adenosis	0
hot sauce	vulva neoplasms	0
bitter nightshades	mixed lymphoma	0
coca cola	sleep initiation dysfunctions	0
chocolate pudding	psammomatous meningiomas	0
kohlrabi	bacterial vaginoses	0
almond oil	laron syndrome	0
dress	penis cancer	0
acid-binding vegetables	thyroid carcinomas	0
curry	heart disease	0
amomum cardamomums	pancreas neoplasms	0
anacardium occidentale	intracranial neoplasm	0
elephant garlic	viral infections	0
adhatoda	chronic obstructive lung disease	0
origanum majorana	tongue neoplasm	0
mushroom	inflammatory polyneuropathy acutes	0
cold-steeping tea	hemangiopericytic meningioma	0
allium cepa	anoxia	0
lens culinaris	mammary cancers	0
cucumber	bechterew's disease	0
radish	numbness	0
green peas	fever	0
swordfish	viral hepatitis	0
horse bean	mixed lymphocytic-histiocytic lymphoma	0
restrict food	basal cell nevus syndrome	0
box elders	elevated cholesterols	0
store licorice	tonic-clonic seizures	0
sprout	burkitt's lymphoma virus	0
bhang	amnestic states	0
andira	retained surgical needles	0
vitamin	limb cramps	0
sesame seeds	colonic cancer	0
solanum laciniatums	allergy	0
beet	anticancer	0
kenaf	gossypiboma	0
cultivated radish	galactokinase deficiency disease	0
rheum	arthrosis	0
foeniculum vulgares	anaplastic carcinoma	0
punica granatums	vulvar neoplasm	0
mentha x piperita	nonorganic insomnia	0
illicium anisatum	verruca	0
plum trees	head injuries	0
saint johns wort	adolescent obesity	0
club sodas	severe congenital microcephaly	0
yellow vegetables	pulmonary diseases	0
betel nuts	schilling type myeloid leukemia	0
pea family	rodent ulcer	0
blueberry plants	infantile botulism	0
lycopersicon esculentum	type c oncoviruses	0
osmanthus tea	diabetic neuropathies	0
lamb chops	massive tremor	0
holy basil tea	galactose-1-phosphate uridyl-transferase deficiency disease	0
pisum sativum	brain benign neoplasm	0
althaea officinalis	ph1-negative myelogenous leukemias	0
espresso	intertrochanteric fractures	0
saint john's wort	headache disorder	0
alcohol	hemangiopericytic meningiomas	0
almond butter	physical sufferings	0
pork	manic-depressive psychosis	0
cleistocalyx	physical suffering	0
apricot tree	infantile colic	0
chinese cinnamons	lead poisonings	0
handling food	monocular blindness	0
flesh foods	ciguatera poisonings	0
jasmine tea	hemicrania	0
vaccinium virgatum	mptp-induced experimental parkinsonism	0
vodka	fatigue	0
buttermilk	cervix cancer	0
bt corn	cancer of esophagus	0
common olive tree	postviral fatigue syndrome	0
flowering shrub	infectious disease	0
exotic fruit	migraine variants	0
hemp plant	vaginal discharge	0
no noni	renal cancer	0
citrus reticulatas	meningiomatose	0
experience food	craniocerebral trauma	0
shoot	galactose 1 phosphate uridyltransferase deficiency	0
drinking coffee	bladder tumor	0
star anise	epileptic seizure	0
official vitamin	resting tremors	0
theobroma cacao	cancer of skin	0
foenumgraecum	goiter	0
saffron	hypovolemic shock	0
kava	delusional parasitoses	0
ketchup	benign brain neoplasm	0
cola acuminata	pyorrhea alveolaris	0
sandwich	clonic seizure	0
carya illinoensis	saccular aneurysm	0
beetroot	renal cancer	0
cicer	bone fracture	0
rooibos tea	familial diffuse gastric cancer	0
prunus salicinas	memory losses	0
plaice	transmissible dementia	0
rosehip	heatstroke	0
illicium verum	upper respiratory infections	0
organ	gnathostoma infections	0
pureed apples	disrupted in b-cell malignancy	0
wheat	myelomatosis	0
poppy seed	muscle tenderness	0
halibut	substance dependence	0
hamburger	lobar pneumonias	0
zea	recurrent brain tumor	0
dried apples	udp-galactose-4-epimerase deficiency	0
pimpinella anisum	adenomatous polyp	0
raw foods	ocular headaches	0
pizza	pancreatic neoplasm	0
meal	wart	0
not-necessarily-so-healthy foods	gall bladder diseases	0
adding blueberries	urinary bladder neoplasm	0
spearmint	ekbom delusory parasitosis	0
raphanus sativus	carotid sinus syncope	0
pleurotus	gastroenteritide	0
wild bananas	bewilderment	0
organic food	acute monocytic leukemias	0
jambolan plum tree	tactile hypesthesia	0
agave	occipital traumas	0
pie	intracranial cns disorders	0
areca catechu	inflammatory bowel disease 1	0
mustard greens	insulin dependent diabetes mellitus	0
meal times	cancer of endometrium	0
prunus persica	cysticercosis	0
spaghetti	hypoxemia	0
herb	nerve tremors	0
holy basil	fibromyalgia	0
ready-to-eat meal	varicose veins	0
shan yao	breast fibrocystic disease	0
baker's yeast	motor seizure	0
salmonella food	leukovirus	0
chamomile oils	human immunodeficiency virus	0
banana plant	toxic megacolon	0
human milk	alopecia cicatrisatas	0
honey	shock	0
apricot	penile cancers	0
snack foods	prostatic adenoma	0
cooked broccoli	arrythmia	0
pleurotus ostreatus	gingivitide	0
sesame oil	venereal wart	0
vaccinium bracteatums	tubal abortions	0
hot peppers	diverticula	0
mayo	pruritis	0
althea officinalis	cerebrovascular accident	0
acer	sclerosis	0
food allergy	germinoblastoma	0
white mallow	kidney calculus	0
oolong tea	somatosensory seizure	0
soy foods	postviral fatigue syndrome	0
raw cranberries	trochanteric fractures	0
sweet potatoes	zoonosis	0
raw meat	water borne hepatitis	0
cucurbita	thyroid cancers	0
colorful foods	continuous tremor	0
red meat	atrial fibrillation	0
persea americanas	intermittent tremor	0
flavorer	deep venous thrombosis	0
black teas	idiopathic polymyositides	0
soft drink	udpglucose hexose 1 phosphate uridylyltransferase deficiency	0
nettle tea	colonic cancers	0
cumin	fibrose	0
eating fruits	halitose	0
daily fruit	cancer of the ovary	0
suggesting apple	gnathostomiasis	0
squash	sliding esophageal hernia	0
curcuma longas	kahler disease	0
hashish	hormonal dysfunction	0
carrot	endometrioma	0
watermelon	visual seizures	0
shiitake mushrooms	chronic b-cell leukemias	0
california avocado	lymphatic sarcomas	0
baby formula	intractable headache	0
pistacia lentiscus	inflammatory demyelinating polyneuropathy	0
yam	intraepithelial neoplasm	0
applesauce	post-traumatic osteoporoses	0
decaf	hypercholesterolemia	0
rubus	cluster headache syndrome	0
black coffee	cerebrovascular stroke	0
bitter orange trees	male sub fertility	0
soy bean curd	bruise	0
fresh fruits	arthrose	0
probiotic	uterus neoplasms	0
organic plants	national cancer	0
usda poultry	fibromyositis-fibromyalgia syndromes	0
liquor	diarrhea	0
pomelo tree	blood cancer	0
solanum	open head injury	0
vaccinium corymbosum	pediatric cancers	0
celery	prostatic cancers	0
brassica nigra	urinary tract infections	0
tisane	hypovolemic shock	0
kiwi	bovine spongiform encephalitis	0
acer saccharums	substance use disorders	0
plant-based foods	epilepsy	0
alcoholic beverages	occipital trauma	0
mentha	cancer of the brain	0
purple rice	fibroatheromatous plaque	0
sweet almond	cancer of thyroid	0
mother cells	seizure disorder	0
cannabis indica	kidney insufficiencies	0
plantago seed	udpglucose hexose 1 phosphate uridylyltransferase deficiency	0
concord grape	pus	0
chenopodium quinoa	premenstrual tensions	0
juglans regia	igf-1 deficiency	0
legume pods	campylobacter infections	0
citrus aurantiifolias	lymphoplasmacytoid lymphoma	0
rubus glaucus	sterility	0
soda water	social anxiety disorder	0
lunch times	pseudopelade	0
phaseolus vulgaris	blood cancers	0
fig	renal cancer	0
watercress	palmoplantaris pustulosis	0
burrito	retroviridae	0
jam	androgenic alopecias	0
convenience foods	cancer of brain	0
snacktime	develop cancer	0
soy yogurt	classic galactosemia	0
st. johnswort	prion disease	0
fagopyrum esculentum	atypical chronic myeloid leukemia	0
fragaria	influenza	0
emphasize plant	neurodegenerative disorders	0
turmeric	germinoblastoma	0
soy proteins	olfactory groove meningioma	0
snack food	foreign object	0
contaminated foods	action tremors	0
grape seeds	skin rash	0
powdered sugar	body weights	0
rose hips	small non-cleaved-cell lymphoma	0
horsemeat	human flu	0
vegetable oil	exudative bronchiolitides	0
sun-dried raisin	social anxiety disorders	0
mustard plant	adenovirus	0
lavandula	sleep initiation dysfunction	0
edible grain	hansen disease	0
laciniate nightshades	intermediate grade lymphoma	0
rice milk	age-related osteoporoses	0
yolk	lung disorders	0
saint john wort	congenital defect	0
cereal	post-traumatic osteoporosis	1
cider	arthritis	0
musa	bladder tumor	0
alcoholic beverage	familial dementia	0
citron tree	sciatic neuralgias	0
spice turmeric	venous thrombosis	0
flounder	cancer of esophagus	0
no-calorie sweeteners	guam disease	0
osmanthus	undifferentiated carcinoma	0
cabbage	horton's syndrome	0
white tea	stomach cancer	0
zucchini	landry guillain barre syndrome	0
illicium verums	muscle sorenesses	0
bacon	limb tremors	0
nori	abdominal aortic aneurysm	0
thymus vulgari	rupture	0
sushi	amyotrophic lateral sclerosis-parkinsonism-dementia complex 1	0
eating nuts	cerebral stroke	0
abelmoschus esculentus	lung inflammations	0
prunus domestica	infant gynecomastia	0
fructose corn	drug hypersensitivity	0
carduus marianus	ramsay hunt paralysis syndrome	0
carbonated beverage	kidney insufficiency	0
cannabis	foodborne botulisms	0
milk proteins	tumorigenesis	0
cherry plum tree	benign essential tremors	0
kola nut	chronic fatigue-fibromyalgia syndromes	0
grape juice	sneezing	0
euterpe precatoria	small round structured viruses	0
citrus	cystic disease of breast	0
pummelo tree	juvenile onset diabetes mellitus	0
butter milk	reducing cancer	0
higher vegetable	primary brain tumors	0
hibiscus cannabinus	diabetes-related complication	0
carbonated beverages	heat strokes	0
fiddlehead ferns	acute coryza	0
breast milks	spindle cell carcinoma	0
trace elements	gastroenteritide	0
faba bean	uterine cancer	0
black rice	cardiovascular disease	0
food poisoning	sudden cardiac death	0
fennel seeds	acute cerebrovascular accidents	0
triticum spelta	pleomorphic lymphoma	0
squid	common cancers	0
refined olive	intermediate-grade lymphoma	0
melissa	allergic reaction	0
poultry product	mucous colitides	0
sweeten	lung neoplasms	0
garcinia mangostana	vestibular seizures	0
kavas	aortic aneurysm	0
sugar substitute	uterine fibroids	0
triticum	norovirus	0
solanum tuberosum	ankylosing spondylitis	0
deli meat	tonsillar cancers	0
thymus plants	broken bone	0
lime	short sleep phenotype	0
petroselinum crispums	pancreas neoplasm	0
true nut	hortons syndrome	0
sea food	disc degenerations	0
cinnamomum zeylanicum	hypersensitivity	0
mangifera indica	diffuse mixed small and large cell lymphoma	0
citrus reticulata	pulmonary inflammation	0
dried fruits	rhabdomyolys	0
olive family	transmissible dementias	0
red pepper	clonic seizure	0
tumeric	pulmonary disease	0
aquatic food	cramp	0
pithecolobium	multiple head injury	0
brassica	global amnesias	0
curry powder	pseudoaphakia	0
ready-prepared foods	urticaria	0
healthiest vegetable	gnathostomiasis	0
pimiento	insulin dependent diabetes mellitus 1	0
cherry	diabetic asymmetric polyneuropathy	0
garcinia mangostanas	ciliary neuralgia	0
family vegetables	continuous tremor	0
fava bean	disc degenerations	0
pistachio	oxygen deficiency	0
pistachio nut trees	spinal meningiomas	0
rose	sharp headaches	0
cayenne peppers	zoonotic disease	0
caramel	subacute spongiform encephalopathy	0
arachis	jakob-creutzfeldt disease	0
cassia cinnamon	arthritide	0
goji berry plants	somatotropin hypersecretion syndrome (acromegaly)	0
tepary beans	prostate disease	0
raphanus raphanistrum	confusional states	0
pomelo trees	heart disease	1
tachigalia	central nervous system cysticercosis	0
ready soybeans	botulism	0
trace element	malignant meningioma	0
restructured meat	arthropathy	0
concord grapes	mental deteriorations	0
maguey	gastric cancers	0
ginger	tongue cancer	0
punica granatum	auriculo ventricular dissociation	0
bitter nightshade	gout	0
glycyrrhiza glabra	fine tremor	0
stem vegetables	cancer of lung	0
papaver	cot deaths	0
preserved foods	inappropriate gh secretion syndrome (acromegaly)	0
flax	intraventricular meningioma	0
red onions	regional ileitis	0
endive	infant botulisms	0
artificially-flavored corn	stroke	0
sea-food	pharyngitis	0
organ meats	acute confusional migraines	0
maize oil	anaplastic carcinoma	0
convenience food	widespread chronic pains	0
gluten-free diet	gestational diabetes	0
animal-based vitamin	premature births	0
fresh ginger	birth weights	0
mastic tree	high-grade lymphomas	0
rosa	intracranial cns disorders	0
elettaria cardamomum	torsion fractures	0
specific cheeses	mottled enamels	0
marshmallow	subwakefullness syndromes	0
empty calorie foods	retained surgical tools	0
cucumis melo	impaired sensations	0
açai berry	dissociative amnesia	0
eating food	gastric neoplasms	0
garbanzo	chronic obstructive pulmonary disease	0
food supplement	age related memory disorders	0
purine-rich plant	bleed	0
dried peas	texidor twinge	0
lettuce	chronic pains	0
citrus bergamias	dental plaque	0
brinjal	forehead traumas	0
flaxseed	mammary cancers	0
croaker	convulsive seizures	0
hawthorn	substance induced organic mental disorders	0
supper	liver failure	0
black tea	atrioventricular dissociation	0
extracted fruit	bilateral deafness	0
roselle	chronic insomnia	0
chinese cassia	urinary bladder diseases	0
clove	diabetic neuralgia	0
humulus	age related bone loss	0
regular carrots	age-related maculopathy	0
brown sugar	gout	0
inadequate fruit	sharp headaches	0
low meat	familial creutzfeldt-jakob disease	0
tangerine trees	common bile duct biliary calculi	0
plant capsule	chronic obstructive airway disease	1
frozen spinach	tor-driven diseases	0
carbonated mineral water	diffuse mixed small and large cell lymphoma	0
petroselinum	human immunodeficiency viruses	0
peach tree	intention tremor	0
psidium	tonsil neoplasm	0
cocoa	essential tremors	0
kawa kawas	galt deficiency	0
prunus dulcis	headache disorder	0
lemon balm	brain vascular accident	0
citrus aurantiums	develop cancer	0
weed	pruritus	0
drink tea	age related maculopathy	0
maraschino cherry	ciguatera fish poisoning	0
citrus sinenses	heart decompensation	0
animal food	cervicitis	0
sweet almonds	sleep disorder	0
dragon fruit	infantile colic	0
aloe	psychotic disorder	0
vaccinium macrocarpon	prostatic intraepithelial neoplasia	0
sorrel	paraesophageal hernia	0
sweet foods	drug abuse	0
paprika	gallbladder disease	0
mustard oil	amyotrophic lateral sclerosis with dementia	0
beef	tying disease	0
blossom	intraventricular meningioma	0
warm milk	chronic b lymphocytic leukemia	0
rabbit meat	parkinson disease 2	0
purslane	deep vein thrombosis	0
kiwi fruits	male breast tumor	0
plant-based nutrients	ciguatera fish poisonings	0
acaí berries	schizophrenic disorders	0
nut bar	dysmenorrhea	0
split pea	infertility	0
beta vulgari	vitamin deficiency	0
açaí berries	circulatory failure	0
walnut oil	neurocysticercose	0
portulaca oleracae	transmissible spongiform encephalopathy	0
tempeh	hyperpigmentation	0
euterpe oleracea mart.s	alopecia	0
psidium guajavas	acute stroke	0
red lentils	dims (disorders of initiating and maintaining sleep)	0
topical ginger	nonhodgkin lymphoma	0
milk protein	myelopathy	0
kava kavas	excess cancer	0
chilli pepper	mouth cancers	0
toxic plants	cervix neoplasms	0
wild celery	bacteriophage	0
rubus fruticosus	enzootic bovine leukoses	0
horse beans	chronic fatigue-fibromyalgia syndrome	0
mustard seeds	right sided heart failure	0
marsh mallows	endometriose	0
include flaxseed	intractable headaches	0
safflower oil	cervical migraine syndromes	0
chewing gums	parasagittal meningiomas	0
century plants	endometrial neoplasms	0
pomegranate seeds	hemolytic jaundices	0
taro	kidney neoplasms	0
mint	aura	0
citrus x paradisi	diabetic complications	0
flax seeds	premature birth	0
high-fructose maize syrup	burn	0
cocos nuciferas	ekbom delusory parasitosis	0
drinking water	experimental parkinson disease	0
petroselinum crispum	nanism	0
ale	cancer of uterus	0
citrus bergamia	reverse cancer	0
acai berries	cerebrovascular stroke	0
morinda citrifolia	viral infection	0
prenatal vitamins	ovary neoplasm	0
callerya	somatotropin (acromegaly) hypersecretion syndrome	0
pimenta officinalis	toxic megacolon	0
star anises	galactosemia	0
chai tea	hepatic neoplasms	0
steak	reproductive sterility	0
colophospermum	prion-induced disorders	0
baked potato	auditory seizure	0
green onions	water stress	0
international nut	colorectal tumors	0
rooibos	penile cancers	0
mirobalanus embilica	meningiomatose	0
green lentils	anoxia	0
lens culinari	osteoarthrosis	0
real chocolate	adenoviridae	0
bamboo shoots	contusion	0
nuclear power plant	myocardial ischemias	0
raw tomatoes	chronic fatigue disorders	0
cassia trees	lichen planus	0
cappari	htlv-iii	0
nut butters	trochanteric fractures	0
ilex paraguarienses	heart diseases	0
taking vitamin	campylobacter infection	0
mussel	menstrual pain	0
bibhitaki fruit	coarse tremors	0
morning meal	prostate neoplasm	0
lemongrass	thyroid neoplasms	0
roughage	malignant primary brain tumors	0
brazil nuts	cancer of the endometrium	0
chenopodium quinoas	auto-immune diseases	0
chickpea	cva (cerebrovascular accident)	0
antioxidant-rich foods	exanthem	0
study lavender	diabetic neuralgias	0
piper methysticums	hiatus hernias	0
nutraceutical	retained surgical needles	0
butter	cognitive impairments	1
celery root	atopic disease	0
curried tofu	bses (bovine spongiform encephalopathy)	0
vitis	endometrium cancers	0
ocimum tenuiflorum	reticulum-cell sarcomas	0
honeybush tea	dental plaque	0
eupatorium rebaudianums	intermediate-grade lymphomas	0
processing meat	infertility	0
frying foods	breast fibrocystic changes	0
poppy	feline lymphoma virus	0
offal	metabolic acidosis	0
alfalfa sprouts	gingivitis	0
domestic fowl	continuous tremors	0
olive oils	gestational diabetes mellitus	0
nightshade	polyradiculoneuropathy	0
tomato juice	liver neoplasm	0
maize	posterior fossa meningiomas	0
mackerel	postural syncopes	0
citrus medicas	cancer of tongue	0
catfish	fibrocystic changes of breast	0
peanut	colorectal neoplasm	0
oyster mushroom	somatotropin (acromegaly) hypersecretion syndromes	0
commercial milk	somatotropin hypersecretion syndromes (acromegaly)	0
eragrostis	cognitive declines	0
cow's milk	contagious pustular dermatitis	0
plant embryo	polyphagia	0
roundup-ready soybeans	pharyngitis	0
organic meat	retained surgical needle	0
sea vegetable	cough	0
dietary plant protein	oncogenic virus	0