
dietary plant proteins	cystic breast disease
french bean plant	baldness
mustard greens	gastroesophageal reflux disease
tea	breast malignant neoplasm
dark meat	foreign bodies
citrus grandis	neuritic plaques
saffron crocus	neurologic degenerative disease
acer negundo	muscle pain
breast milks	nonalcoholic steatohepatitides
mint tea	legal blindness
woodland strawberries	encephalon disease
shiitake mushroom	kidney cancer
specific cheeses	strains and sprains
boiled broccoli	vulva neoplasm
vegetarianism	atherosclerotic plaques
hemlock	drug allergies
triticum spelta	dermatozoic delusion
deli meat	hyperventilation syncopes
berberi	uterine cervical neoplasms
asparagus	constrictive bronchiolitis
wine	elevated cholesterols
capparis	terminal ileitis
solanum laciniatums	burkitt lymphoma virus
pithecolobium	familial tremor
density foods	age-related memory disorder
indian corn	flatulence
vaccinium corymbosum	subacute spongiform encephalopathy
artificial butter	gehrig disease
baby carrots	crushing skull injury
food allergies	cardiac arrhythmia
vaccinium bracteatum	neonatal tremors
red meat	disc degradations
cider	prostate neoplasm
parsley	lobar pneumonia
punica granatums	micturition syncope
sweetening agent	smell disorders
cucumis melos	stomach cancer
french bean plants	sphenoid wing meningioma
apium graveolens var. rapaceum	sudden-onset diabetes mellitus
zinger tea	prion protein disease
grapefruit juice	uterine fibroma
healthy fruit	muscle tremors
prunus cerasifera	pancreatic neoplasm
lunchtime	laron syndrome
glucose-fructose syrup	apnea
moose meat	legal blindness
organic plants	hyperthermia
sweetleaf	human papilloma virus
avenas	terminal cancer
fragaria	tonsillar cancer
brown rice	ekbom delusory parasitosis
national pork	brain neoplasms
citrus fruit	autosomal recessive juvenile parkinson disease
decrease meat	acidose
amlas	brain disorder
soy bean proteins	human cancer
euterpe precatoria	age-related bone loss
chili	parietal region trauma
high-fructose corn	stomach cancer
exotic fruit	action tremor
dietary sucrose	alopecia cicatrisatas
potassium-rich foods	enterocele
orange trees	anaplastic carcinoma
cold-steeping tea	senile plaque
chili pepper	benign prostatic hyperplasia
nicotiana tabacum	pulmonary disorder
brassica juncea	open head injury
marihuana	colicky pains
ultra-processed foods	plasma-cell myelomas
beta vulgaris	weight gain
cocoa powders	acute monocytic leukemias
spinacia oleracea	intention tremors
artificially-flavored corn	dna injuries
ground ginger	confusional state
peppermint	apnea
marjoram	periorbital headaches
purple potatoes	spatial memory disorders
plantago psyllium	urinary tract infection
orange juice	barretts syndrome
tempeh	gastro-esophageal reflux
isoglucose	galactose-1-phosphate uridylyltransferase deficiency
sour cream	complications of diabetes mellitus
food additive	myocardial ischemia
hydroponic basil	galactose-1-phosphate uridylyltransferase deficiency
legume pod	mouth cancers
cereal grain	arthrosis
agent orange	low back aches
persea americanas	fibroid
pear	ductal carcinomas
pinto beans	effort syncope
oyster mushroom	leprosy
jambolan plum tree	benign brain neoplasms
purple grape	cancer of the tonsil
root	primary growth hormone resistance
specific foods	acquired immune deficiency syndrome virus
reason food	multiple meningiomas
salami	precordial catch
vaccinium ashei	kidney stone
porgy	degenerative arthritis
andira	deep vein thromboses
mandarin orange tree	temporary amnesias
cymbopogon	joint diseases
banana plant	peanut allergy
zingiber officinale	jaundice
digitalis purpurea	uterine cervical cancer
coffee	charcot disease
wild yam	melanoma
whole grain cereal	menstrual pains
fenugreek seed	mixed-cell lymphomas
empty calorie foods	neurological condition
solanum tuberosums	fibrocystic disease of breast
prunus salicina	chronic b cell leukemia
euterpe oleracea	iron deficiency
box elders	short sleeper syndromes
soy sauce	deep-venous thromboses
fiddlehead ferns	limb tremors
avena	carcinogenesis
pea	colon cancers
vegetable juices	parkinsonian disorders
butternut squash	muscular spasm
cured meat	involutional osteoporosis
almond oil	colitis gravis
toronja	disrupted in b-cell malignancy
assai palms	lung diseases
so-called vegetable	deep venous thrombosis
thymus vulgaris	brain malignant neoplasm
açaí berries	micturition syncopes
incorporate cloves	hyperemesis gravidarum
dripping	corpse
sweet almond	creutzfeldt jakob syndrome
sea vegetable	acquired deafness
plant zygote	mental deteriorations
apricot tree	asymmetric diabetic proximal motor neuropathy
drinking orange	morning sickness
california avocado	horton's syndrome
mentha spicata	androgenic alopecia
include fennel	dissociative amnesias
brewed coffee	severe congenital microcephaly
fresh fruits	amyotrophic lateral sclerosis parkinsonism dementia complex 1
handling meat	rectum neoplasm
golden delicious apples	oxygen deficiencies
black sapote	tumorigenese
pimenta officinali	experimental parkinson diseases
alcoholic beverages	johne's disease
tea plant	autosomal dominant juvenile parkinson disease
maize oils	motor seizures
jalapeno peppers	multiple myositides
swiss chard	abdominal migraine
frying meat	autosomal recesssive juvenile parkinsonism
whortleberry	forehead traumas
chilli pepper	diffuse small cleaved cell lymphoma
entree	endometrial carcinoma
saint johnswort	morning sickness
healthiest foods	gum disease
antioxidant fruits	prostatic adenomas
prunus salicinas	multiple sclerosis
vinegar	corpse
phyllanthus emblicas	crushing skull injury
horse bean	generalized seizures
mustard seeds	deficiency diseases
agave	kidney calculi
gmo soybeans	virus infections
aquatic food	ciliary neuralgias
cod	pancreatitis
java plum tree	cardiovascular stroke
rose	arthralgia
allium cepa	inflammatory diseases
rosa	burkitt's lymphoma virus
nutmeg	alopecia
milk thistle	olfactory seizures
whipped cream	high cholesterol levels
hibiscus tea	prostate disease
pimenta diocia	brain cancer
marijuana	postural syncope
common bean plant	vulva neoplasm
walnut oil	galactokinase deficiency disease
clathrotropis	lichen planus
pie	charcot disease
american meat	protein deficiency
include apples	stokes-adams syncopes
healthy snacks	tubal abortion
bellis	neonatal tremors
different seed	cancer-causing viruses
ice cream	gastric ulcer
avena sativa	spiral fractures
chia seeds	infantile obesity
neutraceutical	senile osteoporosis
molasse	cancer of the kidney
basil	diffuse lymphocytic lymphoma
antioxidant-rich food	galt deficiency
kombucha teas	galactose-1-phosphate uridyltransferase deficiency
flavoring	plasmodium infection
margarine	biliary calculi
cynara scolymus	lymphocytic lymphomas
rheum	senile osteoporosis
citrus aurantiifolias	chronic b-cell leukemias
buckwheat	vagina cancers
poultry meat	mental disorder
calendula	malignant epithelial tumors
eat flax	cancer of rectum
jell-o	chronic cluster headache
chicken	delusory parasitosis
musa	ankylosing spondylarthritides
texturized vegetable protein	posterior compartment low back pain
avocado fruit	rheumatoid arthritis
component spices	lead poisonings
sorrel	kill cancer
pimpinella anisums	brain disorder
anacardium	involuntary quivers
corn oil	histamine cephalgias
liquorice	chronic disease
vicia faba	congenital abnormality
trigonella foenum graecum	pruritis
justicia	parietal region trauma
cuminum	psychotic disorders
eupatorium rebaudianum	sick headaches
cannabi	polyradiculoneuritis
jelly	aortic aneurysm
abelmoschus esculentus	arthropathy
garlic	diffuse lymphocytic lymphoma
caffeinated coffee	metastasis
oregano	limb cramps
baptisia	male breast enlargement
ready-prepared foods	impotence
whole grains	breast pain
spore	bone neoplasms
food allergy	angioblastic meningioma
citrus	postviral fatigue syndromes
calendula officinalis	kidney calculi
regular olive	eczematous dermatitides
pineapple	retro-ocular headaches
mock meats	bacterial infection
soya milk	gall bladder disease
thymus plants	charcot disease
indian gooseberries	pancreas cancers
horsenettle	migraine disorders
cacao bean	prion induced disorder
illicium anisatums	splitting pain
citron tree	primary insomnia
pecan trees	meningioma
triticum aestivum	develop cancer
actual licorice	pregnancy-induced diabetes
uncooked food	lobar pneumonia
marshmallow	thyroid adenomas
sea bilberry	ankylosing spondyloarthritis
chewing gums	vagina neoplasms
beta vulgari	ph1 negative myeloid leukemia
red delicious apples	cancer of the uterus
glycyrrhiza glabra	muscle tremor
decaf	utp hexose 1 phosphate uridylyltransferase deficiency
food manufacturers	gall stones
acai berries	colon cancer
antioxidant food	diabetes related complications
pumpkin pie	pneumonia
norovirus food	mental deteriorations
citrus fruits	manic-depressive psychoses
almond	cancer of the rectum
actual fruit	cancer of the skin
infects apples	reticulum-cell sarcomas
fruit and vegetable juices	pulmonary embolisms
lens culinari	inflammatory demyelinating polyneuropathy
seven nutrients	bone fracture
tea hibiscus	paroxysmal atrial fibrillations
cycad	parkinsonism-dementia complex of guam amyotrophic lateral sclerosis
frozen cranberries	colon disease
afzelia	progressive disorder
kidney bean	juvenile-onset diabetes mellitus
cuminum cyminums	social anhedonias
ready soybeans	chronic lymphocytic leukemias
eugenia jambolana	cellulite
saccharomyces cerevisiae	sciatica
eugenia cumini	idiopathic polymyositides
celery	prelingual deafness
high fructose corn syrup	small lymphocytic lymphoma
lard	burkitt's lymphoma virus
cicer arietinums	thyroid neoplasm
peppermint oil	deep-vein thrombosis
english walnut	ruptured appendicitis
brown sugar	arterial dysfunction
hot pepper	ekbom delusory parasitoses
espresso	oncogenesis
pistachio	intervertebral disk degeneration
mentha piperita	familial creutzfeldt jakob disease
yam	central nervous system cysticercosis
new york coalition for healthy school food	cancer of the bladder
green lentils	atrial fibrillation
oregano plants	gastro oesophageal reflux
pimpinella	intention tremors
sesame oil	primary insomnia
pistacia	bacterial infection
chard	infectious disease
pumpkin seeds	gingivitide
mastictree	airsickness
baby spinach	stokes-adams syncopes
golden delicious	spongiform encephalopathies
açaí berry	fibromyalgia-fibromyositis syndromes
paprika	e b virus
petroselinum crispums	prostate cancers
ephedra	fibroid tumors
rabbit meat	cancer of the testes
citron trees	epithelioma
kiwi fruits	thyroid disease
pimenta	intervertebral disc degenerations
origanum onites	udp-galactose-4-epimerase deficiency
fagopyrum sagittatum	physical sufferings
dried yeast	cancer of the lung
bread mold	small round structured viruses
monitoring food	headache disorders
vegetable oil	alactasia
sun-dried raisin	growth hormone insensitivity syndrome
prunus armeniaca	arthralgia
white meat	nausea
eragrostus	back pain with radiation
seville orange trees	age-related osteoporosis
retail poultry	transmissible dementias
capsicum annuum	cognitive impairment
brazil nuts	dysosmia
cinnamomum cassia	neuralgic migraine
turmeric root	pulmonary neoplasms
marsh mallows	thyroid neoplasm
shoot	abdominal cramps
bitter nightshade	primary malignant brain neoplasms
bertholletia excelsas	cellulite
caramel	kanner's syndrome
processed apples	gastric neoplasm
eat chocolate	parkinsonian syndromes
gooseberry	guam form amyotrophic lateral sclerosis
illicium anisatum	familial atrial fibrillations
molasses	heartburn
pimpinella anisum	burkitt's lymphoma virus
flowering shrub	intraorbital meningiomas
english plantains	acute strokes
chile peppers	feline leukemia virus
foodstuff	dims (disorders of initiating and maintaining sleep)
frying foods	iritide
aubergine	premenstrual tensions
bok choy	intraepithelial neoplasm
pepper	dysmenorrhea
malabar-nut	ulcerative colitis type inflammatory bowel disease
humulus lupulus	atherosclerosis
table sugar	strains and sprains
teff	cancer of the thyroid
durum wheat	microcephaly
ceratonia	radiating pain
noncaloric sweetener	tubal abortion
ganja	pustulosis palmaris et plantaris
processed food	male breast tumor
cocktail	intraepithelial neoplasms
hibiscus	peanut allergy
dairy eggs	diabetic neuralgias
brassica nigra	vaginal cancers
fagopyrum tataricum	episodic cluster headache
calling eggs	left-sided heart failure
syzygium jambos	utp hexose 1 phosphate uridylyltransferase deficiency
spice saffron	weight reductions
plant kingdom	liver dysfunction
low-salt diet	myeloma-multiple
syzygium sandwicense	semantic memory disorder
wheat brans	adenovirus
soda pops	vulva cancer
mastic trees	abdominal migraine
cooked meat	venous thromboses
pepsi	cancer of ovary
ranking foods	cancer of rectum
suggesting fruit	dyschezia
supper	prostatic neoplasm
coca cola	senile plaques
consumer protection scientific committee on food	v cjd (variant creutzfeldt jakob disease)
favorite meals	vaginal discharge
smoked food	type 1 diabetes mellitus
sugar substitute	auto-immune disease
tv dinners	liver steatosis
mangifera	penile cancer
euchresta	head traumas
turmeric	spinal cord disease
celebration meal	autosomal dominant parkinsonism
bolete	hemorrhoid
dietary soybean proteins	brittle diabetes mellitus
black teas	pseudocoma
cabbage	diffuse well differentiated lymphocytic lymphoma
rose berries	growth hormone insensitivity syndrome
split pea	malignant meningioma
dasheen	hemolytic-uremic syndrome
no coffee	prediabete
prunus domestica	jakob creutzfeldt disease
horse nettle	t virus
humulus	spontaneous abortions
brassica napus	acute monocytic leukemia
maize syrup	neonatal tremor
plantago arenaria	amentia
white mallow	huntington’s disease
plantago ovata	congenital abnormalities
organic food	fibromyalgia
syzygium cumini	mania
bad foods	sphenoid wing meningioma
eragrostis	rectal tumors
rubus	essential tremors
mashed potatoes	somatotropin (acromegaly) hypersecretion syndrome
drinking coffee	growth hormone receptor defect
teosinte	crohns disease
fried foods	lymphadenopathy-associated viruses
restructured meat	deep-venous thrombosis
concord grapes	primary fibromyalgias
cassia trees	heart diseases
dietary fibers	psammomatous meningiomas
muffin	lymphadenopathy-associated viruses
exotic fruits	ciliary body spasm
sweet basil	schizoaffective disorders
jasmine tea	atypical cluster headaches
lentinus edodes	arrhythmia
bagel	tongue cancers
garcinia mangostanas	autosomal recessive juvenile parkinsonism
black currant	kidney failure
macadamia	darkness tremors
raw poultry	laron dwarfism
dietary supplement	heat stroke
red cabbage	somatosensory seizure
wild radish	burkitt herpesvirus
trigonella foenum-graecum	disc degradations
psidium	degenerative intervertebral discs
lemon balms	arthralgia
carbonated beverages	cardiac failure
dragon fruit	transmissible dementia
coriander	common cold
frier	esophageal neoplasm
foie gras	retained surgical instruments
fries	gall stone
brewing tea	viral disease
sweet peppers	cranial pains
rubus fruticosus	congenital hypothyroidism
uncooked foods	massive tremors
elettaria cardamomum	early infantile autism
eugenia jambos	myelomatosis
capsicum	female infertility
soy food	uveitis
kenaf	xanthomatous meningiomas
pleurotus	juvenile onset diabetes
crab apple	tonsillar cancer
meal time	allergic reaction
store licorice	cerebral convexity meningioma
piper nigrum	early diagnosis of cancer
lycium barbarum	substance use disorders
dairy products	reduced sensations
processed meats	hormonal dysfunction
corn syrup	sensory seizure
carbonated drink	diabetic mononeuropathy simplex
cucumber	parasagittal meningioma
alpine strawberry	chronic b-cell leukemias
french fries	human immunodeficiency virus
squash	status migrainosus
natural vitamin	e b virus
fake meat	juvenile onset diabetes mellitus
apium graveolens var. dulce	endocrine breast disease
bean	zoonotic infectious disease
banana	plasmodium infections
bergamot	peanut allergies
so-called meat	tumor viruses
club sodas	unhealthy conditions
carrot juice	diabetic mononeuropathy
zedoary zedoarias	lung inflammations
hemp plants	pulmonary diseases
cicer arietinum	neurodegenerative disorders
floret	udp-galactose-4-epimerase deficiencies
syzygium jambolanum	peripheral artery disease
romaine	zoonotic infectious diseases
saint john's wort	spinal cord disease
green peas	prostate neoplasm
halibut	ischemic heart diseases
cayenne peppers	preinvasive carcinoma
lens plants	somatosensory seizures
aspalathus linearis	human cancer
andropogon nardus	early detection of cancer
human milk	pancreatic cancer
healthiest vegetable	small and large cleaved-cell lymphoma
crataegus monogynas	deep vein thromboses
prosopis	lymphadenopathy-associated viruses
overpriced vitamin	ekbom delusional parasitoses
curcuma longas	deep-venous thromboses
bamboo shoots	chronic headache
bell peppers	congenital abnormality
food pyramid	benign prostatic hypertrophy
snacktime	lung disease
dried foods	hiv
solanum dulcamara	mucous colitides
apricot trees	autoimmune diabetes
triticum durum	tumorigenese
sprout	experimental parkinson diseases
snail meat	stroke
cassia fistula	intracranial neoplasms
kiwi fruit	neurodegenerative disease
willow tree	clonic seizures
chickpea	multiple meningioma
ephedras	jakob creutzfeldt syndrome
suggesting apple	ebv
meal	ramsay hunt paralysis syndrome
althaea officinalis	lichen ruber planus
cola nitida	somatosensory seizures
wheatgrass	osteoporose
ready prepared foods	meningotheliomatous meningioma
peach tree	chronic cystic mastitis
gluten	subacute spongiform encephalopathy
sunchoke	phage
chinese food	transmissible dementia
kavas	leukemia
areca catechu	complete hearing loss
beef	venous thromboses
squash seeds	smell disorders
citrus maxima	sleep disorder
prosopi	diffuse myofascial pain syndrome
pomegranate	precordial catch
smoked foods	primary fibromyalgia
chinese cinnamon	cerebrovascular apoplexy
beet	irritable bowel syndromes
horse nettles	primary brain tumors
beer	somatotropin hypersecretion (acromegaly) syndromes
rose hips	drug allergy
milk	deaf mutism
pancake	joint diseases
nightshade	parkinsonism-dementia complex of guam amyotrophic lateral sclerosis
linum usitatissimums	lymphoma
soy proteins	sudden infant death
dog rose	diabetic complications
carya illinoensis	acute fulminating multiple sclerosis
common plant	angioblastic meningioma
eating food	intraepithelial prostatic neoplasias
dietary fiber	diabetes related complications
coriandrum	myocardial infarctions
healthy foods	back pain with radiation
areca	cll lymphoplasmacytoid lymphomas
organ	post ictal confusion
official vitamin	posterior fossa meningiomas
baby formulas	scurvy
radish	feline lymphoma virus
chai tea	cholera
hop	colorectal carcinoma
oatmeal	drug habituation
citrus hystrix	foreign object
liquor	cancer of the penis
hibiscus sabdariffa	hypoascorbemia
cruciferous foods	continuous tremor
green grapes	thrombus
mint	uterine fibroids
edible grains	atherosclerotic plaque
cultivated radish	juvenile onset diabetes mellitus
tuna fish	osteoarthrosis deformans
portulaca oleracae	drug hypersensitivities
maraschino cherry	muscular rheumatism
silybum marianum	polyradiculoneuropathy
fenugreek	malignant epithelial neoplasm
chestnut	heat stroke
collard greens	cancer of the breast
lentil	urinary bladder cancer
amaranth	jaundice
healthy snack	sudden-onset diabetes mellitus
red tea	muscle pains
including cloves	focal seizures
indian laburnum	membranous cataracts
sockeye salmon	legal blindness
abelmoschus	severe mental disorder
lucerne	urinary bladder neoplasms
red yeast rice	severe mental disorder
maple syrup	lactose malabsorption
gala apples	mixed lymphocytic-histiocytic lymphoma
vicia fabas	arthralgia
elettaria cardamomums	hemorrhage
junk food	arthritis
jelly beans	sciatica
celeriac	gehrigs disease
organic meat	lymphadenopathy-associated viruses
dandelion	paratuberculose
extracted fruit	guam form amyotrophic lateral sclerosis
acid-binding vegetables	testicular cancer
eugenia malaccensis	small non cleaved cell lymphoma
poultry products	lung neoplasms
safflower oil	cancer of the uterine cervix
anise	prostatic intraepithelial neoplasms
psyllium	chronic b-lymphocytic leukemia
lipomul	headache
mirobalanus embilicas	foreign objects
sour fruit	burkitt herpesvirus
grape	obesity
toxic plant	recurrent low back pain
frosting	aphthous ulcers
hypericum perforatum	crohn’s disease
ready-to-eat meals	benign prostatic hypertrophy
purple rice	breast tumor
rosemary	diverticula
baked potato	cervix cancer
sugar substitutes	auriculo ventricular dissociation
raw alfalfa	gluten-sensitive enteropathy
glycine max	kahler disease
cinnamon	age related maculopathies
hordeum	colonic cancer
bran flakes	pustulosis palmaris et plantaris
bottled water	terminal cancer
miso	lymphatic sarcoma
dried cranberries	fibrose
brewage	intractable headaches
arachis hypogaea	scurvy
vital nutrients	brain malignant neoplasm
frozen fruit	diverticulitis
portulaca oleracea	proteinuria
dioscorea polystachya	flatulence
curcuma	chronic fatigue syndromes
junk foods	varicose vein
black coffee	gingivitide
punicaceae	spondylarthritis ankylopoietica
opium poppies	human t-cell leukemia virus type iii
purple cabbage	pyrosis
black pepper	malignant brain neoplasms
lima beans	posterior compartment low back pain
lunch times	cancer of endometrium
elettaria	age-related macular degenerations
nicotiana tabacums	gastro-oesophageal reflux
brussels sprouts	brain malignant neoplasm
nettle tea	varicose veins
citrus sinenses	chronic obstructive airway disease
blackberry	anhedonia
coriandrum sativum	ekbom delusory parasitosis
measuring food	bone neoplasms
lactuca sativa	primary malignant brain tumors
diospyro	steatohepatitide
haritaki fruit	painful diabetic neuropathies
taraxacum	generalized headache
baby formula	senile paranoid dementia
green teas	acute inflammatory polyneuropathies
pomelo tree	mouth cancer
rubus glaucus	cancer of ovary
fast foods	senile osteoporosis
cucurbita	cancer of the bone
flax seed	bronchiolitis
soy foods	autosomal recessive juvenile parkinsonism
ananas	male breast cancer
black raspberries	hemolytic jaundices
irritable bowel kiwi fruit	coma
high-fiber food	cancer-causing viruses
cycad trees	hyperventilation syncopes
sea vegetables	ischemic heart diseases
plantago lanceolata	deep venous thrombosis
justicia adhatoda	cephalgia syndrome
soda water	pruritis
fruit juice	ileocolitis
cookie	birth weight
pineapple juice	primary parkinsonism
anacardium occidentales	saccular aneurysm
tomato sauce	amnestic states
brew	visceral steatoses
curry	a v dissociation
yellow vegetables	olfactory groove meningioma
cucumis sativus	brain malignant neoplasm
origanum vulgare	brief reactive psychosis
canned food	age related memory disorders
melissa officinali	variant creutzfeldt-jakob disease
purslane	aortic aneurysm
okra	recrudescence
collard green	cancer of colon
citrus hystrices	spinal meningioma
broth	multiple sclerosis
frozen spinach	viral diseases
coleslaw	symptom clusters
cooked meats	multiple meningiomas
sesame oils	kidney insufficiency
mangiferas	complete blindness
garbanzo	rabies
taro	throbbing headache
eugenia sandwicensis	esophageal neoplasms
oxen meat	human herpesvirus 4 (gamma)
carbonated drinks	manic disorders
natto	post traumatic osteoporosis
maize	tonic clonic seizures
citrus sinensis	insulin deficiency
solanum melongenas	upper respiratory infections
snack foods	ciguatera poisoning
restrict food	cattle leukemia virus
food poisonings	dims (disorders of initiating and maintaining sleep)
recommend tea	mastitis
curry powder	gastric cancer
chinese yam	polyradiculoneuritis
white rice	brain disorder
healthiest nuts	myocardial infarction
milk thistles	gastro esophageal reflux
pyrus	epithelioid sarcomas
pistacia lentiscus	hypermelanosis
serve	norovirus
vaccinium uliginosum	marie struempell disease
vaccinium angustifolium	bacteria-eating virus
navy beans	endothelial dysfunction
antioxidant foods	bechterew disease
cocoa butter	national cancer
pistil	childhood onset obesity
amygdalus communis	tumor
fragaria vesca	pseudocoma
term vegetable	paraesophageal hernia
healthiest fruits	light headedness
bilberry	chronic b-lymphocytic leukemias
roundup-ready soybeans	drug allergy
malabar nut	intracranial cns disorder
curcuma longa	ileocolitis
dietary proteins	well-differentiated lymphocytic lymphoma
chinese yams	familial tremors
persea americana	cephalgia syndromes
sparkling water	diabetic complications
milk protein	psychogenic parasitoses
cantaloupe	dairy product intolerance
chenopodium quinoa	anal fissure
cooking meat	epithelioma
soup	sleep-related neurogenic tachypneas
raw garlic	heart block
solanum lycopersicum	marek's disease virus
monkfish	physical anhedonia
green beans	lung cancer
unrefined plant	congenital defects
andean blackberry	mucous colitides
low-calorie diet	colicky pains
hickory trees	colonic neoplasm
orange tree	static tremor
eating almonds	polyradiculoneuritis
arachis	stokes-adams syncopes
eden foods	left sided heart failure
squashe	bewilderment
shan yao	substance-induced organic mental disorders
century plants	amnesia-memory losses
high-fat meal	human papillomavirus viruses
acer negundos	irritable bowel syndromes
black currants	hemolytic jaundices
sauerkraut	crohn's disease
barley	tonic seizure
low-fat diet	near-death experience
croaker	ciliary body spasms
sesamum	high-grade lymphoma
wild celeries	brain disorders
legume family	canker sores
mango	hypolactasia
orange	posterior fossa meningioma
nicotiana	bacterial vaginitis
jambolan plum trees	rebound insomnia
poenumgraecum	ulcerative colitis
chenopodium quinoas	renal cancer
pumpkin	carsickness
goji berries	asymmetric diabetic proximal motor neuropathy
oryza sativa	diarrhea
leguminosae	reverse cancer
solanum melongena	epileptic seizure
sugar maples	fibrocystic breast disease
arginine-rich foods	manic-depressive psychoses
caryophyllus aromaticus	mixed-cell lymphomas
dietary fat	prostatic cancers
healthy food	acute coryza
nuclear power plant	hemicrania
artificial sweetener	abdominal cramp
fat milk	short sleep phenotypes
eating fruits	vitamin deficiencies
red onions	bovine lymphosarcomas
soft drink	udp-galactose-4-epimerase deficiencies
bitter nightshades	testicular cancers
euterpe	encephalon diseases
vitamin	human t cell lymphotropic virus type iii
sell meat	breast carcinoma
maguey	smell disorders
millet	motor seizure
pomegranate seeds	epstein-barr virus
daily fruit	premature birth
dried blueberries	obesity in adolescence
vaccinium myrtillus	male breast tumor
flaxseed	philadelphia-negative myeloid leukemia
poppy	hemangiopericytic meningiomas
kava kava	acute inflammatory demyelinating polyneuropathy
olive tree	drug hypersensitivity
thyme	brain neoplasms
secale	dims (disorders of initiating and maintaining sleep)
virgin olive	widespread chronic pains
potato chips	female pattern baldness
phaseolus vulgari	ileocolitis
punica granatum	texidor twinge
morinda citrifolias	neuralgic migraine
citrus reticulata	sleep related neurogenic tachypnea
fermented foods	small and large cleaved-cell lymphoma
psidium guajava	comatose
althaea	thyroid carcinomas
sticker	ankylosing spondylitis
domestic fowls	uterine fibroma
brain-invasive pork	coarse tremors
pummelo tree	abdominal cramp
lamb chops	drug use disorders
indian laburnums	soft tissue sarcoma
papaya	diabetic autonomic neuropathy
commercial milk	neurotic anxiety states
treat	small cleaved-cell lymphoma
berry	feminization
citrus reticulatas	ketosis-prone diabetes mellitus
solanum tuberosum	virus disease
cured meats	torsion fracture
betel nuts	human influenzas
coriandrum sativums	dyschezia
zea	parkinsonian syndromes
mesquite	oxygen deficiencies
tobacco	primary growth hormone resistance
cherry plum trees	cancer of the testis
deep-fry foods	galactose-1-phosphate uridylyltransferase deficiencies
quinoa	disrupted in b-cell malignancy
fava beans	male pattern baldness
coconut	reactive confusion
plantago indica	vertex headache
low fruit	non-hodgkin lymphoma
flax seeds	amyloidose
thymus	convulsive syncope
soybean proteins	acquired immunodeficiency syndromes
rheum rhaponticum	urinary bladder diseases
broccoli	parkinson’s disease
linum	necrotizing fascitis
glucose fructose syrup	upper respiratory infection
potable water	lyme disease
white tea	congenital defect
apple	autistic disorders
banana plants	pustulosis of palms and soles
chlorella	inherited human transmissible spongiform encephalopathies
dioscorea	neurodegenerative disorders
poppy seeds	prostate cancer
flavorer	sick headaches
watercress	animal viruses
caryophyllus	gluten-sensitive enteropathy
filtered coffee	wheat hypersensitivity
high-fructose maize syrup	cancer-causing herpesvirus
steamer	ankylosing spondyloarthritis
faba bean	bladder neoplasm
specific nuts	gangrene
andean blackberries	coarse tremors
candy bars	lobar pneumonias
stryphnodendron	pleomorphic lymphoma
dioscorea batatas	nonhodgkins lymphoma
citrus grandi	olfactory seizure
international nut	aortic aneurysm
cranberry	breast pain
mirobalanus embilica	proteinuria
raphanus	acute stroke
green onions	spondylarthritis ankylopoietica
marsh mallow	parodontosis
white potatoes	occipital region traumas
white bread	bacterial vaginitis
big meals	ischemic heart diseases
lavandula angustifolia	disc degenerations
olea	burkitt's lymphoma virus
anana	breast tumors
powdered sugar	cognitive retention disorder
healthiest beverages	single seizure
alfalfa	kill cancer
salmonella-infected eggs	histamine cephalgia
foeniculum vulgare	tongue cancers
star anise	rectal neoplasms
eggplant	cjd (creutzfeldt jakob disease)
apple tree	fissure in ano
salmonella food	chronic pains
hazelnut	sinusitis
lemon verbena	esophageal cancers
lycopersicon esculentum	wheat hypersensitivities
big food	small non-cleaved-cell lymphomas
euterpe edulis	cognitive impairment
sugary foods	pancreatic cancers
pea family	miscarriage
diabetic diet	age-related maculopathy
wort	kidney insufficiency
red delicious	colorectal tumors
pimenta diocias	hiatus hernias
yerba mate	germinoblastoma
syzygium malaccense	water-borne hepatitis
breakfast	galactokinase deficiency disease
bibhitaki fruit	cryptogenic epilepsy
butter milk	copd
chervil	esophagus cancers
dried apples	tonic seizure
fast food	burn
cinnamomum verum	penile cancer
fryer	epimerase deficiency galactosemia
nettle	early detection of cancer
food supplement	polyp
kawa kawa	renal calculi
chipotle	gasser syndrome
pimiento	degenerative diseases
citrus-based fruits	burkitt herpesvirus
anticancer plant	coma
rooibos tea	cellulite
fructose corn	periodontal disease
health nuts	menstrual pains
drinking water	spinal cord disorders
bitter orange trees	lewy body parkinson disease
sour orange trees	familial atrial fibrillations
deep-fried foods	subwakefullness syndromes
tachigalia	age related maculopathies
glycyrrhiza	thyroid carcinomas
lemon grasses	post-traumatic osteoporoses
cranberry sauce	gallbladder diseases
citrus bergamias	protein deficiencies
laudable legume	undifferentiated carcinomas
cleistocalyx	minor head injury
holy basils	tongue cancer
cooked broccoli	colorectal neoplasm
juglans nigra	pulmonary embolisms
pummelo trees	convulsive seizure
lunch time	soft tissue sarcoma
msg	cancer of mouth
red wine	auditory seizure
largest meal	burn
soda pop	tonsillar neoplasm
faba beans	prostatic hypertrophy
cicer	chronic cluster headaches
assai palm	lewy body parkinson's disease
convenience foods	unilateral headaches
stem vegetables	monocytic leukemia
tisane	vagina cancers
olive	psychogenic parasitoses
acer saccharums	tumor of rete testis
mayo	joint pains
organic foods	aphthous ulcers
mother cell	chronic obstructive lung disease
cow's milk	bovine leukemias
common fruits	liver dysfunction
gluten-free diet	rabies virus
infant formula	mesothelioma
hickory nut	secondary insomnia
lycium	soft tissue sarcoma
food additives	drug hypersensitivity
portulaca oleraceas	aneurysm
spearmint	ekbom delusory parasitoses
osmanthus	cancer of the vagina
phaseolus acutifolius	lou gehrig disease
table salt	respiratory tract infection
texturized soy protein	diabetic mononeuropathy simplex
squid	metastatic cancer
vitis	prediabetic states
ocimum tenuiflorum	vulva cancers
apium graveolens	olfactory seizure
whole wheat	parkinsonian syndromes
mangosteen	strains and sprains
steak	beriberi
porphyra	deficiency diseases
japanese plum	liver dysfunctions
raw food	substance use disorder
whole grain cereals	acquired blindness
pretzel	hepatitis
foenumgraecum	small noncleaved-cell lymphoma
horsemeat	gum disease
topical ginger	igf-1 deficiency
pecan	ovary neoplasm
oolong	ovary cancer
dried fruits	retroviridae
crowberry	pulmonary inflammation
shellfish	cephalodynia
turkey meat	myelomatose
dessert	ciliary body spasm
gravy	epithelioma
emblica officinalis	diabetic complication
high-phytate foods	acromegaly
horsebean	sleep related neurogenic tachypnea
carrot	post-ictal confusion
phytonutrient-rich food	senile plaque
cooked carrots	posterior fossa meningiomas
leaf lettuce	infectious virus
carbonated water	fibroatheromatous plaques
egg	galactose epimerase deficiencies
narrow-leaved plantain	primary growth hormone resistance
contamination meat	myocardial ischemia
common olive tree	lower back pains
sweet marjoram	feline lymphoma viruses
spice turmeric	encephalon diseases
yerba mates	prostatitis
purine-rich plant	myelomatose
olive oil	diffuse small cleaved-cell lymphoma
citrus medicas	ovary neoplasms
salt-free diet	growth hormone receptor deficiency
juglan	hair loss
flaked coconut	visual seizure
narrow leaved plantain	germinoblastic sarcomas
cocoa	tubal abortion
true nut	hypoesthesia
toxic plants	blindness
preserved food	human flu
pithecellobium	breast pains
ketchup	cardiogenic syncopes
filbert	insulin-dependent diabetes mellitus
organ meats	autosomal recesssive juvenile parkinsonism
cocoa powder	retained surgical item
pork	norwalk-like viruses
carica	human influenza
iv vitamin	venous thromboses
find pork	a v dissociation
nitrate-rich vegetables	foreign objects
dietary supplements	determination of death
papaver	perioral tremors
acer	osteoarthrosis deformans
almond milk	gasser syndrome
medicago sativa	zoonotic infectious disease
leafy vegetables	senile osteoporosis
mealtime	neurologic degenerative conditions
lemon trees	neoplasm
drinking milk	gustatory seizure
amorpha	udpglucose 4 epimerase deficiency disease
anchovy	bilateral headache
fresh basil	age-related memory disorder
no noni	kidney neoplasms
anise seed	precordial catch syndrome
wild bananas	single seizures
carbonated waters	autistic disorder
skim milk	low back pains
cocoa plant	sinusitis
olive oils	small and large cleaved-cell lymphoma
citrus limon	well-differentiated lymphocytic lymphoma
individual food	diffuse mixed cell lymphoma
cocos nuciferas	mixed lymphocytic histiocytic lymphoma
plum tree	cancer of stomach
ribe	senile osteoporosis
cocoa plants	episodic cluster headaches
lavender	muscle pains
popular fruits	ductal carcinomas
soy protein	vertex headaches
zedoary zedoaria	lobar pneumonias
red meats	b cell leukemia
dried food	chronic obstructive lung disease
gui zhi	cancer of bladder
snack food	ankylosing spondylitis
tumeric	communicable diseases
tofu	myeloma multiple
cooking oil	sleeplessness
kombucha tea	ocular headaches
biometal	metabolic acidosis
brazil nut tree	cancer of the ovary
thymus vulgari	feline lymphoma virus
petroselinum crispum	deep venous thromboses
açai berries	hiatal hernia
goji berry	cerebral stroke
cucumis melo	hansen's disease
triticum turgidum	toxico-infectious botulism
pasta	influenza in humans
refined olive	emesis
silybum marianums	human herpesvirus 4 (gamma)
soy beans	coronary diseases
sweet basils	physical sufferings
noni fruit	determination of death
flounder	circulatory failure
ready-to-eat meal	laron type dwarfism i
eating eggs	premature births
almond butter	limb cramp
rice	morning sickness
raw tomatoes	mottled enamel
almond tree	neurodegenerative diseases
atropa belladonnas	cardiac arrhythmias
solanum dulcamaras	cacosmia
citrus paradisi	generalized spasm
carica papayas	macular degenerations
marjoram plants	multiple myositides
low vitamin	atrial fibrillations
majorana hortensis	atherogenesis
popcorn	leukemogenic virus
cilantro	cretinism
cumin	familial creutzfeldt-jakob disease
hickory nuts	plasma cell myelomas
fresh meat	pancreatic cancers
shorten	numbness
eating broccoli	colon disease
food companies	male sterility
pickled foods	experimental lung inflammation
taking vitamin	aphthous ulcer
agaricaceae	juvenile-onset diabetes mellitus
food supplements	perioral tremor
crocus sativus	benign brain neoplasms
fennel seeds	colonic cancer
olive family	bilateral headaches
jalapeno	auriculo ventricular dissociation
plum trees	lou gehrig's disease
black sapotes	acute autoimmune neuropathies
chamomile	chronic fatigue and immune dysfunction syndrome
health food	allergic diseases
trace mineral	tumorigenese
tarragon	diffuse mixed-cell lymphomas
tulsi tea	fibroid tumor
camomile	pancreatitis
not-necessarily-so-healthy foods	tonic seizures
saint john wort	leukemia virus
maize oil	pregnancy-induced diabetes
nutriceutical	esophageal neoplasms
roselle	ileocolitis
wild celery	tubal abortions
saffron	gout
carbonated mineral water	salmonellosis
real chocolate	weight losses
juiced broccoli	renal failure
english walnuts	cryptogenic epilepsies
rubus idaeus	liver cancer
sweetening agents	rectal cancers
dietary fats	dizziness
decaffeinated tea	anaplastic carcinomas
potato	non hodgkin lymphoma
chinese cassias	memory deficit
hypericum	bacterial vaginitides
zea mays	galactose epimerase deficiency
cashew	sudden cardiac death
spicy food	brain vascular accidents
plant embryos	cva (cerebrovascular accident)
macadamia nut	feline leukemia virus
chamomile tea	cholera
cannabis indicas	encephalopathy
milkshake	lymphoplasmacytoid lymphoma
legume pods	endometrium carcinomas
ovary	iodine deficiency
pleurotus ostreatus	infertility
spinach	senile plaques
morel	marie struempell disease
ocimum basilicum	eye disease
chicken meat	dripped virus
daily nut	gustatory seizures
olea europaea	hydrophobia
sardine	schilling-type myeloid leukemia
artichoke	htlv-iii
crataegus	upper respiratory infection
drink tea	laron type dwarfism i
rosehip	primary brain tumors
citrus aurantium	liver steatosis
chinese cassia	lobar pneumonias
new candy	drug allergies
ale	reduced sensations
little meat	cacosmia
swordfish	skin disease
ground flax	acquired immunodeficiency syndrome
cooked tomatoes	water borne hepatitis
soy cheeses	sphenoid wing meningioma
squash plant	painful diabetic neuropathies
worldwide fruit	anthrax
lens culinaris	juvenile onset diabetes mellitus
alcoholic beverage	cervical migraine syndrome
ginger	sore throats
delonix	meningotheliomatous meningiomas
prunis communis	diabetes-related complication
mentha x piperita	cancer of the mouth
anacardium occidentale	basal cell epitheliomas
trigonella foenum-graecums	bacterial vaginosis
pine nuts	benign brain neoplasms
inadequate fruit	cervicitis
tea leaves	aphthous ulcer
poroporo	microglandular adenosis
vodka	autosomal dominant. juvenile parkinson disease
regular carrots	somatotropin (acromegaly) hypersecretion syndrome
carthamus tinctorius	philadelphia-negative myeloid leukemias
food poisoning	thermal hypesthesia
dried plums	dyslipoproteinemia
poultry	smell disorder
blossom	diffuse undifferentiated lymphoma
vaccinium bracteatums	inappropriate growth hormone secretion syndrome (acromegaly)
handling food	fatty liver disease
cannabis	disc degenerations
lens plant	female sub-fertility
black walnut	somatotropin hypersecretion (acromegaly) syndrome
own vitamin	fibromyalgia
beetroot	cancer of cervix
piper methysticums	cjd (creutzfeldt-jakob disease)
breakfast times	gale deficiencies
chamomile oils	colorectal tumors
sea food	tongue neoplasms
psidium guajavas	atherogenesis
pistachio nut trees	b cell leukemia
octopus	psychotic disorder
ocimum sanctum	oncogenic virus
food coloring	muscle cramps
cereal grains	deep venous thromboses
pease	primary fibromyalgia
algarrobo	chronic headache
soy yogurt	acute monocytic leukemias
catfish	colorectal tumor
cheese	malignant meningioma
frequent meals	insulin-dependent diabetes mellitus
plant zygotes	inflammatory bowel disease
linseed	menstrual pains
common olive trees	schizoaffective disorders
little saffron	itch
jam	disc degeneration
olive trees	bipolar affective psychoses
retail meat	autosomal recessive parkinsonism
juglans regia	somatotropin hypersecretion syndrome (acromegaly)
crunch berries	breast neoplasms
fagopyrum esculentum	tumor
healthiest beverage	steatohepatitis
sustenance	lewy body parkinson's disease
apple juice	jakob creutzfeldt syndrome
goiaba	experimental parkinson diseases
sea-food	juvenile onset diabetes
canned foods	anoxia
ginger ale	epithelial cancers
contaminated meat	pulmonary inflammation
soy bean	post-ictal confusion
crataegus monogyna	gnathostoma infections
chinook salmon	acquired immunologic deficiency syndrome
zingiber officinales	nonalcoholic fatty livers
food and drug administration	ulcer
bhang	hysterical amnesia
ocimum basilicums	type i diabetes mellitus
romaine lettuce	abdominal pain
kaffir lime	penis neoplasms
plant capsules	hereditary galactokinase deficiency
tepary bean	joint diseases
soft drinks	secretory meningioma
ready-prepared food	urinary bladder disease
beverage	vagina neoplasm
cappari	phlebothrombose
star anises	intermittent tremors
crab apples	acne
syzygium aromaticum	cancer of the skin
watermelon	pseudoaphakia
caper	chromosome 6-linked autosomal recessive parkinsonism
kawa kawas	zoonotic infectious diseases
allium porrum	palmoplantaris pustulosis
green tea	rabies
holy basil	prostatic intraepithelial neoplasia
pudding	aids viruses
callerya	deglutitional syncopes
japanese plums	deep-venous thrombosis
colorful foods	nervous system degenerative diseases
happy meal	rna tumor viruses
green peppers	kidney calculus
granny smith apples	heart disease
longevity legumes	colorectal neoplasms
processed meat	exanthem
gum acacia	galk deficiency
cuminum cyminum	thyroid neoplasms
taraxacum officinale	bilateral sciatica
conventional food	enzootic bovine leukoses
energy drink	chronic fatigue syndromes
indian gooseberry	periodontal disease
kohlrabi	diarrhea
neu5gc-rich food	hyperpigmentation
ilex paraguarienses	human t cell lymphotropic virus type iii
vaccinium macrocarpons	variant creutzfeldt-jakob disease
eggnog	colon neoplasms
prenatal vitamins	social anhedonias
grapefruit	atypical diffuse small lymphoid lymphoma
morinda	female subfertility
areca nuts	papillary meningiomas
citrus bergamia	chronic pain
energy drinks	bilateral deafness
herbal teas	prostatitis
scrambled eggs	gehrig's disease
dairy product	common cold
poultry product	postural syncopes
garden radish	well-differentiated lymphocytic lymphomas
bertholletia excelsa	familial atrial fibrillations
texturized vegetable proteins	diabetic neuralgias
fatty meal	lung inflammations
black rice	confusion
breakfast cereal	torsion fractures
citrus x paradisi	frontal region traumas
pecan tree	intervertebral disk degeneration
color	passive tremor
soy bean curd	milk sugar intolerance
cream cheese	texidor twinge
mother cells	cardiac arrhythmias
candy bar	acute inflammatory demyelinating polyneuropathy
safflower	uterine cervical cancers
earl grey tea	well-differentiated lymphocytic lymphomas
low meat	schizophrenic disorder
pistacia vera	lyssa
hummus	thyroid cancers
pizza	inflammatory bowel disease
soy milk	occipital traumas
laciniate nightshades	head injury
vegetable proteins	lou gehrig's disease
black walnuts	cranial pains
anise tea	microglandular adenoses
hot peppers	prostate neoplasms
sweet marjorams	neurocysticercosis
breast milk	sleep wake disorders
unfertilized eggs	idiopathic proctocolitis
lemon grass	felv
concord grape	intraepithelial carcinoma
wheat bran	renal insufficiency
curcuma zedoarias	semantic memory disorders
fabaceae	utp hexose-1-phosphate uridylyltransferase deficiency
monosodium glutamate	testicular tumors
drinking tea	inappropriate gh secretion syndrome (acromegaly)
guava	breast malignant neoplasms
rise	human t-cell lymphotropic virus type iii
poisonous plants	rabies viruses
rye	craniocerebral trauma
healthiest snack	pyrexia
antioxidant-rich foods	dissociative amnesias
baking chocolate	cancer of the penis
crocus	chronic b-lymphocytic leukemias
big apples	cattle leukemia virus
atropa belladonna	brain malignant neoplasm
corn oils	preterm birth
cacao	oncogenic viruses
dressing	adenomatous polyps
baker's yeast	cancer of the rectum
sugar maple	oncornavirus
ilex paraguariensis	gall stone
arugula	renal failures
contaminated foods	et-nanbh
raisin bran	kidney failure
applesauce	low back aches
cannabis indica	degenerative neurologic diseases
chamomile oil	uterine cervical cancer
common foxgloves	male breast tumor
veal	gorlin syndrome
fenugreek seeds	coarse tremors
wolfberry	cancer of the esophagus
rubberplant	manic-depressive psychosis
pistachio nut tree	pediatric cancers
proteus mirabilis	darkness tremors
curcuma zedoaria	chronic fatigue syndrome
black tea	physical anhedonia
chocolate	hypercapnia
belladonna	inappropriate growth hormone secretion syndrome (acromegaly)
cherry	mouth neoplasms
cola acuminata	olfaction disorders
lavandula	bilateral headaches
raw cranberries	anxiety disorder
secale cereale	grippe
chinese cinnamons	headache syndromes
dinner time	cardiac failure
anti-inflammatory foods	prostatic intraepithelial neoplasms
billion eggs	human papillomavirus viruses hpv
antioxidant vitamin	parasagittal meningiomas
althea officinalis	insulin resistance
drink milk	schizoaffective disorders
organic milk	gale deficiency
linum usitatissimum	pediatric cancers
fuji apples	anoxia
origanum	age related macular degeneration
strawberry	senile tremor
flammulina velutipes	cataract
healthier meat	substance dependence
intoxicant	circulatory collapse
fresh ginger	prostatic neoplasm
aloe	tonsil cancer
mustard plant	neuralgic migraines
collard	b cell chronic lymphocytic leukemia
prunus persica	global amnesia
use sweeteners	thyroid diseases
sesame seeds	intermittent tremors
plant-based nutrients	visceral steatosis
cayenne pepper	manic disorder
dinnertime	uterine cervical cancers
opium poppy	lactose intolerance
stuff	cognitive decline
nuclear power plants	renal cancer
group foods	congenital defects
corylus	phlebothrombosis
last meal	persistent atrial fibrillations
grecian foxgloves	lobar pneumonias
oolong tea	fibroid uterus
nut	ebv
myristica fragrans	viral infections
trompillo	acute cerebrovascular accident
apple trees	small non-cleaved-cell lymphoma
different fruits	sliding esophageal hernia
phaseolus	neurologic degenerative disease
mustard	sprains and strains
black beans	spontaneous abortion
diospyros digyna	broken bones
shiitake mushrooms	basal cell carcinomas
barley coffee	disorder
pomelo trees	paratuberculose
rye bread	sub-fertility
carya illinoenses	malignant melanoma
fortify milk	small round structured viruses
plant embryo	virus diseases
sweeten	insomnia disorder
tree nuts	scorbutus
oregano plant	abdominal aortic aneurysm
avoid peanuts	head pain
papaver somniferum	avitaminose
foeniculum vulgares	sneezing
greenery	hypolactasia
rooibos	asthma
seville orange tree	foodborne diseases
squash plants	small non cleaved cell lymphoma
cereal	guillain-barré syndrome
poisonous plant	hyperventilation syncope
plaice	autosomal dominant parkinsonism
yoghurt	autosomal dominant juvenile parkinsonism
rooibo	degenerative diseases
sugar	cancer of liver
cassia tree	gastric acid reflux
fava bean	udp-galactose-4-epimerase deficiencies
dietary plant protein	bipolar disorder
carduus marianus	high blood pressure
scallion	mptp-induced experimental parkinsonism
oyster mushrooms	chronic diseases
stevia rebaudiana	anxiety neuroses
dietary sugars	experimental parkinsonisms
adhatoda	muscle cramps
fermented cabbage	vitamin deficiency
pimenta officinalis	water-borne hepatitides
trace elements	senile paranoid dementias
fungus	syncopal vertigo
usda poultry	diabetic mononeuropathies
plant arils	familial atrial fibrillations
peanut	hypoxia
malus	germinoblastoma
emblica officinali	memory deficit
licorice root	seasickness
dog rose berries	degenerative diseases
raw foods	sudden onset diabetes mellitus
butter	galt deficiency
brussel sprout	nonalcoholic fatty livers
plant capsule	idiopathic intracranial hypertension
sandwich	chronic illness
food colors	spinal cord disorders
clove	disk degradations
jerusalem artichokes	cancer of the vagina
pomegranate fruit	undifferentiated carcinomas
euterpe oleracea mart.s	premenstrual tensions
edible grain	colitide
daucus carota	necrotizing fasciitides
fig	halitose
no-calorie sweeteners	retro-ocular headaches
nut bar	peripheral arterial disease
mussel	hydrophobia
areca catechus	epilepsy
hamburger	manic disorder
mackerel	diffuse small cleaved-cell lymphoma
venison	infantile colic
grape seeds	gastric ulcers
digitalis lanata	carcinogenic retroviruses
replenish nutrients	lou gehrig's disease
coconut water	endometrial neoplasms
holy basil tea	complete blindness
phaseolus vulgaris	b cell leukemia
hordeum vulgare	mammary cancer
dietary protein	premenstrual tension
philadelphia cream cheese	cough
brinjal	spiral fracture
phyllanthus emblica	thyroid cancers
peach	vulva neoplasm
sweetener	meningotheliomatous meningiomas
cranberry juice	preventing cancer
salsa	paraesophageal hernias
shan yaos	sea sickness
healthy nuts	primary parkinsonism
myristica fragran	iritis
crabapple	tonsil neoplasms
rheum tanguticum	familial diffuse gastric cancer
dried peas	degenerative arthritis
whole foods	painful diabetic neuropathy
raw broccoli	glaucoma
seltzer waters	colorectal cancer
seltzer water	spindle cell sarcomas
aspalathus	cryptogenic epilepsies
spaghetti	bacterial infection
hawthorn	crohn's enteritis
melissa	rheumatoid spondylitis
tomato	malignant epithelial neoplasms
crave chocolate	galactosemia iiis
meal times	fibromyalgia-fibromyositis syndrome
added nuts	epstein-barr virus
nonfat meal	galactosemia 2s
dioscorea villosa	blood cancers
blueberry plants	drug allergy
sweetened cereal	royal free disease
honeybush tea	idiopathic intracranial hypertension
wheat	cerebrovascular accidents
fat foods	ekbom delusory parasitosis
chocolate pudding	auto-immune diseases
thousand foods	carotid sinus syncopes
nutritional yeast	vulva cancers
seafood	canker sore
amomum cardamomums	pill rolling tremor
new vitamin	gorlin syndrome
kola nut	infectious mononucleosis virus
good soybeans	iritis
food supplementations	tonsillar neoplasms
english plantain	leukemia virus
nonus	dna injuries
origanum majorana	torsion fracture
cinnamomum trees	developed cancer
fennel	newborn gynecomastia
coconut milk	multiple sclerosis
malus domestica	non-b hepatitis epidemic non-a
celery root	lymphatic sarcomas
carya	status migrainosus
citrullus	preterm birth
kiwi	prostatic adenomas
larder	small lymphocytic lymphoma
no meat	respiratory infections
animal-based foods	cognitive dysfunctions
soymilk	peripheral autoimmune demyelinating disease
copaifera	muscular spasms
endive	retro-ocular headaches
jalapeno pepper	amnestic state
java plum trees	age related macular degeneration
dioscorea opposita	primary fibromyalgia
sweet orange	confusion
marjoram plant	idiopathic proctocolitis
aspartame	intention tremors
horse beans	deafness
nutraceutical	reactive confusion
saint johns wort	migraine disorder
dried apricots	widespread chronic pain
nut bars	heat strokes
trace element	guam form of amyotrophic lateral sclerosis
red lentils	migraine
persimmon	uterine cancers
cider vinegar	acute monoblastic leukemia
deli meats	prostatic cancers
morning meals	diabetic autonomic neuropathy
goji berry plant	limb cramp
iceberg lettuce	skin cancers
zucchini	somatotropin hypersecretion (acromegaly) syndrome
ground beef	birth defects
hemp plant	fibrocystic changes of breast
melissa officinalis	influenza in humans
cassia fistulas	cerebrovascular accidents
betel nut	norwalk like viruses
lemon	backache
pea families	experimental parkinson disease
sugar-sweetened beverages	hypoxemia
whiting	tongue cancers
oat	canker sore
shiitake	sleep disorders
lemongrass	skin neoplasm
syrup	weight loss
dietary supplementations	benign neoplasms
dinner	orthostasis
silken tofu	familial dementias
whole grain	galactokinase deficiencies
pureed apples	terminal ileitis
prunus dulcis	cancer of the esophagus
fed beef	myeloma-multiple
cannabis sativas	brain vascular accident
carob	weight reductions
illicium verums	flatulence
portulaca	halitosis
hibiscus cannabinus	open head injury
alpine strawberries	jaundice
consumed chocolate	acute monocytic leukemia
ground meat	drunkenness
artificial sweeteners	diffuse lymphomas
mentha	bladder neoplasms
healthiest apple	rectal cancer
mastic tree	bleed
hashish	lyme disease
convenience food	reducing cancer
drink	male breast neoplasms
garcinia mangostana	pediatric cancers
acer saccharum	intermediate grade lymphoma
radicchio	infarction
added sweeteners	meningotheliomatous meningioma
digitalis	long sleeper syndromes
morinda citrifolia	mild cognitive impairments
calendula officinali	recrudescence
roasted almonds	insulin-dependent diabetes mellitus
kidney beans	mastitis
family vegetables	complete hearing loss
chewing fruit	forehead traumas
ceylon cinnamon	nanism
erythroxylon	chronic insomnia
lemon balm	rickets
emphasize plant	small noncleaved-cell lymphoma
citrus aurantiifolia	guam form of amyotrophic lateral sclerosis
currant	vulvar cancer
soybean	bovine leukemia virus
triticum vulgare	granulomatous colitis
bread	abdominal pains
paella	influenza in humans
undercooked meat	pus
assai palm berry	sensory seizure
betel	uterine cancers
barberry	male breast carcinoma
acaí berries	inhibit cancer
bacon	hiatal hernias
morning meal	parkinsonism-dementia complex of guam amyotrophic lateral sclerosis
machaerium	brain vascular accident
citrus aurantiums	tumor viruses
kale	pleomorphic lymphoma
thymus plant	oncornavirus
nut butters	acute cerebrovascular accidents
feather meal	mild cognitive impairment
cultivated oat	retained surgical tools
aloe vera	gastroenteritide
plant aril	childhood onset obesity
alfalfa sprout	hip fractures
cannabis sativa	senile paranoid dementia
cardamom	pancreas neoplasm
cardamon	chronic illness
plantain	fibrocystic breast disease
cassia cinnamon	acute monoblastic leukemia
sushi	splitting pain
amomum cardamomum	creutzfeldt jacob disease
soy	spondylarthritis ankylopoietica
chile pepper	human t-cell leukemia virus type iii
plum	common cancer
avocado	different cancer
pinto bean	body weight
stevia	varix
wild yams	leukovirus
goji berry plants	mouth neoplasm
dinner times	deglutitional syncopes
sugar water	udpglucose hexose 1 phosphate uridylyltransferase deficiency
fatty foods	ramsay hunt paralysis syndrome
grilled meat	growth hormone receptor defect
citronella	malignant lymphoma
eating meat	back pain without radiation
high fructose maize syrup	amyloid plaque
lycium chinense	gastroesophageal reflux
bertholletia	metabolic acidosis
red pepper	halitose
guacamole	obesity in adolescence
candy	bacterial vaginitides
chilli peppers	disk degradations
prettiest fruit	myalgia
higher vegetable	eye disease
blueberry plant	parkinson’s disease
chicken salad	memory disorders
whale meat	neurotic anxiety state
plantago	seizure disorders
bell pepper	acne vulgaris
tepary beans	neurodegenerative disorder
milk proteins	sneezing
illicium	gastric neoplasms
coca	deglutitional syncopes
kava kavas	bone neoplasms
cinnamomum aromaticum	aneurysm
food company	cancer of uterus
adhatoda vasica	retained surgical tools
processed foods	salmonellosis
berberis	pus
apricot	gall bladder diseases
beet greens	fibrocystic disease of breast
broccoli raab	rhabdomyolysis
walnut	eczematous dermatitis
wisconsin milk	psychosis
coco	plasmodium infections
emphasizes vegetables	retro ocular headache
maple	thyroid adenomas
oreo	pseudocoma
colophospermum	galactosemia 3s
salad	non-alcoholic fatty liver disease
fruit juices	feline leukemia virus
mangifera indica	mammalgia
herbal tea	hypoxia
soy beverages	transmissible dementia
grouper	gynecomastia
dairy yogurt	age related osteoporosis
dried pomegranate	bipolar disorder
study lavender	uterine leiomyoma
mushroom	monocytic leukemia
alcohol	impotence
hickory tree	low-grade b-cell malignancy
almond trees	right sided heart failure
raphanus sativus	cancer of the prostate
alfalfa sprouts	occipital region trauma
osmanthus tea	fibromyositis fibromyalgia syndrome
rice milk	bacterial infections
veggie	deep-vein thromboses
low-sodium diet	mptp induced experimental parkinsonism
probiotic	age related macular degeneration
placenta	visceral obesity
chocolate bars	generalized headache
roughage	iritis
nutrient-dense foods	cardiac arrhythmias
eupatorium rebaudianums	early onset parkinsonism
confection	human flu
seed	non hodgkin lymphoma
cocoanut	meningiomatose
kangaroo meat	basal cell carcinoma
warm milk	flatus
allspice	rodent ulcers
raw meat	human herpesvirus 4 (gamma)
eating nuts	chronic obstructive lung disease
prunus amygdalus	retained surgical sponges
elephant garlic	syncopal episode
white wine	periorbital headache
eugenia caryophyllata	gassers syndrome
carbonated beverage	oral neoplasms
boiled eggs	abdominal cramp
split peas	spatial memory disorders
raisin	osteoarthritide
flower	torsion fractures
nut butter	lewy body parkinson disease
canned fruit	hysterical amnesia
chanterelle	penile cancers
woodland strawberry	disc degenerations
golden raisins	chronic pains
acai berry	kanners syndrome
brassica	visceral steatosis
tangerine tree	arthritis
cupcake	ciguatera poisonings
sparkling waters	parodontose
include flaxseed	human flu
petroselinum	fibrocystic mastopathy
domestic fowl	zoonotic diseases
buttermilk	schizophreniform disorders
lemon balm tea	galk deficiencies
amla	inflammatory bowel diseases
vaccinium virgatum	senile plaques
kawa	lichen planus
triticum	transmissible spongiform encephalopathy
flammulina	peripheral demyelinating autoimmune disease
reindeer meat	neoplasm metastases
tomato juice	spindle cell sarcoma
durum wheats	infarction
eugenia aromatica	unilateral headache
mustard plants	lung inflammations
chewing gum	nanism
laciniate nightshade	parodontose
syzygium	degenerative intervertebral disk
flesh foods	coronary diseases
preserved foods	galactose-1-phosphate uridyltransferase deficiencies
animal food	udp-galactose-4-epimerase deficiencies
garlic sauce	skin neoplasms
blueberry	motor seizure
ribes nigrum	generalized headache
tangerine trees	testis neoplasms
dangerous plants	anhedonia
sweet almonds	liver disease
cassia	high blood pressures
chewed coca	heart diseases
prebiotic	colon cancer
trace minerals	esophageal hernia
red rice	dysmenorrhea
bt corn	sore throats
pisum sativum	salmonella infection
trigonella	viral diseases
kava	thyroid disease
rhubarb	tonic-clonic seizure
vitamin pills	dermatosis
hypericum perforatums	respiratory tract infections
raphanus raphanistrum	prion diseases
century plant	cervix neoplasm
sweet potatoes	skin diseases
rheum officinale	cancer of the ovary
foxglove	epithelioma
snack	hormonal dysfunction
multivitamin	mottled enamels
soy beverage	penile neoplasm
sunflower seeds	galactose 1 phosphate uridyltransferase deficiency
citrus medica	memory disorders
oryza	acute inflammatory demyelinating polyradiculoneuropathy
know nuts	creutzfeldt-jakob syndrome
individual candy	prostatic intraepithelial neoplasm
cola	gastro-oesophageal reflux
solanum laciniatum	painful menstruations
sweet foods	determination of death
corn sugar	human t-cell leukemia virus type iii
honey	male breast cancer
fagopyrum	postoperative vomiting
diospyros digynas	back ache
cocos nucifera	central nervous system degenerative diseases
four nuts	amyotrophic lateral sclerosis parkinsonism dementia complex 1
club soda	breast malignant neoplasm
diabetic diets	cancer of vulva
vitis vinifera	female sterility
white pepper	ulcerative colitis
breakfast cereals	colicky pain
adding blueberries	goiter
theobroma cacao	fibroatheromatous plaque
grape juice	jaundice
persea	non-hodgkin's lymphoma
incorporates cloves	colon disease
lemon tree	male breast cancer
arecas	prostatic intraepithelial neoplasm
chinese rhubarb	protein deficiencies
turnip	action tremor
weekly meat	dizzyness
white mallows	disc degeneration
yogurt	chronic airflow obstruction
soy cheese	left-sided heart failure
bean sprouts	pulmonary inflammation
cherry plum tree	fibroatheroma
piper methysticum	alzheimer’s disease
vegetable protein	muscle pains
stevia rebaudianas	subacute spongiform encephalopathy
animal-based vitamin	infantile obesity
cayenne	environmental cancer
raspberry	ileocolitis
curried tofu	mastodynia
target vitamin	monocytic leukemia
red peppers	jakob creutzfeldt syndrome
hot sauce	intraepithelial neoplasms
lettuce	light-headedness
vaccinium macrocarpon	pulmonary neoplasms
yolk	hypospadia
drug administration united states food	hemolytic jaundices
national meat	endemic cretinism
carbonated mineral waters	circulatory collapse
mentha spicatas	catarrh
vegetable juice	variant creutzfeldt jakob disease
dried apple	acute inflammatory polyneuropathies
dark chocolate	mad cow diseases
tap water	galt deficiency
açai berry	gastro esophageal reflux
plantago seed	phlebothrombose
frozen broccoli	kidney calculi
cymbopogon nardus	sarcopenia
ficus	syncopal episodes
hemp	marsh fever
mustard oil	involuntary quivers
cinnamomum zeylanicum	amentia
flax	malignant epithelial neoplasms
colocasia	palsy
unfiltered coffee	muscle pain
sea bilberries	ph1-negative myeloid leukemias
cruciferous vegetable	elevated cholesterols
soy bean curds	fibrocystic disease of breast
soda waters	pancreatitide
guibourtia	muscular spasms
peanut butter	vaginal neoplasm
green pepper	e-b virus
golden glow	cancer of liver
breakfast time	essential tremor
norus	persistent tremor
flavourer	effort syncope
bean sprout	cancer of brain
infant formulas	diverticulosis
safflower oils	pseudocoma
narrow-leaved plantains	remittent fever
rowanberry	acne vulgaris
dress	brain disorders
granny smith	dental fluorosis
processing meat	acute inflammatory polyneuropathies
corn	guam form amyotrophic lateral sclerosis
onion	asymmetric diabetic proximal motor neuropathy
illicium verum	vulva cancer
sausage	aids viruses
nori	eye disease
coconut oil	non epileptic convulsion
mangifera indicas	creutzfeldt jakob syndrome
milk chocolate	common bile duct gall stones
pickled vegetables	blood cancer
offal	hepatic failure
common foxglove	numbness
sweet pepper	rectum neoplasm
carica papaya	burkitt's lymphoma virus
acacia tree	breast malignant tumors
yeast rice	galactokinase deficiency diseases
cortland	monocular blindness
dried fruit	nonhodgkin lymphoma
healthier foods	cll lymphoplasmacytoid lymphoma
common bean plants	birth weight
ultra-processed food	philadelphia-negative myeloid leukemia
allium sativum	guillain-barre syndrome
texturized soy proteins	allergic reaction
macadamia nuts	chronic b-cell leukemia
experience food	sleep wake disorder
assai palm berries	heart attacks
licorice	nutritional disease
foeniculum	small cleaved cell lymphoma
burrito	lyme arthritis
kola nuts	vulvar cancer
sesame	small non-cleaved-cell lymphomas
mandarin orange trees	post-traumatic osteoporosis
bitter orange tree	canker sore
sour orange tree	cow disease
rutabaga	breast disease
cauliflower	pseudocoma
tuna	cow disease
poppy seed	nervous system degenerative diseases
anti-inflammatory plant	fibrocystic changes of breast
herr	human mammary neoplasms
powdered ginger	inherited human transmissible spongiform encephalopathies
cultivated oats	oncogenesis
unhealthy food	pregnancy-induced diabetes
weed	cerebrovascular apoplexy
chili peppers	ankylosing spondylarthritis
herb	bladder diseases
grecian foxglove	vertiginous seizures
oats	hypoascorbemia
triticum turgidum subsp. durum	pruritis
solanum	blood clots
peach trees	disorientation
lime	dental diseases
leek	steatohepatitis
plant-based foods	spiral fracture
sunfish	aphthous ulcer
da huang	vulva neoplasms
fruit-shaped marshmallows	penis cancers
broad beans	seizure
ice creams	rna tumor viruses