
avocado fruit	burkitt's lymphoma virus	0
coconut oil	intracranial cns disorders	0
cucumis sativus	increase cancer	0
dinner times	penis neoplasms	0
edible grains	sneeze	0
extracted fruit	nonalcoholic steatohepatitides	0
cherry	neoplasm	0
unfiltered coffee	renal failures	0
grapefruit	gnathostomiasis	0
nettle tea	small noncleaved-cell lymphomas	0
kawa kawa	malignant epithelial tumor	0
humulus lupulus	diffuse undifferentiated lymphoma	0
eating broccoli	colitis gravis	0
energy drinks	burn	0
grecian foxgloves	malignant brain neoplasm	0
food poisonings	gehrigs disease	0
added sweeteners	intermediate-grade lymphoma	0
high fructose maize syrup	posterior fossa meningioma	0
largest meal	lewy body parkinson disease	0
white wine	intermediate-grade lymphomas	0
ceylon cinnamon	fibroid	0
brown rice	mptp induced experimental parkinsonism	0
steak	bovine lymphomas	0
mangifera	congenital defect	0
common olive tree	rectal cancers	0
bread mold	sensory seizure	0
milk chocolate	cognitive decline	0
lentinus edodes	galk deficiency	0
mirobalanus embilica	limb cramps	0
onion	diabetic neuralgia	0
sprout	paraesophageal hiatal hernias	0
alfalfa	myalgia	0
frying foods	water stress	0
pear	polymyositis ossificans	0
pomelo tree	periorbital headaches	0
purple rice	chromosome 6 linked autosomal recessive parkinsonism	0
hypericum perforatums	epithelioid sarcomas	0
dietary supplementations	skin disease	0
horse nettle	ekbom dermatozoic delusions	0
big meals	ekbom delusional parasitosis	0
pork	hypertension	1
weekly meat	hip fractures	0
peach tree	frontal region trauma	0
food allergies	anal ulcers	0
commercial milk	gastric ulcers	0
cocoa powder	tumorigenesis	0
healthiest snack	ekbom psychogenic parasitoses	0
cicer arietinum	idiopathic intracranial hypertension	0
cereal grain	primary malignant brain tumors	0
raw garlic	fibrose	0
eugenia caryophyllata	colonic neoplasm	0
mustard oil	stroke	0
sweet foods	right sided heart failure	0
raisin	acquired blindness	0
whole grain	psychogenic parasitoses	0
saint john wort	heart disease	0
beetroot	undifferentiated lymphoma	0
radish	chronic cluster headaches	0
nonus	cancer of the bladder	0
common fruits	intraventricular meningiomas	0
snack food	muscle cramps	0
carbonated water	amyotrophic lateral sclerosis with dementia	0
handling food	periorbital headaches	0
pease	ciguatera	0
linum usitatissimum	drug hypersensitivities	0
plantago ovata	autosomal recessive juvenile parkinsonism	0
cocos nuciferas	water stress	0
rye	atypical cluster headache	0
juglans nigra	post-ictal confusion	0
flavoring	xanthomatous meningiomas	0
pea family	weight losses	0
shan yao	parkinsons disease	0
acid-binding vegetables	bovine lymphosarcomas	0
curry powder	anal ulcers	0
nutmeg	spiral fracture	0
red yeast rice	generalized headaches	0
eat flax	lung diseases	0
black walnuts	v-cjd (variant-creutzfeldt-jakob disease)	0
table salt	rodent ulcer	0
cuminum cyminums	diabetes-related complications	0
lemon grass	sexual dysfunction	0
poisonous plant	substance dependence	0
fagopyrum sagittatum	texidor's twinge	0
arecas	renal calculus	0
triticum vulgare	sphenoid wing meningioma	0
poultry product	human mammary carcinoma	0
celeriac	ulcer	0
emphasizes vegetables	psychosis	0
pimpinella	carcinoma of endometrium	0
vitis	malignant lymphoma	0
intoxicant	parkinson’s disease	0
arugula	non b hepatitis enterically transmitted non a	0
emblica officinalis	heart attacks	0
sunflower seeds	infantile obesity	0
peach trees	early awakening	0
caryophyllus aromaticus	esophagus neoplasm	0
oats	mental disorder	0
linum usitatissimums	udpglucose hexose 1 phosphate uridylyltransferase deficiency	0
carthamus tinctorius	prediabetic state	0
leek	vitamin deficiency	0
maraschino cherry	dental plaque	0
sauerkraut	gastro esophageal reflux	0
plantago	muscle soreness	0
vicia fabas	sleep initiation dysfunctions	0
dried apple	uterus cancers	0
cinnamomum cassia	idiopathic parkinson's disease	0
rice milk	hemangiopericytic meningioma	0
carbonated drink	excess cancer	0
acer negundos	esophageal cancers	0
preserved food	blood clot	0
pasta	metabolic acidoses	0
hordeum vulgare	short sleeper syndrome	0
candy	e-b viruses	0
tomato juice	anal ulcer	0
faba bean	heartburn	0
target vitamin	human mammary neoplasms	0
french bean plant	cancer of the ovary	0
willow tree	intervertebral disc degeneration	0
texturized soy proteins	central nervous system degenerative diseases	0
real chocolate	chronic b-cell leukemia	0
vegetable oil	burkitt lymphoma virus	0
blackberry	parietal region traumas	0
cannabis indica	uterine cervical neoplasm	0
coca	spondyloarthritis ankylopoietica	0
eat chocolate	reticulum-cell sarcoma	0
morinda	reticulum-cell sarcomas	0
pickled foods	nonalcoholic steatohepatitides	0
healthy foods	cardiovascular strokes	0
wheat bran	benign neoplasms	1
oryza	premenstrual tensions	0
junk foods	urinary tract infections	0
osmanthus	menstrual disorders	0
cow's milk	parkinson's disease	0
plantago lanceolata	ankylosing spondyloarthritis	0
goji berry plant	periorbital headaches	0
digitalis	prostate neoplasm	0
lipomul	insomnia	0
tofu	senile osteoporosis	0
capparis	sphenoid wing meningioma	0
rose	gerd	0
portulaca oleraceas	hereditary essential tremor	0
iceberg lettuce	vulva neoplasms	0
root	thyroid disease	0
phyllanthus emblicas	semantic memory disorder	0
red cabbage	ischemic heart disease	0
citrus hystrix	polyradiculoneuropathy	0
whiting	cancer of penis	0
clathrotropis	manic state	0
green pepper	udpglucose 4 epimerase deficiency disease	0
mint tea	epithelial cancers	0
snail meat	mixed lymphoma	0
plant kingdom	oral cancers	0
anise	arrhythmia	0
pleurotus	arterial dysfunction	0
chinese food	congenital defect	0
vicia faba	dizzyness	0
alcoholic beverages	develop cancer	0
cocoa powders	smell disorders	0
sockeye salmon	sleep initiation dysfunction	0
berberi	amaurose	0
antioxidant fruits	udpglucose hexose 1 phosphate uridylyltransferase deficiency	0
taraxacum	crohns disease	0
lavandula angustifolia	severe gh insensitivity	0
apium graveolens var. dulce	hepatic cancers	0
gmo soybeans	psammomatous meningiomas	0
sweetened cereal	intraorbital meningiomas	0
dandelion	liver cancer	0
eating food	androgenetic alopecia	0
purple cabbage	germinoblastic sarcoma	0
beta vulgari	female sub-fertility	0
boiled broccoli	low backaches	0
jambolan plum tree	pancreatic neoplasms	0
saint johnswort	preventing cancer	0
dried cranberries	oxygen deficiencies	0
bitter nightshade	hot flashes	0
currant	death	0
liquor	lav-htlv-iii	0
faba beans	fibroid tumor	0
cannabi	aids virus	0
rice	dizzyness	0
dressing	mixed lymphocytic-histiocytic lymphomas	0
olea europaea	pattern baldness	0
experience food	precordial catch syndrome	0
squid	cancer of kidney	0
soft drink	diverticula	0
hemlock	mixed lymphocytic-histiocytic lymphomas	0
safflower	hereditary essential tremor	0
dinnertime	tumor virus	0
wheat	cervix neoplasm	0
dried blueberries	avian leukosis/sarcoma virus	0
barley coffee	tying disease	0
tuna fish	spindle cell sarcoma	0
hickory nuts	eczematous dermatitides	0
fagopyrum	cancer of the mouth	0
applesauce	creutzfeldt jacob disease	0
malabar nut	viral hepatitis	0
myristica fragran	intracranial meningioma	0
confection	cramp	0
silken tofu	tick bites	0
snack foods	degenerative neurologic diseases	0
stevia	arterial dysfunction	0
mentha piperita	congenital hypothyroidism	0
phaseolus vulgaris	myelomatosis	0
kawa kawas	mild neurocognitive disorders	0
sunchoke	barrett metaplasia	0
daily fruit	peripheral arterial disease	0
prunus persica	resting tremors	0
nutriceutical	seizure	0
coca cola	diffuse undifferentiated lymphomas	0
french fries	peripheral demyelinating autoimmune disease	0
leafy vegetables	familial creutzfeldt-jakob disease	0
healthiest foods	endotoxemia	0
hemp	sliding esophageal hernia	0
family vegetables	inflammation	0
big apples	paludism	0
seville orange tree	cephalgia	0
cooked meats	orthostatic headaches	0
nutritional yeast	fibromyalgia-fibromyositis syndrome	0
trompillo	gehrig disease	0
adding blueberries	impaired sensation	0
drinking orange	hhv-4	0
lemon verbena	post traumatic osteoporosis	0
trace minerals	brain neoplasms	0
red pepper	catarrh	0
amla	gastric cancers	0
brassica napus	infant botulisms	0
tea plant	small lymphocytic lymphoma	0
pea families	inner ear cancer	0
baby carrots	epileptic seizure	0
lunchtime	drug use disorders	0
cultivated oat	reticulum-cell sarcoma	0
cannabis sativas	sprain	0
cilantro	gnathostomiase	0
fresh fruits	ekbom delusional parasitoses	0
chilli pepper	wart	0
cream cheese	neoplasm	0
bacon	weight loss	0
inadequate fruit	cancer of colon	0
garden radish	mammalgia	0
alfalfa sprout	aphthous stomatitis	0
snacktime	upper respiratory infection	0
popular fruits	ponv	0
citrus fruits	malignant tumor of urinary bladder	0
flax seeds	nasal cavity cancer	0
alfalfa sprouts	sliding esophageal hernias	0
avocado	neurodegenerative disorders	0
adhatoda vasica	occipital region traumas	0
american meat	ciliary neuralgia	0
topical ginger	sneezing	0
fruit-shaped marshmallows	prion diseases	0
poultry meat	transitional meningiomas	0
watercress	visual seizures	0
garlic	breast fibrocystic changes	0
healthiest nuts	static tremor	0
crabapple	visual seizures	0
bamboo shoots	iron deficiency	0
century plants	gorlin-goltz syndrome	0
eugenia aromatica	diabetes complication	0
andean blackberry	female pattern baldness	0
fava beans	primary growth hormone resistance	0
rubberplant	foodborne diseases	0
lemongrass	undifferentiated lymphoma	0
cardamon	colon cancer	0
sugar maple	a v dissociation	0
eggnog	uterus neoplasms	0
cinnamomum trees	obesity virus	0
curcuma zedoaria	social anhedonias	0
favorite meals	coronary heart diseases	0
pimenta	bses (bovine spongiform encephalopathy)	0
drinking coffee	early detection of cancer	0
tea	diffuse mixed cell lymphoma	0
chinese cassias	orthostasis	0
sweet pepper	epithelial cancers	0
saffron crocus	semirhythmic tremors	0
citrus sinenses	familial tremor	0
food coloring	lower back pain	0
dog rose	tonsil cancers	0
frozen cranberries	familial atrial fibrillations	0
dried apricots	rheumatoid spondylitis	0
english walnut	aphthous stomatitides	0
secale	muscular cramp	0
mock meats	coma	0
eugenia jambos	acquired blindness	0
marjoram plant	influenza in humans	0
drinking water	epstein barr virus	0
organic milk	myeloid leukemia	0
bagel	inappropriate gh secretion syndrome (acromegaly)	0
boiled eggs	uterine cancers	0
chamomile tea	bruise	0
durum wheat	esophageal neoplasms	0
supper	halitose	0
daucus carota	epilepsy	0
fresh meat	prostatic intraepithelial neoplasms	0
yogurt	right sided heart failure	0
aubergine	benign meningioma	0
fermented cabbage	amnesia-memory losses	0
osmanthus tea	parkinsonian diseases	0
pine nuts	type c oncovirus	0
opium poppy	ciliary neuralgias	0
uncooked foods	lou gehrig disease	0
sugar substitutes	orthostasis	0
pithecellobium	mad cow disease	0
orange tree	hiccup	0
canned food	chronic pain	0
watermelon	fibrositide	0
actual fruit	diverticula	0
marsh mallow	vulvar cancer	0
green beans	neurological condition	0
whole grain cereals	benign meningioma	0
white rice	pancreas cancer	0
saint john's wort	lewy body parkinson's disease	0
spearmint	intertrochanteric fractures	0
convenience foods	weight losses	1
alcoholic beverage	ocular headache	0
agent orange	spatial memory disorders	0
grape	fibroid	0
chia seeds	amaurosis	0
syrup	myelomatosis	0
beet	androgenic alopecias	0
cayenne peppers	spondyloarthritis ankylopoietica	0
drinking tea	breast pains	0
roselle	manic-depressive psychoses	0
crave chocolate	polyradiculoneuropathy	0
glucose fructose syrup	fighting cancer	0
peach	new variant creutzfeldt-jakob disease	0
turmeric root	acne	0
marihuana	ekbom psychogenic parasitoses	0
healthy fruit	acidosis	0
flaked coconut	neurodegenerative diseases	0
collard	thyroid diseases	0
lycium chinense	car sickness	0
sea-food	disorder	0
indian gooseberries	plasmodium infections	0
snack	benign essential tremor	0
breakfast cereal	crohn disease	0
lemon balm	cancer of the testis	0
daily nut	vulva cancers	0
saint johns wort	ekbom psychogenic parasitoses	0
aspartame	arthritide	0
aquatic food	infectious mononucleosis virus	0
rheum officinale	cattle leukemia virus	0
convenience food	avitaminosis	0
meal time	cancer of the brain	0
butter	amnestic state	0
group foods	age-related macular degeneration	0
colophospermum	postoperative emeses	0
cola	barrett syndrome	0
msg	retained surgical item	0
breakfast	peripheral demyelinating autoimmune disease	0
solanum tuberosums	hypovolemic shock	0
blueberry	paroxysmal atrial fibrillation	0
baker's yeast	bacteriophage	0
prunus armeniaca	manic disorder	0
raw food	thyroid disease	0
garlic sauce	neuritic plaque	0
maguey	small-cell lymphomas	0
california avocado	diffuse mixed-cell lymphoma	0
pizza	prion-induced disorder	0
soy yogurt	hirsutism	0
energy drink	cervical neoplasm	0
cinnamon	senile paranoid dementia	0
olive oils	non-b hepatitis enterically-transmitted non-a	0
bean	bacteriophage	0
wort	neuritic plaque	0
pecan	intracranial cns disorder	0
citrus aurantium	human papillomavirus viruses hpv	0
prunis communis	t viruses	0
stevia rebaudianas	bovine lymphosarcoma	0
carbonated drinks	somatotropin hypersecretion syndrome (acromegaly)	0
squash plants	continuous tremors	0
raspberry	idiopathic parkinson disease	0
cocoa plants	acquired immunologic deficiency syndrome	0
carrot juice	amyotrophic lateral sclerosis motor neuron disease	0
sweet marjoram	muscle spasm	0
paella	amyloidose	0
stuff	lyme disease	0
mustard	cancer of rectum	0
peanut butter	paraesophageal hiatal hernia	0
cacao bean	colicky pain	0
processed meats	galactose 1 phosphate uridyltransferase deficiency	0
areca catechus	trochanteric fractures	0
contaminated foods	unhealthy conditions	0
flowering shrub	subacute spongiform encephalopathy	0
carica papaya	ciliary body spasm	0
cider	peripheral artery disease	0
whole wheat	reversing chronic disease	0
woodland strawberry	retained surgical item	0
monosodium glutamate	animal virus	0
high-phytate foods	tumorigenesis	0
solanum dulcamaras	right-sided heart failure	0
little saffron	small noncleaved-cell lymphomas	0
cured meats	childhood obesity	0
sandwich	encephalopathy	0
chewed coca	male sexual impotence	0
organ	tremor	0
nut butters	carcinomatosis	0
potable water	microglandular adenosis	0
jell-o	acute inflammatory polyradiculoneuropathies	0
nuclear power plants	rash	0
marjoram	spondylarthritis ankylopoietica	0
vital nutrients	sleep disorders	0
ground meat	food-borne diseases	0
ice cream	temporary amnesias	0
ocimum basilicum	generalized seizures	0
dietary protein	paraosmia	0
alcohol	diffuse undifferentiated lymphomas	0
citrus	cancer of rectum	0
red delicious	intermediate-grade lymphomas	0
larder	androgenic alopecias	0
tarragon	common bile duct gall stones	0
milk protein	spondylitis ankylopoietica	0
high fructose corn syrup	human influenza	0
capsicum	hypermelanose	0
foodstuff	hepatocellular cancer	0
raw foods	pancreas neoplasms	0
melissa officinali	ketosis-prone diabetes mellitus	0
carrot	low backache	0
navy beans	sliding hiatal hernias	0
peppermint	memory loss	0
black coffee	lymphadenopathy-associated viruses	0
tap water	prediabetic states	0
healthiest apple	crushing skull injury	0
apium graveolens var. rapaceum	cerebrovascular apoplexy	0
raw poultry	apoplexy	0
higher vegetable	peripheral demyelinating autoimmune disease	0
healthy nuts	nevoid basal cell carcinoma syndrome	0
dietary soybean proteins	malignant neoplasm of breast	0
turkey meat	age-related maculopathy	0
pineapple juice	manic disorder	0
nitrate-rich vegetables	mild cognitive impairments	0
jam	hemicrania migraine	0
eden foods	degenerative diseases	0
espresso	leukemia	0
artichoke	uveitis	0
healthy snacks	gehrig disease	0
golden delicious apples	polyradiculoneuropathy	0
probiotic	animal virus	0
bitter orange trees	acute cerebrovascular accidents	0
dried apples	creutzfeldt-jakob syndrome	0
herb	high cholesterol levels	0
diabetic diet	broken bone	0
sea bilberry	hepatic failure	0
nightshade	chronic b-lymphocytic leukemias	0
processing meat	non hodgkins lymphoma	0
brazil nut tree	short sleep phenotype	0
crocus	esophagus cancer	0
multivitamin	pulmonary embolism	0
paprika	udpglucose 4 epimerase deficiency disease	0
swordfish	bovine leukemia	0
yoghurt	muscle cramp	0
grouper	familial parkinson disease	0
sea vegetables	colorectal carcinoma	0
high-fat meal	galactose-1-phosphate uridyltransferase deficiency	0
exotic fruits	avian leukosis/sarcoma virus	0
juglan	cardiac sudden death	0
pithecolobium	vitamin deficiencies	0
goji berries	massive tremors	0
cayenne	fetal iodine deficiency disorder	0
dangerous plants	infarction	0
peppermint oil	manic depressive psychosis	0
zinger tea	corpse	0
cider vinegar	testicular neoplasms	0
consumer protection scientific committee on food	ulcerative colitis	0
kenaf	circulatory failure	0
citrus paradisi	cancer of stomach	0
wheatgrass	pyrosis	0
purple potatoes	crohns disease	0
milk proteins	marie-struempell disease	0
chili pepper	myalgia	0
chocolate bars	craniocerebral injury	0
dietary supplements	diabetic asymmetric polyneuropathy	0
plantago indica	nervous system degenerative diseases	0
monitoring food	weight gains	0
citrus sinensis	foreign bodies	0
prunus amygdalus	parkinson disease 2	0
flammulina	chronic b-cell leukemia	0
carbonated beverages	sleeplessness	0
mayo	spindle-cell carcinomas	0
cooked carrots	transmissible spongiform encephalopathy	0
healthier foods	fighting cancer	0
vaccinium bracteatum	rna tumor virus	0
eugenia jambolana	gall stones	0
salmonella food	leanness	0
cod	feminization	0
maple syrup	acute strokes	0
illicium anisatums	intertrochanteric fractures	0
dietary plant protein	pharyngitide	0
banana plants	static tremors	0
dioscorea villosa	paratuberculosis	0
pimenta officinali	bone cancer	0
zea mays	cystic disease of breast	0
cauliflower	renal failures	0
cannabis	renal calculi	0
jambolan plum trees	galactose 1 phosphate uridylyltransferase deficiency	0
little meat	pneumonitis	0
chewing gum	ovary neoplasm	0
vodka	somatotropin (acromegaly) hypersecretion syndromes	0
pie	reticulum cell sarcoma	0
pimenta diocias	diffuse lymphocytic lymphoma	0
sea bilberries	anticancer	0
norus	reproductive sterility	0
retail poultry	endometrial carcinomas	0
zedoary zedoaria	aids viruses	0
plant embryos	stomach neoplasms	0
entree	cancer of the tonsil	0
banana	human mammary neoplasms	0
millet	jakob creutzfeldt syndrome	0
healthiest vegetable	pulmonary diseases	0
bad foods	coronary diseases	0
crab apples	chronic insomnia	0
avena	gastric neoplasms	0
cooking oil	intermittent tremors	0
octopus	neoplasia	0
baptisia	burkitts lymphoma virus	0
spinach	sneezing	0
apple	hepatocellular cancer	0
toronja	impaired sensation	0
mother cell	familial creutzfeldt-jakob disease	0
guacamole	bowel disease	0
gala apples	acidosis	0
food companies	sudden-onset diabetes mellitus	0
liquorice	feline lymphoma virus	0
natto	air sickness	0
coffee	prediabete	0
illicium anisatum	bacterial infection	0
cassia	colicky pains	0
individual candy	flatus	0
persea americanas	diffuse small cleaved-cell lymphoma	0
reason food	car sickness	0
pummelo trees	atypical chronic myeloid leukemia	0
alpine strawberry	parkinsons disease	0
berry	somatotropin hypersecretion syndromes (acromegaly)	0
include flaxseed	exudative bronchiolitides	0
citrus limon	low backaches	0
hickory trees	anticancer	0
origanum onites	pustulosis of palms and soles	0
nonfat meal	cancer of the cervix	0
vaccinium ashei	kidney calculi	0
psyllium	schizoaffective disorders	0
lens culinari	ph1-negative myeloid leukemias	0
durum wheats	dairy product intolerance	0
sausage	macular dystrophy	0
indian corn	cardiogenic syncopes	0
psidium guajava	orthostasis	0
dioscorea opposita	bovine lymphosarcomas	0
fragaria	human papillomavirus viruses hpv	0
eupatorium rebaudianum	psychosis	0
pistachio nut trees	milk sugar intolerance	0
wisconsin milk	malignant meningioma	0
big food	mammary cancer	0
noncaloric sweetener	necrotizing fasciitides	0
club sodas	bovine lymphoma	0
box elders	a-v dissociations	0
overpriced vitamin	high cholesterol levels	0
triticum	insulin resistance	1
beer	prostate cancers	0
flower	plasmodium infection	0
foxglove	static tremors	0
chile pepper	spindle cell carcinoma	0
plum trees	bovine leukemias	0
fig	neoplasm metastasis	0
alpine strawberries	throbbing headaches	0
deli meats	premenstrual tension	0
acer	resting tremors	0
raphanus raphanistrum	intention tremors	0
vegetable protein	cva (cerebrovascular accident)	1
fenugreek seed	ovarian neoplasms	0
halibut	diffuse undifferentiated lymphoma	0
ocimum tenuiflorum	cjd (creutzfeldt jakob disease)	0
vitamin	kidney stones	1
noni fruit	preinvasive carcinoma	0
oyster mushrooms	gluten enteropathy	0
white meat	hyperventilation syncope	0
cucumis melo	spindle cell sarcomas	0
machaerium	rabies viruses	0
tobacco	angiomatous meningioma	0
ready-prepared foods	inflammation	0
split peas	bewilderment	0
component spices	dissociative amnesia	0
spinacia oleracea	germinoblastic sarcomas	0
citron tree	bechterew's disease	0
brussels sprouts	deglutitional syncope	0
mentha	fibromyalgia	0
norovirus food	zoonotic infectious disease	0
baked potato	myocardial infarct	0
infant formula	mptp induced experimental parkinsonism	0
bitter nightshades	intractable headaches	0
cinnamomum aromaticum	cervicitis	0
rubus glaucus	rectal cancers	0
arachis hypogaea	impaired sensation	0
prettiest fruit	visual seizure	0
quinoa	high grade lymphoma	0
bibhitaki fruit	low back pain	0
hot pepper	acquired immunologic deficiency syndrome	0
aspalathus linearis	vulva cancers	0
croaker	hypovolemic shock	0
national meat	adenosis of breast	0
colorful foods	anal ulcer	0
teosinte	premature aging	0
last meal	pus	0
beef	guillain-barré syndrome	0
zingiber officinale	protein deficiencies	0
lavandula	respiratory tract infection	0
soymilk	myeloma multiple	0
vaccinium uliginosum	ciguatera fish poisoning	0
sugary foods	short sleeper syndromes	0
coriander	cephalgia syndromes	0
mastictree	kidney cancer	0
acer saccharum	cephalgia syndromes	0
specific cheeses	inhibit cancer	0
food additives	chronic insomnia	0
gluten	circulatory failure	0
persea	degenerative diseases	0
wheat brans	diabetes complication	0
lycium	disc degeneration	0
contaminated meat	prion protein disease	0
almond	periodontal disease	0
skim milk	polymyositis ossificans	0
holy basil tea	rodent ulcers	0
cucumis melos	todds paralysis	0
algarrobo	growth hormone insensitivity syndrome	0
tachigalia	substance abuse	0
spice turmeric	bacterial vaginitis	0
oreo	juvenile onset diabetes	0
trigonella foenum-graecum	male sexual impotence	0
allium porrum	rebound insomnia	0
aloe vera	lymphatic sarcomas	0
whole grain cereal	cancer of the tonsil	0
brazil nuts	ekbom delusional parasitosis	0
deep-fried foods	retinitis	0
mother cells	renal cancer	0
acer negundo	bovine lymphosarcoma	0
fungus	dna injury	0
morel	bovine lymphoma	0
marshmallow	degenerative neurologic disorder	0
processed apples	nervous system degenerative diseases	0
lemon	disk degeneration	0
tumeric	aortic aneurysms	0
hawthorn	birth defect	0
parsley	memory losses	0
java plum tree	somatotropin (acromegaly) hypersecretion syndrome	0
acai berries	burning pain	0
calendula officinali	osteoarthritide	0
grape juice	uterine cancer	0
assai palms	inflammatory disease	0
baby formulas	myocardial infarction	0
juiced broccoli	toxic megacolon	0
crunch berries	acute strokes	0
indian laburnums	social phobias	0
maize	vaginal cancers	0
kangaroo meat	action tremor	0
preserved foods	olfactory seizure	0
calling eggs	degenerative intervertebral disk	0
spore	venereal wart	0
maize syrup	spatial memory disorders	0
fresh basil	cluster headaches	0
da huang	ciguatera poisonings	0
artificial sweetener	auricular fibrillations	0
atropa belladonnas	throbbing headache	0
cinnamomum verum	animal viruses	0
century plant	galactosemia 3	0
domestic fowls	intraepithelial prostatic neoplasia	0
biometal	food-borne illnesses	0
carya illinoenses	allergy	0
açai berry	utp hexose-1-phosphate uridylyltransferase deficiency	0
kaffir lime	liver neoplasms	0
guibourtia	asymmetric diabetic proximal motor neuropathy	0
curcuma zedoarias	encephalopathy	0
coriandrum	hepatitis	0
store licorice	fighting cancer	0
acer saccharums	membranous cataracts	0
color	study cancer	0
pumpkin seeds	micturition syncope	0
sparkling water	arrythmia	0
oat	penile neoplasm	0
solanum tuberosum	auditory seizure	0
purslane	urinary bladder neoplasms	0
cooking meat	guillaine barre syndrome	0
bean sprouts	amyloidose	0
almond tree	lyme arthritis	0
celebration meal	cancer of tonsil	0
thymus vulgaris	deep-vein thrombosis	0
pyrus	porcine endogenous retroviruses	0
brain-invasive pork	regional ileitis	0
bt corn	arthritide	0
powdered ginger	secondary insomnia	0
drink milk	substance addiction	0
kiwi	leiomyoma	0
powdered sugar	postoperative emesis	0
sweet almonds	schizophrenic disorders	0
common bean plant	lactose intolerance	0
hickory nut	memory disorder	0
vaccinium corymbosum	hemangioblastic meningioma	0
purple grape	ph1-negative myelogenous leukemias	0
walnut oil	fibroatheromatous plaque	0
term vegetable	philadelphia-negative myeloid leukemia	0
phytonutrient-rich food	mammary cancer	0
tepary beans	marek's disease virus	0
sesame	headache syndromes	0
soy protein	postviral fatigue syndrome	0
melissa	fibromyositis-fibromyalgia syndrome	0
steamer	foodborne diseases	0
black tea	liver cancer	1
psidium	mammary cancer	0
suggesting fruit	postviral fatigue syndromes	0
cranberry sauce	virus infection	0
colocasia	prion-induced disorder	0
conventional food	crushing skull injuries	0
cassia fistula	retained surgical tools	0
cupcake	pus	0
hop	physical suffering	0
citrus grandis	paraesophageal hernia	0
chipotle	endometrial neoplasm	0
petroselinum crispums	secondary fibromyalgias	0
granny smith apples	grippe	0
assai palm berries	cephalgia syndrome	0
grecian foxglove	cancer of thyroid	0
lemon balms	high cholesterol level	0
poppy seeds	chronic diseases	0
cherry plum tree	posterior fossa meningioma	0
avenas	ciliary neuralgia	0
betel nuts	brain cysticercosis	0
organic plants	myocardial infarct	0
carduus marianus	dyslipidemia	0
chai tea	bleed	0
frier	paralysis	0
flaxseed	ph1-negative myelogenous leukemia	0
sticker	uveitis	0
eating almonds	effort syncopes	0
black pepper	drug dependence	0
organic meat	ramsay hunt paralysis syndrome	0
triticum turgidum	galactose 1 phosphate uridyl transferase deficiency disease	0
ground flax	schizophreniform disorders	0
cuminum	drug addiction	0
andira	asthma	0
pistacia	chronic obstructive lung disease	0
kola nuts	cervical migraine syndrome	0
mustard greens	deafness	0
wild yam	ekbom psychogenic parasitosis	0
red lentils	chronic b lymphocytic leukemia	0
cayenne pepper	ischemic heart diseases	0
no-calorie sweeteners	chronic fatigue syndromes	0
woodland strawberries	substance-induced organic mental disorders	0
thymus vulgari	sleep wake disorder	0
measuring food	congenital defect	0
japanese plums	physical anhedonias	0
edible grain	skin disease	0
tisane	esophagitide	0
replenish nutrients	toxico-infectious botulism	0
phaseolus acutifolius	hair losses	0
marsh mallows	high-grade lymphomas	0
lard	head pains	0
glycyrrhiza glabra	heat strokes	0
afzelia	atherosclerose	0
citrus maxima	royal free disease	0
lemon tree	iron deficiency	0
diospyros digynas	basal cell carcinoma	0
haritaki fruit	drug hypersensitivity	0
vegetable juices	birth weight	0
nutraceutical	stomach ulcers	0
french bean plants	mania	0
cruciferous foods	progressive disorder	0
white mallows	substance use disorders	0
popcorn	cancer of the colon	0
solanum	phlebothrombosis	0
fat foods	colon neoplasms	0
nettle	disc degradations	0
callerya	xanthomatous meningiomas	0
regular carrots	malignant brain neoplasm	0
malus	constrictive bronchiolitis	0
curcuma longa	chronic infectious mononucleosis-like syndrome	0
flax seed	visceral obesities	0
density foods	cervix neoplasm	0
eragrostus	auricular fibrillations	0
rabbit meat	utp hexose 1 phosphate uridylyltransferase deficiency disease	0
arginine-rich foods	gall bladder diseases	0
billion eggs	bladder cancers	0
sweetener	idiopathic proctocolitis	0
kava kava	amnesia memory loss	0
amomum cardamomums	colic	0
legume pods	malignant epithelial tumor	0
raw cranberries	anxiety neuroses	0
lime	acute monoblastic leukemias	0
salami	urticarias	0
melissa officinalis	fever	0
longevity legumes	ischemic heart diseases	0
baking chocolate	adolescent obesity	0
cicer arietinums	kidney calculus	0
chenopodium quinoa	cryptogenic epilepsies	0
chinese cassia	chronic lymphoblastic leukemia	0
pudding	diffuse mixed small and large cell lymphoma	0
red rice	tonsil neoplasms	0
granny smith	renal neoplasms	0
chile peppers	common bile duct gall stones	0
processed meat	drug allergy	0
drinking milk	small round structured viruses	0
cassia cinnamon	gehrig's disease	0
sugar substitute	prion-associated disorders	0
fruit juices	t virus	0
solanum laciniatum	urinary bladder neoplasms	0
sweetening agent	fibrous meningioma	0
agave	malignant lymphomas	0
exotic fruit	gluten-sensitive enteropathies	0
lunch time	uveitis	0
sunfish	pulmonary thromboembolisms	0
origanum majorana	pulmonary inflammations	0
brassica juncea	cerebral stroke	0
coriandrum sativums	schizophreniform disorders	0
olive oil	postural syncopes	0
pecan tree	acute monocytic leukemias	0
shiitake mushroom	grave’s disease	0
green grapes	communicable diseases	0
piper nigrum	classic galactosemias	0
new candy	muscular rheumatism	0
soy proteins	fight cancer	0
english walnuts	breast disease	0
cymbopogon nardus	bipolar disorder	0
ranking foods	monocular blindness	0
pea	primary parkinsonism	0
illicium	thrombus	0
marijuana	uterine fibromas	0
carica	pancreatitis	0
sweet orange	uterine cervical neoplasms	0
soy cheeses	central nervous system intracranial disorders	0
aloe	vestibular seizure	0
fennel	barrett metaplasia	0
cocktail	leprosy	0
stryphnodendron	renal calculus	0
justicia adhatoda	spongiform encephalopathies	0
raphanus sativus	premenstrual tensions	0
poppy	uterine fibroid	0
pancake	post traumatic osteoporosis	0
pimpinella anisums	foreign objects	0
bellis	colorectal tumors	0
brassica	experimental lung inflammations	0
chinese cinnamon	human papilloma virus	0
lucerne	gastric cancers	0
processed foods	menstrual pains	0
lentil	human herpesvirus 4 (gamma)	0
teff	hormonal dysfunction	0
seven nutrients	back ache	0
different fruits	cancer of the testis	0
butter milk	temporal region trauma	0
soy milk	paraosmia	0
mustard plant	cancer of lung	0
horsemeat	bacterial infections	0
plum tree	heart disease	0
chanterelle	ciguatera poisonings	0
amlas	hyperventilation syncope	0
citron trees	contagious pustular dermatitis	0
carob	pernicious vomiting of pregnancy	0
moose meat	tongue cancer	0
acaí berries	htlv-iii	0
triticum turgidum subsp. durum	ekbom dermatozoic delusion	0
wild celeries	disc degradation	0
justicia	urinary tract infection	0
cruciferous vegetable	amyotrophic lateral sclerosis with dementia	0
texturized vegetable protein	amyloid plaques	0
flavorer	high blood pressures	0
barberry	cramp	0
macadamia	sore throats	0
red meats	gehrig disease	0
mangosteen	gorlin goltz syndrome	0
cinnamomum zeylanicum	prostatic hyperplasia	0
contamination meat	diffuse mixed cell lymphoma	0
syzygium	ankylosing spondylitis	0
corn	carcinoma	0
oregano plant	zoonotic disease	0
citrus aurantiums	papillary meningiomas	0
sweet basils	epilepsy	0
food company	chronic cluster headache	0
althea officinalis	anaplastic carcinoma	0
bhang	increase cancer	0
food supplementations	aortic aneurysm	0
oolong tea	anoxia	0
dioscorea batatas	malignant meningiomas	0
citrus bergamias	autosomal recessive juvenile parkinsonism	0
dried plums	endometriose	0
lemon balm tea	avian leukosis/sarcoma virus	0
eating fruits	sore throat	0
almond oil	goiter	0
prosopi	rachitis	0
brew	crushing pain	0
cantaloupe	stomach neoplasms	0
deli meat	inappropriate gh secretion syndrome (acromegaly)	0
star anise	ph1-negative myeloid leukemia	0
hypericum perforatum	amyloidosis	0
herbal tea	degenerative neurologic disorders	0
solanum laciniatums	primary growth hormone resistance	0
cardamom	esophagitis	0
vegetarianism	osteoporose	0
miso	lung inflammations	0
molasses	micturition syncope	0
black sapotes	schizophrenic disorders	0
mastic tree	vaginal cancers	0
secale cereale	endocrine breast disease	0
actual licorice	massive tremor	0
allium sativum	subacute spongiform encephalopathy	0
myristica fragrans	microglandular adenosis	0
regular olive	atrioventricular dissociation	0
olive	sneeze	0
acacia tree	venereal warts	0
sweetleaf	diabetic mononeuropathy simplices	0
cappari	osteoarthrosis deformans	0
apple tree	alopecia	0
rheum tanguticum	low back aches	0
apricot tree	age related memory disorders	0
althaea officinalis	atrial fibrillations	0
deep-fry foods	cancer of the skin	0
orange juice	virus	0
blueberry plants	bewilderment	0
yolk	upper respiratory infection	0
citrus reticulatas	diarrhea	0
berberis	ponv	0
nut	reverse cancer	0
ganja	prediabetic states	0
corn oils	memory losses	0
citronella	urticaria	0
ultra-processed foods	diabetic asymmetric polyneuropathy	0
jerusalem artichokes	uterine cervical neoplasm	0
plum	multiple meningioma	0
dietary sucrose	acquired immuno-deficiency syndrome	0
animal-based vitamin	respiratory tract infection	0
high-fructose maize syrup	malignant tumor of breast	0
mentha spicata	pseudotumor cerebri	0
vaccinium myrtillus	paraesophageal hernia	0
allium cepa	poisoning	0
brewage	neonatal tremor	0
tea hibiscus	coronary diseases	0
carya illinoensis	vulva cancers	0
animal-based foods	mental deterioration	0
mangiferas	acute coryza	0
celery	muscle tremors	0
pummelo tree	occipital trauma	0
maple	hypermelanosis	0
usda poultry	malignant epithelial tumor	0
eugenia malaccensis	recurrent brain tumor	0
ovary	schizophreniform disorder	0
dietary fats	autoimmune disorders	0
sweetening agents	rebound insomnia	0
calendula	metabolic acidosis	0
cereal	classic galactosemia	0
clove	dysosmia	0
vegetable juice	schizophreniform disorder	0
organic food	diffuse mixed-cell lymphomas	0
jalapeno peppers	substance use disorders	0
bell peppers	cancer of the cervix	0
legume pod	intraventricular meningiomas	0
broad beans	occipital region traumas	0
cooked meat	parodontosis	0
cucumber	ph1-negative myeloid leukemias	0
kava	male breast enlargement	0
althaea	mastodynia	0
cortland	prostatic neoplasm	0
crowberry	vaginal discharge	0
mandarin orange trees	atypical cluster headache	0
brown sugar	early-onset parkinsonism	0
pecan trees	nonspecific vaginitis	0
use sweeteners	human t cell leukemia virus type iii	0
mangifera indica	tonsil cancers	0
floret	tactile hypesthesia	0
dioscorea	neoplasm metastasis	0
pimpinella anisum	drug abuse	0
nicotiana	painful menstruations	0
organ meats	secondary insomnia	0
nori	fetal iodine deficiency disorder	0
individual food	pulmonary disorder	0
meal	type 1 diabetes mellitus	0
herr	diabetes complication	0
tuna	polyp	0
happy meal	uterine fibroma	0
bergamot	pancreas neoplasm	0
anacardium occidentale	colonic inertia	0
trigonella foenum graecum	periorbital headaches	0
cola acuminata	age-related maculopathies	0
safflower oils	heart blocks	0
common foxglove	pyrosis	0
artificial butter	endometrial neoplasms	0
squash	thyroid carcinoma	0
mint	endometrial carcinomas	0
shorten	testis neoplasm	0
lima beans	testis neoplasm	0
wild bananas	asthma	0
zucchini	barrett epithelium	0
fried foods	lou gehrig disease	0
tangerine tree	fibromyalgia	0
spaghetti	endothelial dysfunction	0
cucurbita	hemolytic jaundices	0
wild radish	bladder tumor	0
toxic plants	variant creutzfeldt-jakob disease	0
chamomile oils	polyarthralgia	0
chicken salad	drop attack	0
musa	deep vein thromboses	0
sesamum	constrictive bronchiolitides	0
goji berry plants	bovine leukemias	0
poisonous plants	galactosemia 2s	0
plant capsule	diabetic neuropathies	0
low vitamin	tonic-clonic seizures	0
nicotiana tabacums	benign prostatic hyperplasia	0
raisin bran	auricular fibrillation	0
garbanzo	chronic fatigue-fibromyalgia syndromes	0
dietary fat	chronic fatigue syndrome	0
scrambled eggs	epithelioma	0
fabaceae	carcinoma	0
prosopis	manic-depressive psychoses	0
cymbopogon	subtrochanteric fractures	0
white mallow	lichen ruber planus	0
salmonella-infected eggs	urinary bladder diseases	0
chinese cinnamons	mad cow diseases	0
rhubarb	acute fulminating multiple sclerosis	0
hypericum	skin cancers	0
black rice	classic galactosemias	0
elettaria	cvas (cerebrovascular accident)	0
solanum melongenas	breast dysplasia	0
butternut squash	episodic cluster headaches	0
kombucha teas	seasickness	0
carbonated mineral waters	tonic clonic seizures	0
almond trees	manic-depressive psychoses	0
syzygium jambos	ph1 negative myeloid leukemia	0
low fruit	tussive syncopes	0
mussel	cognitive impairments	0
oxen meat	epithelioid sarcoma	0
breast milks	testis cancer	0
soy bean curd	foodborne botulism	0
coconut milk	reduced sensation	0
hibiscus	prostate neoplasms	0
flax	olfactory seizures	0
earl grey tea	arthrose	0
hemp plant	myocardial infarcts	0
beta vulgaris	well-differentiated lymphocytic lymphoma	0
no meat	juvenile parkinsonisms	0
petroselinum crispum	endometrial carcinomas	0
dried food	basal cell epithelioma	0
oregano plants	allergic reactions	0
okra	deep-vein thromboses	0
rowanberry	spindle-cell carcinomas	0
agaricaceae	headache disorder	0
cuminum cyminum	reduced sensation	0
hot sauce	cardiovascular conditions	0
antioxidant-rich foods	transient blindness	0
curry	ileocolitis	0
cocoa plant	essential tremors	0
antioxidant food	posterior compartment low back pain	0
indian gooseberry	hhv-4	0
kavas	age related maculopathies	0
health nuts	weight reduction	0
vaccinium macrocarpons	minor head injury	0
vaccinium angustifolium	skin rash	0
apricot trees	early awakening	0
vaccinium virgatum	oxygen deficiencies	0
blueberry plant	increase cancer	0
portulaca oleracea	neurocysticercose	0
including cloves	malignant primary brain neoplasms	0
apricot	tumor virus	0
green lentils	arthralgia	0
red tea	disk degradation	0
texturized vegetable proteins	cervix neoplasms	0
pinto beans	anosmia	0
so-called meat	peripheral artery disease	0
apple trees	small cleaved-cell lymphoma	0
brassica nigra	disorders of initiating and maintaining sleep	0
warm milk	visual seizure	0
cacao	ekbom delusory parasitoses	0
meal times	brain diseases	0
pickled vegetables	birth weights	0
food and drug administration	acquired immunodeficiency syndrome virus	0
kidney bean	gluten-sensitive enteropathies	0
healthiest beverage	udp-galactose-4-epimerase deficiency disease	0
so-called vegetable	sleep initiation dysfunction	0
fructose corn	reactive confusion	0
breast milk	pancreatitide	0
jelly	substance-induced organic mental disorders	0
new vitamin	amyloidose	0
burrito	histamine cephalgias	0
thymus plants	rhabdomyolysis	0
lens plants	creutzfeldt jakob syndrome	0
hummus	chronic insomnia	0
illicium verums	intermediate grade lymphoma	0
sweet marjorams	basal cell nevus syndrome	0
fuji apples	motor seizures	0
black sapote	renal cancer	0
broth	preventing cancer	0
anana	cranial pain	0
blossom	headache syndrome	0
adhatoda	lymphatic sarcomas	0
trace mineral	liver dysfunction	0
pomegranate fruit	malignant tumor of breast	0
amaranth	irritable bowel syndrome	0
dietary plant proteins	reticulum-cell sarcomas	0
soft drinks	vulva cancers	0
erythroxylon	muscle disease	0
ocimum basilicums	premenstrual syndrome	0
prebiotic	autoimmune disorders	0
unrefined plant	arthrosis	0
recommend tea	grave’s disease	0
shellfish	hypospadia	0
plant-based nutrients	a-v dissociation	0
ice creams	excess cancer	0
uncooked food	autosomal dominant juvenile parkinsonism	0
morinda citrifolia	anxiety disorders	0
euterpe edulis	food hypersensitivity	0
indian laburnum	sphenoid wing meningioma	0
good soybeans	fibrositis	0
basil	germinoblastoma	0
plant aril	congenital abnormalities	0
carica papayas	galactose epimerase deficiencies	0
abelmoschus	ebv	0
mackerel	degenerative disease	0
ready prepared foods	utp hexose 1 phosphate uridylyltransferase deficiency disease	0
vegetable proteins	intracranial cns disorders	0
tomato sauce	non b hepatitis epidemic non a	0
flesh foods	diffuse small cleaved cell lymphoma	0
macadamia nuts	salmonella infection	0
citrus grandi	lymphatic sarcomas	0
reindeer meat	acute inflammatory polyradiculoneuropathy	0
crataegus	tussive syncopes	0
squash plant	acquired immune deficiency syndrome virus	0
canned fruit	presyncope	0
diospyro	carsickness	0
ilex paraguarienses	endometrium cancers	0
citrullus	cancer of thyroid	0
piper methysticum	brain malignant neoplasm	0
fries	severe gh insensitivity	0
soda pops	low grade lymphoma	0
bitter orange tree	animal virus	0
eupatorium rebaudianums	endocrine breast diseases	0
glycine max	uterine fibromas	0
elettaria cardamomum	salmonella infections	0
bell pepper	myeloid leukemia	0
cassia fistulas	huntingtons disease	0
shiitake mushrooms	malignant meningioma	0
licorice root	acidosis	0
empty calorie foods	autosomal dominant. juvenile parkinson disease	0
cereal grains	stomach cancers	0
nicotiana tabacum	cll lymphoplasmacytoid lymphomas	0
leaf lettuce	pulmonary neoplasm	0
four nuts	chronic lymphatic leukemia	0
hazelnut	gut dysfunction	0
anise tea	prostatic cancer	0
olive trees	sick headache	0
corn syrup	semirhythmic tremors	0
sugar	mottled enamels	0
kale	mixed lymphocytic-histiocytic lymphoma	0
pistacia vera	fibrositis	0
dietary supplement	stomach ulcers	0
diospyros digyna	torsion fractures	0
citrus aurantiifolia	atheroma	0
gluten-free diet	dementia praecox	0
dragon fruit	esophagus neoplasm	0
pleurotus ostreatus	norwalk-like viruses	0
ready-to-eat meal	colicky pains	0
canned foods	secondary insomnia	0
low-calorie diet	ciguatera poisonings	0
dioscorea polystachya	angiomatous meningioma	0
pumpkin	galk deficiency	0
brinjal	galactokinase deficiency diseases	0
thousand foods	diabetic polyneuropathy	0
red meat	carcinoma of endometrium	0
soda waters	rachitis	0
whipped cream	acquired immunodeficiency syndrome	0
eating nuts	static tremor	0
english plantains	hypoesthesia	0
muffin	polyp	0
vitis vinifera	postoperative nausea and vomiting	0
chicken	heart failure	0
raw alfalfa	primary malignant brain tumors	0
food allergy	carotid sinus syncope	0
curcuma	minor head injury	0
sweet potatoes	atrioventricular dissociation	0
elephant garlic	preventable cancers	0
rosa	aids viruses	0
bertholletia excelsas	eczematous dermatitis	0
salad	acute confusional migraines	0
collard greens	bilateral deafness	0
anti-inflammatory plant	relapse	0
goiaba	common bile duct gall stones	0
pepper	complete blindness	0
chinese yams	upper respiratory infection	0
new york coalition for healthy school food	cancer of the tonsil	0
fortify milk	soft tissue sarcomas	0
own vitamin	macular degeneration	0
soda water	congenital myxedema	0
neutraceutical	carcinomatose	0
grape seeds	olfactory groove meningiomas	0
trace elements	metastasis	0
sweet almond	pulmonary disease	0
soy beverages	milk sugar intolerance	0
decrease meat	cardiac failure	0
porgy	acute monocytic leukemia	0
narrow-leaved plantain	atrioventricular dissociations	0
brussel sprout	acquired immunologic deficiency syndrome	0
sweet basil	parkinsonian syndrome	0
cheese	sudden cardiac arrest	0
romaine lettuce	somatotropin hypersecretion syndromes (acromegaly)	0
smoked foods	kidney insufficiency	0
citrus hystrices	micturition syncope	0
narrow leaved plantain	food-borne diseases	0
euterpe	cancer of kidney	0
phaseolus vulgari	vagina neoplasms	0
human milk	cat leukemia viruses	0
piper methysticums	spasm	0
toxic plant	plasma-cell myelomas	0
cabbage	air sickness	0
bottled water	lead poisoning	0
soy foods	hypoascorbemia	0
morinda citrifolias	penile neoplasms	0
papaver	muscle spasms	0
mentha x piperita	spindle-cell carcinomas	0
chewing gums	cerebral stroke	0
hydroponic basil	spindle-cell carcinoma	0
fake meat	somatotropin (acromegaly) hypersecretion syndromes	0
fenugreek	human t-lymphotropic virus type iii	0
hordeum	insomnia	0
lunch times	mouth cancers	0
prenatal vitamins	ovarian cancer	0
fiddlehead ferns	bovine leukemia virus	0
morning meal	sleep initiation and maintenance disorders	0
lycopersicon esculentum	guillaine barre syndrome	0
celery root	human mammary neoplasms	0
soda pop	vulva neoplasms	0
soy sauce	myelomatosis	0
dress	myelomatosis	0
cynara scolymus	lens opacities	0
eugenia cumini	non hodgkin's lymphoma	0
horse nettles	retinitis	0
curried tofu	frontal region trauma	0
sorrel	uveitide	0
dessert	preterm birth	0
hamburger	fifth phacomatosis	0
strawberry	familial tremor	0
dinner time	ischemic heart disease	0
syzygium jambolanum	irritable bowel syndrome	0
study lavender	colorectal carcinoma	0
honeybush tea	hansen's disease	0
health food	oncornavirus	0
infant formulas	multiple myelomas	0
red wine	zoonotic disease	0
citrus bergamia	rabies viruses	0
acai berry	zoonotic infectious diseases	0
silybum marianums	perioral tremors	0
soy bean curds	intraventricular meningioma	0
specific foods	fibrocystic breast disease	0
dripping	nephrolith	0
virgin olive	hypoesthesia	0
star anises	reduced sensation	0
placenta	cognitive dysfunctions	0
not-necessarily-so-healthy foods	hiccough	0
texturized soy protein	degenerative neurologic diseases	0
pineapple	lewy body parkinson's disease	0
healthy snack	lav-htlv-iii	0
persimmon	uterine fibroid	0
barley	coronary heart disease	0
ground beef	galactosemia	0
food poisoning	breast cancers	0
theobroma cacao	migraine headaches	0
baby spinach	rectal neoplasms	0
poenumgraecum	female infertility	0
treat	chronic b-lymphocytic leukemia	0
soy	macular dystrophies	0
fruit and vegetable juices	diabetic mononeuropathy simplex	0
syzygium malaccense	acute inflammatory polyneuropathy	0
shoot	galactose-1-phosphate uridyl-transferase deficiency disease	0
cleistocalyx	premature births	0
black beans	neurologic degenerative diseases	0
ficus	endometrial neoplasms	0
andropogon nardus	social anhedonia	0
turnip	breast cystic disease	0
caramel	environmental cancer	0
trigonella foenum-graecums	gossypiboma	0
golden glow	head pain	0
bok choy	spiral fracture	0
fragaria vesca	burkitts lymphoma virus	0
dried fruit	amyloidose	0
atropa belladonna	vertex headache	0
dinner	colon neoplasm	0
potato chips	post-ictal confusion	0
amorpha	sneeze	0
açai berries	minor head injury	0
soy bean proteins	fibrocystic disease of breast	0
food colors	food borne diseases	0
gum acacia	galactosemia iii	0
golden delicious	auriculo-ventricular dissociation	0
chinese yam	gehrig disease	0
brewed coffee	oxygen deficiency	0
mustard seeds	ductal carcinoma	0
origanum	bacterial vaginosis	0
unfertilized eggs	multiple meningiomas	0
poppy seed	lymphoplasmacytoid lymphoma	0
restructured meat	wheat hypersensitivity	0
kiwi fruit	esophagitide	0
grilled meat	sliding esophageal hernia	0
sun-dried raisin	primary parkinsonism	0
holy basils	pseudoaphakia	0
whale meat	chronic lymphatic leukemia	0
majorana hortensis	chronic fatigue-fibromyalgia syndrome	0
potato	papillary meningioma	0
cassia trees	heart disease	0
low-fat diet	breast neoplasm	0
seltzer water	androgenetic alopecia	0
walnut	ovarian cancers	0
oregano	anxiety neuroses	0
prunus salicina	galactose-1-phosphate uridyltransferase deficiency	0
copaifera	guam form amyotrophic lateral sclerosis	0
lavender	relapse	0
dietary fibers	cognitive retention disorder	0
cashew	barrett's esophagus	0
white bread	abdominal migraines	0
incorporate cloves	back pain with radiation	0
triticum aestivum	burkitt herpesvirus	0
chervil	intracranial cns disorder	0
whole grains	philadelphia-negative myeloid leukemia	0
silybum marianum	renal cancers	0
origanum vulgare	male sub-fertility	0
hibiscus tea	botulism	0
taraxacum officinale	cerebral convexity meningioma	0
black currants	small lymphocytic lymphoma	0
java plum trees	female sub fertility	0
açaí berry	aids virus	0
solanum lycopersicum	cot deaths	0
almond milk	resting tremor	0
romaine	galactose epimerase deficiency	0
citrus reticulata	hyperemesis gravidarum	0
nuclear power plant	sarcopenia	0
punica granatums	leucocythemia	0
milk thistles	proteinuria	0
food supplement	treat cancer	0
fennel seeds	ciguatera poisoning	0
illicium verum	acute inflammatory polyradiculoneuropathy	0
fast food	marie struempell disease	0
malus domestica	abdominal obesities	0
triticum durum	endothelial dysfunction	0
soy bean	deep-vein thromboses	0
rheum rhaponticum	familial juvenile parkinsonism	0
common foxgloves	e-b virus	0
sugar maples	spontaneous abortions	0
apium graveolens	pus	0
lettuce	constrictive bronchiolitides	0
stem vegetables	dwarfism	0
dairy eggs	thyroid diseases	0
curcuma longas	bilateral headaches	0
phyllanthus emblica	frontal region traumas	0
black raspberries	metastatic cancer	0
fenugreek seeds	malignant brain neoplasms	0
carya	somatotropin (acromegaly) hypersecretion syndromes	0
horse bean	heart diseases	0
dasheen	norwalk like viruses	0
plant capsules	blindness	0
isoglucose	acromegaly	0
sugar-sweetened beverages	cancer of prostate	0
healthy food	mechanical low back pain	0
chocolate	lung disorders	0
leguminosae	thyroid adenomas	0
zea	air sickness	0
potassium-rich foods	epilepsy	0
brewing tea	atypical cluster headaches	0
ephedra	hepatic failure	0
plant zygotes	hemorrhage	0
different seed	diabetes-related complication	0
broccoli	gassers syndrome	0
club soda	muscular spasms	0
dried foods	gastric cancers	0
corylus	hereditary essential tremor	0
banana plant	renal neoplasm	0
healthiest beverages	mania	0
citrus fruit	drug use disorder	0
morning meals	hemolytic uremic syndrome	0
fed beef	testicular tumors	0
fermented foods	lassitude	0
turmeric	bovine leukemia virus	0
collard green	colonic neoplasm	0
rooibos	migraine disorders	0
find pork	muscle spasms	0
goji berry	brain tumor	0
soybean	intraepithelial neoplasm	0
artificially-flavored corn	fibromyalgia	0
green teas	neoplasm	1
tree nuts	avian leukosis/sarcoma virus	0
emblica officinali	hypercapnia	0
sour fruit	chronic lymphocytic leukemia	0
organic foods	forehead trauma	0
diabetic diets	small cleaved-cell lymphoma	0
opium poppies	gluten enteropathies	0
ribes nigrum	retro ocular headache	0
cultivated oats	deaf mutism	0
sushi	rebound insomnia	0
red peppers	chronic headache	0
shiitake	idiopathic polymyositides	0
citrus aurantiifolias	open head injury	0
bertholletia excelsa	syncopal episode	0
cola nitida	inflammatory polyneuropathy acute	0
know nuts	increased cancer	0
porphyra	fibroatheroma	0
cranberry	oral cancer	0
mentha spicatas	burkitt herpesvirus	0
foeniculum	massive tremors	0
trace element	benign prostatic hyperplasia	0
trigonella	neuralgic migraine	0
food additive	cardiovascular disease	0
dietary sugars	inappropriate growth hormone secretion syndrome (acromegaly)	0
kawa	udpglucose 4 epimerase deficiency disease	0
elettaria cardamomums	fibromyalgia	0
vaccinium macrocarpon	lyssa	0
bread	osteoarthrosis deformans	0
delonix	plasma cell myeloma	0
hashish	uterine cervical neoplasms	0
seville orange trees	broken bones	0
grapefruit juice	gall stone	0
national pork	degenerative arthritides	0
asparagus	neoplasm	0
gooseberry	childhood onset obesity	0
crataegus monogynas	irritable bowel syndromes	0
linum	gassers syndrome	0
milk thistle	cerebrovascular accident	0
junk food	gall stone	0
feather meal	wheat allergies	0
healthier meat	spinal cord disease	0
soybean proteins	cardiovascular strokes	0
thyme	rest tremors	0
roasted almonds	food-borne disease	0
dark chocolate	prion protein disease	0
cannabis indicas	hypospadia	0
pimenta officinalis	aphthous ulcer	0
ultra-processed food	benign intracranial hypertension	0
pisum sativum	bone neoplasm	0
açaí berries	backache	0
poultry	cancer of the vulva	0
high-fructose corn	lymphocytic lymphomas	0
abelmoschus esculentus	passive tremor	0
chamomile oil	atypical cluster headaches	0
anacardium	food borne illnesses	0
foie gras	sclerosis	0
pomegranate seeds	senile tremor	0
mushroom	barrett metaplasia	0
ceratonia	leukemia virus	0
shan yaos	hypersensitivity	0
plantago seed	leukemogenic virus	0
split pea	prion-associated disorders	0
allspice	breast carcinomas	0
thymus	atherosclerotic plaque	0
wine	craniocerebral injury	0
swiss chard	autoimmune condition	0
saccharomyces cerevisiae	malignant brain neoplasm	0
incorporates cloves	painful menstruations	0
flavourer	pulmonary embolism	0
carbonated waters	tumor of rete testis	0
portulaca	intermediate-grade lymphoma	0
frozen spinach	pseudotumor cerebri	0
peanut	weight gains	0
fast foods	short sleeper syndrome	0
pistachio nut tree	cluster headache syndromes	0
soup	diffuse undifferentiated lymphoma	0
digitalis lanata	kidney insufficiency	0
rose hips	male breast enlargement	0
rosemary	spinal meningioma	0
humulus	intraepithelial carcinoma	0
ginger	craniocerebral injury	0
nut bars	histamine cephalgias	0
cocoanut	gastric ulcers	0
pistacia lentiscus	diabetes complications	0
fava bean	global amnesia	0
lamb chops	chest pain	0
cocoa butter	cardiogenic syncopes	0
ginger ale	cancer of breast	0
mustard plants	basal cell epithelioma	0
food pyramid	polyp	0
seafood	anthrax	0
avoid peanuts	plasma cell myeloma	0
orange	prostatic neoplasms	0
digitalis purpurea	precordial catch	0
syzygium aromaticum	cerebrovascular stroke	0
sustenance	heat stroke	0
mashed potatoes	somatotropin (acromegaly) hypersecretion syndrome	0
eating meat	laron syndrome	0
cicer	generalized headaches	0
euterpe oleracea	zoonotic diseases	0
olive tree	hemolytic uremic syndrome	0
cocoa	amyotrophic lateral sclerosis motor neuron disease	0
kohlrabi	cognitive retention disorder	0
prunus cerasifera	chicken virus	0
syzygium cumini	sinusitide	0
suggesting apple	bilateral headache	0
ocimum sanctum	human influenza	0
lactuca sativa	pregnancy pernicious vomiting	0
fagopyrum tataricum	postoperative emeses	0
veggie	coronary diseases	0
malabar-nut	tor-driven diseases	0
chickpea	multiple meningioma	0
triticum spelta	early onset parkinsonism	0
ground ginger	parkinson's disease	0
poultry products	irritable bowel syndromes	0
catfish	vagina cancers	0
pomelo trees	secondary fibromyalgias	0
anti-inflammatory foods	myeloid leukemia	0
cranberry juice	mad cow disease	0
betel nut	encephalon diseases	0
garcinia mangostana	autoimmune diabetes	0
mandarin orange tree	small-cell lymphoma	0
squash seeds	age-related maculopathies	0
mango	drug abuse	0
consumed chocolate	kanner's syndrome	0
horsebean	forehead traumas	0
flammulina velutipes	myocardial infarcts	0
mirobalanus embilicas	fibroid	0
sour cream	primary brain neoplasms	0
japanese plum	galactose-1-phosphate uridylyltransferase deficiencies	0
prunus salicinas	cancer of brain	0
raphanus	papillomaviridae	0
carbonated mineral water	cognitive impairment	0
chestnut	sleep wake disorders	0
foenumgraecum	brain vascular accidents	0
dried fruits	passive tremor	0
baby formula	menstrual disorders	0
egg	basal cell epitheliomas	0
soy cheese	impaired sensations	0
low meat	chronic fatigue fibromyalgia syndrome	0
glycyrrhiza	cancer of the tonsil	0
eggplant	aphthous stomatitides	0
lens culinaris	tongue neoplasm	0
ready-to-eat meals	contagious pustular dermatitis	0
serve	neuralgic migraine	0
ribe	rest tremors	0
assai palm	hyperpigmentation	0
oolong	thyroid neoplasms	0
petroselinum	penis cancers	0
jalapeno	rupture	0
rose berries	plegia	0
anise seed	norwalk-like viruses	0
wolfberry	ovary neoplasm	0
fryer	chronic airflow obstructions	0
coconut water	botulism	0
marjoram plants	feline lymphoma virus	0
flounder	brain neoplasm	0
guava	primary gh resistance	0
table sugar	apneas	0
mealtime	autism	0
rooibo	testicular cancers	0
nut bar	esophageal cancer	0
wild yams	cognitive decline	0
green peas	rabies	0
aspalathus	wound botulisms	0
buckwheat	abdominal aortic aneurysm	0
spicy food	birth weight	0
horsenettle	cancer of thyroid	0
saffron	bechterew's disease	0
horse beans	throbbing headache	0
seltzer waters	cancer of skin	0
chilli peppers	prion-induced disorders	0
fat milk	barrett esophagus	0
bolete	convulsion	0
yerba mates	male breast carcinoma	0
crocus sativus	b12 deficiency	0
punica granatum	biliary calculi	0
refined olive	ph1 negative myeloid leukemia	0
retail meat	pustulosis palmaris et plantaris	0
zingiber officinales	involuntary quivers	0
wild celery	heartburn	0
orange trees	hemangioblastic meningioma	0
chinese rhubarb	brain cysticercosis	0
radicchio	lymphocytic leukemia	0
legume family	chronic disease	0
roundup-ready soybeans	dripped virus	0
green tea	pustular psoriasis of palms and soles	0
plant arils	inflammatory polyneuropathy acutes	0
macadamia nut	cancer of ovary	0
smoked food	severe mental disorders	0
fagopyrum esculentum	gut dysfunction	0
ready soybeans	cluster headaches	0
dairy product	malignant lymphoma	0
drink tea	intraorbital meningiomas	0
ale	rhabdomyolysis	0
pinto bean	cognitive dysfunction	0
cold-steeping tea	papillary meningioma	0
lycium barbarum	breast fibrocystic disease	0
drug administration united states food	tactile hypesthesias	0
yellow vegetables	retained surgical instrument	0
oyster mushroom	throat cancer	0
persea americana	elevated cholesterols	0
hibiscus sabdariffa	autoimmune condition	0
green peppers	ph1-negative myeloid leukemia	0
pimenta diocia	colonic inertia	0
syzygium sandwicense	uterine fibroma	0
infects apples	cancer of the skin	0
coco	nonalcoholic steatohepatitides	0
caper	uterine leiomyoma	0
betel	cot deaths	0
tempeh	pattern baldness	0
kava kavas	ms (multiple sclerosis)	0
glucose-fructose syrup	cataract	0
milk	muscle tremor	0
plantain	inflammatory polyneuropathy acutes	0
food manufacturers	intervertebral disk degenerations	0
drink	landry guillain barre syndrome	0
spice saffron	diabetic neuropathies	0
nutrient-dense foods	feminization	0
coconut	pancreas cancer	0
coriandrum sativum	body weight	0
filtered coffee	convulsion	0
broccoli raab	microglandular adenosis	0
beet greens	uterine cancer	0
plant zygote	ovary neoplasms	0
pomegranate	deficiency disease	0
decaffeinated tea	motor seizures	0
eragrostis	influenza in human	0
monkfish	early diagnosis of cancer	0
red delicious apples	dermatosis	0
citrus-based fruits	acquired immune deficiency syndrome virus	0
tomato	determination of death	0
bean sprout	menstrual pain	0
caffeinated coffee	ischemia	0
low-sodium diet	tying disease	0
raw broccoli	sterility	0
yam	v-cjd (variant-creutzfeldt-jakob disease)	0
chamomile	bovine lymphosarcomas	0
apple juice	anticancer	0
chili	diabetic polyneuropathies	0
hot peppers	aphthous ulcer	0
honey	colorectal tumor	0
pepsi	chronic fatigue syndrome	0
proteus mirabilis	pituitary dwarfism ii	0
official vitamin	insulin-dependent diabetes mellitus 1	0
taro	olfactory groove meningioma	0
fruit juice	brain disease	0
dietary fiber	premature birth	0
sesame seeds	udp-galactose-4-epimerase deficiency	0
narrow-leaved plantains	blv	0
healthiest fruits	barrett metaplasia	0
cycad	microcephaly	0
rubus fruticosus	cirrhosis	0
cured meat	endometrial neoplasms	0
chili peppers	celiac sprue	0
candy bar	renal neoplasms	0
undercooked meat	spontaneous abortion	0
dried pomegranate	oral cancer	0
sell meat	varix	0
pimiento	cardiovascular disease	0
ready-prepared food	heart block	0
holy basil	migraine headache	0
plantago arenaria	back pain with radiation	0
punicaceae	idiopathic polymyositides	0
black walnut	muscle sorenesses	0
beverage	utp hexose 1 phosphate uridylyltransferase deficiency	0
cooked tomatoes	paroxysmal atrial fibrillation	0
whortleberry	lewy body parkinson's disease	0
specific nuts	emesis	0
unhealthy food	jakob creutzfeldt disease	0
chlorella	deglutitional syncope	0
artificial sweeteners	human herpesvirus 4 (gamma)	0
capsicum annuum	autoimmune diabetes	0
eating eggs	guam form amyotrophic lateral sclerosis	0
garcinia mangostanas	copd	0
include fennel	meningotheliomatous meningiomas	0
rooibos tea	ciguatera fish poisonings	0
offal	gnathostoma infections	0
pumpkin pie	dairy product intolerance	0
areca	bovine lymphosarcoma	0
squashe	wheat hypersensitivity	0
plant-based foods	tumorigenese	0
tulsi tea	lung cancer	0
foeniculum vulgares	intracranial neoplasms	0
cherry plum trees	dizziness	0
frequent meals	ekbom delusory parasitoses	0
medicago sativa	periadenitis mucosa necrotica recurrens	0
jalapeno pepper	viral diseases	0
lemon grasses	premenstrual syndrome	0
bilberry	bacterial vaginoses	0
dried yeast	fibromyalgia	0
foeniculum vulgare	growth hormone receptor defect	0
rise	terminal cancer	0
yerba mate	progressive disorder	0
citrus x paradisi	schizophrenic disorder	0
ananas	bowel disease	0
plantago psyllium	deficiency diseases	0
veal	dizziness	0
rheum	secretory meningiomas	0
crataegus monogyna	amyloid plaques	0
cooked broccoli	primary insomnia	0
dietary proteins	clear cell meningioma	0
pretzel	hair losses	0
breakfast time	intestinal disease	0
dairy products	progressive disorder	0
white potatoes	atherosclerotic plaques	0
dried peas	mouth cancer	0
hemp plants	cervical migraine syndrome	0
bran flakes	gorlin goltz syndrome	0
antioxidant foods	gustatory seizure	0
cultivated radish	amyotrophic lateral sclerosis-parkinsonism-dementia complex 1	0
handling meat	mptp induced experimental parkinsonism	0
areca catechu	neonatal tremor	0
pureed apples	autosomal recessive parkinsonism	0
pistachio	frontal region trauma	0
chocolate pudding	penile neoplasm	0
hickory tree	hypermelanose	0
maize oil	ciguatera fish poisoning	0
worldwide fruit	widespread chronic pain	0
weed	sleep-related neurogenic tachypnea	0
fresh ginger	upper respiratory tract infections	0
chicken meat	male sexual impotence	0
concord grape	amyloid deposit	0
camomile	breast fibrocystic change	0
crab apple	myocardial ischemia	0
carbonated beverage	reticuloendotheliosis viruses	0
sea food	b12 deficiency	0
philadelphia cream cheese	light headedness	0
lens plant	fibrous meningiomas	0
ilex paraguariensis	regional enteritis	0
amomum cardamomum	obesity	0
true nut	chronic daily headaches	0
gravy	early-onset parkinsonism	0
seed	b cell leukemia	0
calendula officinalis	type c oncoviruses	0
coleslaw	chronic daily headache	0
andean blackberries	chronic lymphocytic leukemias	0
frying meat	substance addiction	0
zedoary zedoarias	chronic b-cell leukemias	0
rubus	convulsive syncope	0
ketchup	nerve tremors	0
emphasize plant	intermittent tremor	0
venison	bovine leukemias	0
laciniate nightshade	mixed-cell lymphomas	0
cycad trees	exudative bronchiolitides	0
soya milk	tying disease	0
plant embryo	b-cell leukemia	0
cassia tree	cephalgia syndromes	0
sea vegetable	schizophrenic disorder	0
rutabaga	disk degradations	0
chard	enterocele	0
decaf	diffuse undifferentiated lymphoma	0
laciniate nightshades	multiple head injury	0
salsa	fibrosis	0
soy beans	gerd	0
corn oil	bilateral sciatica	0
corn sugar	decreased cancer	0
maize oils	lung disease	0
include apples	plasmodium infections	0
candy bars	toxic megacolon	0
tangerine trees	auto-immune disease	0
raw meat	prostatic hyperplasia	0
ephedras	drug hypersensitivity	0
oatmeal	udp galactose 4 epimerase deficiency	0
plaice	prediabetic states	0
frozen fruit	galactosemia 3	0
lemon trees	bacterial vaginoses	0
nut butter	galactose 1 phosphate uridyl transferase deficiency disease	0
tea leaves	short sleeper syndrome	0
common olive trees	mptp-induced experimental parkinsonism	0
papaya	male breast cancer	0
anacardium occidentales	foodborne botulisms	0
sour orange trees	neuritic plaques	0
tepary bean	plegia	0
no noni	feline leukemia viruses	0
black teas	secondary insomnia	0
roughage	nonhodgkin lymphoma	0
arachis	blood cancers	0
vitamin pills	feline lymphoma viruses	0
kiwi fruits	esophagus neoplasms	0
cumin	guillaine-barre syndrome	0
phaseolus	disorders of initiating and maintaining sleep	0
papaver somniferum	physical anhedonias	0
black currant	bses (bovine spongiform encephalopathy)	0
greenery	pseudocoma	0
frosting	pleomorphic lymphoma	0
green onions	drop attacks	0
euterpe oleracea mart.s	ekbom delusional parasitosis	0
rubus idaeus	cognitive impairment	0
dog rose berries	gerd	0
anchovy	neurodegenerative disorders	0
taking vitamin	bacteria-eating viruses	0
milkshake	retained surgical instrument	0
no coffee	tonic-clonic seizures	0
concord grapes	lymphoblastic leukemia	0
sweet peppers	polyphagia	0
linseed	premenstrual tension	0
iv vitamin	bovine lymphosarcomas	0
neu5gc-rich food	colitis	0
fatty foods	esophageal neoplasms	0
high-fiber food	carcinoma of endometrium	0
thymus plant	testis cancers	0
poroporo	epithelial cancers	0
sardine	breast carcinoma	0
yeast rice	degenerative neurologic disease	0
international nut	primary brain tumors	0
cocos nucifera	v cjd (variant creutzfeldt jakob disease)	0
jasmine tea	crib death	0
mastic trees	atrioventricular dissociations	0
citrus medicas	cluster headache syndromes	0
solanum dulcamara	ruptured appendicitis	0
assai palm berry	treat cancer	0
whole foods	autosomal recessive juvenile parkinson disease	0
buttermilk	nonorganic insomnia	0
avena sativa	ache	0
herbal teas	clear cell meningioma	0
natural vitamin	ductal carcinoma	0
purine-rich plant	colitis	0
soy food	tonsillar neoplasms	0
amygdalus communis	weight reduction	1
euchresta	intraepithelial prostatic neoplasias	0
solanum melongena	semirhythmic tremor	0
dairy yogurt	massive tremor	0
vinegar	pulmonary cancer	0
pistil	auto-immune diseases	0
chinook salmon	fibromyositis fibromyalgia syndrome	0
licorice	familial dementia	0
low-salt diet	groundnut hypersensitivity	0
antioxidant-rich food	sliding esophageal hernias	0
sesame oil	severe gh insensitivity	0
soy beverage	cognitive impairment	0
domestic fowl	prostatic neoplasms	1
margarine	hypercapnia	0
sweeten	renal insufficiency	0
prunus dulcis	preinvasive carcinoma	0
kidney beans	water-borne hepatitis	0
breakfast cereals	food-borne illnesses	0
raw tomatoes	esophagitis	0
psidium guajavas	bses (bovine spongiform encephalopathy)	0
white pepper	deep vein thromboses	0
oryza sativa	chronic b cell leukemia	0
caryophyllus	chicken embryo lethal orphan virus	0
olive family	human papillomavirus virus	0
breakfast times	multiple myelomas	0
safflower oil	benign meningioma	0
kola nut	chronic infectious mononucleosis like syndrome	0
jelly beans	darkness tremors	0
stevia rebaudiana	urinary tract infection	0
english plantain	non-alcoholic fatty liver disease	0
cannabis sativa	idiopathic polymyositides	0
vaccinium bracteatums	epimerase deficiency galactosemias	0
red onions	multiple head injuries	0
golden raisins	recrudescence	0
filbert	intraepithelial neoplasm	0
chewing fruit	groundnut hypersensitivity	0
olea	acquired immunologic deficiency syndrome	0
kombucha tea	symptom clusters	0
eugenia sandwicensis	nonorganic insomnia	0
portulaca oleracae	ankylosing spondyloarthritis	0
added nuts	retroviridae	0
anticancer plant	ekbom dermatozoic delusions	0
common bean plants	amyotrophic lateral sclerosis parkinsonism dementia complex 1	0
frozen broccoli	thyroid adenoma	0
sparkling waters	arterial dysfunction	0
belladonna	secretory meningioma	0
endive	prostatic cancer	0
irritable bowel kiwi fruit	stokes-adams syncope	0
sugar water	cll lymphoplasmacytoid lymphomas	0
processed food	penile cancers	0
tv dinners	sudden infant death syndrome	0
mesquite	transient insomnia	0
fatty meal	epileptic seizure	0
scallion	penis cancer	0
rosehip	v-cjd (variant-creutzfeldt-jakob disease)	0
areca nuts	dermatozoic delusion	0
gui zhi	rabies	0
prunus domestica	bladder cancer	0
animal food	degenerative diseases	0
white tea	non-hodgkin lymphoma	0
euterpe precatoria	breast pains	0
almond butter	thrombose	0
salt-free diet	mixed small and large cell lymphoma	0
rye bread	memory deficits	0
food supplements	vaginal neoplasms	0
hibiscus cannabinus	constrictive bronchiolitis	0
laudable legume	oxygen deficiencies	0
common plant	burning pain	0
chenopodium quinoas	juvenile parkinsonism	0
antioxidant vitamin	focal seizure	0
bertholletia	degenerative neurologic diseases	0
mangifera indicas	acute coryza	0
molasse	nonalcoholic fatty livers	0
restrict food	gnathostoma infections	0
cookie	lyme arthritis	0
citrus medica	single seizures	0
juglans regia	sunburn	0
sour orange tree	gastro-esophageal reflux	0
dark meat	chronic b cell leukemia	0
sesame oils	thrombose	0