
sugar	chronic fatigue syndromes	0
plantago	milk sugar intolerance	0
tea hibiscus	deaf mutism	0
scallion	auriculo-ventricular dissociations	0
piper methysticum	neoplasm metastasis	0
green grapes	intermittent tremor	0
ready-prepared food	upper respiratory infections	0
vaccinium macrocarpon	necrotizing fasciitides	0
nut butters	chicken viruses	0
antioxidant fruits	sinusitis	0
plant-based nutrients	b-cell leukemia	0
toronja	brain diseases	0
drinking tea	early diagnosis of cancer	0
syzygium aromaticum	preventing cancer	0
licorice	penis cancer	0
pea	manic depressive psychoses	0
pimenta officinali	schizophreniform disorder	0
ultra-processed foods	uterine neoplasms	0
grapefruit juice	cognitive impairments	0
domestic fowl	newborn gynecomastia	0
safflower oils	cancer of the kidney	0
flowering shrub	growth hormone receptor deficiency	0
convenience foods	deficiency disease	0
dioscorea opposita	human mammary carcinoma	0
blossom	leukemogenic viruses	0
atropa belladonnas	canker sore	0
rye	spondyloarthritis ankylopoietica	0
porgy	malignant brain neoplasm	0
lemon balm	pituitary dwarfism iis	0
carya illinoenses	acute infectious polyneuritis	0
yogurt	tonsil cancer	0
citrus hystrix	colonic cancers	1
red tea	reproductive sterility	0
pimenta diocia	pulmonary cancer	0
capsicum annuum	prion protein disease	0
prunus persica	germinoblastic sarcoma	0
mastictree	recurrence	0
soybean	reduced sensations	0
frier	pill rolling tremors	0
cooked broccoli	joint diseases	0
kiwi fruits	stomatognathic disease	0
chili	bladder neoplasms	0
thymus	gnathostoma infection	0
acer saccharum	creutzfeldt jakob syndrome	0
rice	intraepithelial neoplasms	0
dragon fruit	drug habituation	0
cocoanut	venereal warts	0
grilled meat	burkitts lymphoma virus	0
soft drinks	nbcc	0
oat	precordial catch syndrome	0
eugenia cumini	superficial head injuries	0
petroselinum crispums	polyradiculoneuritide	0
philadelphia cream cheese	persistent tremor	0
leafy vegetables	t viruses	0
amlas	lymphadenopathy associated virus	0
healthiest snack	fibrositis	0
avena	uterus cancers	0
almond trees	sleep disorder	0
kiwi fruit	colorectal cancer	0
maize syrup	pregnancy-induced diabetes	0
butter milk	lymphocytic lymphoma	0
prunus armeniaca	urinary tract infections	0
plant capsule	pulmonary neoplasms	1
legume pods	subacute spongiform encephalopathy	0
safflower	substance use disorders	0
ananas	intention tremors	0
mother cells	deep venous thromboses	0
banana	gerd	0
zea	develop cancer	0
tempeh	virus infection	0
liquorice	nontropical sprue	0
poenumgraecum	sclerosis	0
pancake	aids viruses	0
carica	human papilloma virus	0
soy yogurt	udpglucose hexose 1 phosphate uridylyltransferase deficiency	0
lycium chinense	cerebral stroke	0
celeriac	rest tremor	0
licorice root	post-ictal confusion	0
cannabis	skin diseases	0
breakfast cereal	vertebrogenic pain syndromes	0
cider	skin neoplasm	0
lamb chops	neurocysticercose	0
secale cereale	varice	0
cranberry sauce	variant creutzfeldt-jakob disease	0
anti-inflammatory foods	genital wart	0
favorite meals	confusional states	0
eat flax	diabetes-related complications	0
cola nitida	phlebothrombose	0
rheum rhaponticum	saturnine tremors	0
triticum	cysticercose	0
cookie	female subfertility	0
healthiest foods	craniocerebral injuries	0
walnut oil	monocytic leukemia	0
oreo	papillary meningioma	0
sunchoke	anthrax	0
brown rice	neonatal tremors	0
malus domestica	gassers syndrome	0
saint johnswort	parietal region traumas	0
euterpe oleracea mart.s	congestive heart failure	0
sweet basils	chronic lymphatic leukemia	0
cooked meats	pernicious vomiting of pregnancy	0
flaked coconut	polymyositis	0
carbonated beverages	western diseases	0
infant formula	malignant meningioma	0
cucumis melo	preinvasive carcinoma	0
high-fructose corn	persistent tremor	0
dairy eggs	lyme disease	0
table sugar	cataract	0
brewing tea	vaginal neoplasm	0
silybum marianum	extreme hearing loss	0
coriandrum	parkinsonian syndrome	0
vitamin	inflammatory polyneuropathy acutes	0
english plantains	human t lymphotropic virus type iii	0
açaí berries	familial creutzfeldt-jakob disease	0
fructose corn	colorectal tumor	0
snack foods	acute confusional migraine	0
holy basil	proteinuria	0
red rice	breast malignant tumors	0
incorporate cloves	mental disorder	0
prunus salicinas	spiral fractures	0
carthamus tinctorius	amnestic state	0
multivitamin	acquired immunodeficiency syndrome	0
dietary fat	reticulum-cell sarcomas	0
chile pepper	childhood onset obesity	0
food company	bilateral deafness	0
silken tofu	syncopal vertigos	0
cayenne peppers	substance-induced organic mental disorders	0
rooibo	light headedness	0
kola nuts	gehrig disease	0
vegetable oil	upper respiratory infection	0
wild yams	botulism	0
cardamom	convulsive syncopes	0
soft drink	atherosclerose	0
watercress	postoperative nausea and vomiting	0
persea	genital wart	0
billion eggs	bowel diseases	0
pudding	monocular blindness	0
laudable legume	malignant melanomas	0
fruit juices	palsy	0
citrus bergamia	carcinomatose	0
mussel	irritable bowel syndromes	0
dried cranberries	male breast cancer	0
bacon	fusiform aneurysms	0
calendula officinali	hortons syndrome	0
maize oil	renal cancer	0
alfalfa sprout	spiral fractures	0
chili peppers	kanner syndrome	0
sorrel	breast neoplasms	0
official vitamin	brain cysticercosis	0
soy protein	cysticercosis	0
exotic fruits	kidney calculus	0
regular carrots	multiple sclerosis	0
processed meats	generalized headache	0
raw tomatoes	abdominal obesity	0
amomum cardamomums	food-borne diseases	0
turmeric	headache disorder	0
frosting	mastodynia	0
andira	verruca	0
hibiscus tea	itch	0
musa	ulcerative colitis	0
morning meal	primary brain tumor	0
althea officinalis	thermal hypesthesias	0
mackerel	endocrine breast disease	0
alfalfa sprouts	diffuse well differentiated lymphocytic lymphoma	0
sesame oil	juvenile parkinsonisms	0
hibiscus sabdariffa	basal cell carcinoma	0
rose berries	ankylosing spondylarthritides	0
carbonated drinks	burkitts lymphoma virus	0
guava	v-cjd (variant-creutzfeldt-jakob disease)	0
fragaria	endothelial dysfunction	0
pumpkin	catarrh	0
texturized soy protein	substance use disorder	0
dangerous plants	gestational diabetes mellitus	0
morinda citrifolia	postoperative emesis	0
nuclear power plant	utp hexose 1 phosphate uridylyltransferase deficiency disease	0
coconut	basal cell epithelioma	0
juiced broccoli	memory losses	0
nuclear power plants	complete blindness	0
aloe	generalized spasms	0
artichoke	water stress	0
salami	cardiac disease	0
nettle	new variant creutzfeldt-jakob disease	0
soy beverage	familial tremors	0
dairy yogurt	uterine fibromas	0
cucumber	myelomatose	0
sugar water	venous thromboses	0
baptisia	polyarthralgia	0
bertholletia excelsa	colon disease	0
soda pops	sclerosis	0
lunch time	male sub fertility	0
vicia faba	sleeplessness	0
regular olive	intraorbital meningioma	0
vaccinium uliginosum	burkitt herpesvirus	0
cinnamomum trees	reticulolymphosarcoma	0
dress	wheat hypersensitivity	0
corn oil	nanism	0
know nuts	remittent fever	0
apricot tree	small noncleaved-cell lymphoma	0
alpine strawberries	tonsillar neoplasms	0
ground flax	coma	0
glycyrrhiza	cardiovascular diseases	0
tobacco	oral cancers	1
sweetened cereal	migraine headache	0
baby formulas	nafld	0
cream cheese	terminal ileitis	0
lavandula angustifolia	morning sickness	0
candy	breast fibrocystic disease	0
low-sodium diet	cancer of bladder	0
sea-food	vulvar cancer	0
ultra-processed food	hepatitide	0
porphyra	non-epileptic convulsion	0
not-necessarily-so-healthy foods	feline lymphoma virus	0
eugenia jambos	gastric cancer	0
cleistocalyx	human t-lymphotropic virus type iii	0
high-phytate foods	mastalgia	0
fermented cabbage	diabetes complication	0
holy basils	colitide	0
cold-steeping tea	neurodegenerative disorder	0
maguey	myalgic encephalomyelitis	0
neu5gc-rich food	glaucoma	0
allium cepa	human papilloma virus	0
garbanzo	human t-cell lymphotropic virus type iii	0
agaricaceae	degenerative neurologic disorder	0
maple	leprosy	0
radish	lichen planus	0
acer negundo	breast carcinoma	0
syzygium jambos	stomach ulcer	0
pecan tree	spongiform encephalopathies	0
lemon	disk degenerations	0
brain-invasive pork	ph1-negative myeloid leukemia	0
grouper	goiter	0
probiotic	undifferentiated carcinomas	0
alcoholic beverages	oncogenic viruses	0
phytonutrient-rich food	cerebral strokes	0
herr	wart viruses	0
sea vegetable	postviral fatigue syndromes	0
jambolan plum trees	human papillomavirus viruses	0
chewed coca	metabolic acidoses	0
serve	infertility	0
poultry meat	udpglucose hexose-1-phosphate uridylyltransferase deficiency	0
overpriced vitamin	gluten sensitive enteropathy	0
glycine max	radiating pains	0
carduus marianus	polyarthritis	0
beetroot	cancer of the skin	0
strawberry	hyperventilation syncopes	0
mastic trees	udp galactose 4 epimerase deficiency disease	0
steak	lactose malabsorption	0
processed meat	intention tremor	0
unfiltered coffee	mptp-induced experimental parkinsonism	0
breakfast time	necrotizing fasciitides	0
ketchup	weight reductions	0
ready-to-eat meal	sleep initiation dysfunctions	0
decaf	cervical cancer	0
marjoram plant	viral infection	0
prunis communis	idiopathic parkinson disease	0
crataegus monogynas	type 1 diabetes mellitus	0
leaf lettuce	congestive heart failure	0
nutritional yeast	marek's disease virus	0
wine	hiatal hernias	0
soy food	urinary bladder neoplasm	0
chinese cassia	prostate cancers	0
squash seeds	peripheral demyelinating autoimmune disease	0
jerusalem artichokes	single seizure	0
retail poultry	head injury	0
oolong	esophageal reflux	0
bhang	familial guillain-barre syndrome	0
brussel sprout	primary brain neoplasms	0
bean	small-cell lymphoma	0
healthy fruit	asthma	0
pizza	type i diabetes mellitus	0
pepper	menstrual pains	0
pistil	germinoblastic sarcomas	0
pistachio nut trees	malignant lymphomas	0
mentha spicatas	kidney diseases	0
meal time	cancer of bone	0
healthy nuts	painful diabetic neuropathy	0
ground meat	ovarian cancers	0
healthiest apple	lower back pains	0
apium graveolens	bechterew's disease	0
chamomile	car sickness	0
solanum melongena	eczematous dermatitides	0
grecian foxglove	cardiac diseases	0
purple grape	sunburn	0
cassia	atheroma	0
acer negundos	auto-immune diseases	0
nut	fatty liver	0
garlic sauce	bovine spongiform encephalitis	0
steamer	cardiogenic syncopes	0
unfertilized eggs	sneezing	0
dandelion	gum disease	0
tachigalia	breast malignant neoplasm	1
high fructose maize syrup	cognitive impairment	0
holy basil tea	exanthema	0
digitalis	basal cell carcinomas	0
english walnut	arrhythmia	0
recommend tea	lichen ruber planus	0
wort	laron type dwarfism i	0
orange trees	malignant epithelial neoplasms	0
national meat	cognitive dysfunctions	0
herbal teas	carsickness	0
animal-based vitamin	cervical migraine syndromes	0
betel nuts	acute cerebrovascular accident	0
rice milk	atopic disease	0
vaccinium corymbosum	senile paranoid dementia	0
pineapple	gall bladder diseases	0
smoked foods	plasma-cell myelomas	0
beer	numbness	0
black coffee	sharp headaches	0
macadamia	frontal region traumas	0
cinnamomum cassia	muscle spasm	0
carob	social anxiety disorders	0
cinnamomum verum	tussive syncopes	0
seville orange tree	obesity in childhood	0
undercooked meat	papillary meningioma	0
cayenne pepper	renal cancers	0
moose meat	udp galactose 4 epimerase deficiency disease	0
plant kingdom	liver dysfunction	0
oregano	acute inflammatory demyelinating polyneuropathy	0
mock meats	brief reactive psychoses	0
yeast rice	age related macular degeneration	0
frying foods	disk degradations	0
cheese	cerebral stroke	0
chinese yams	lung disorders	0
olive family	diffuse undifferentiated lymphoma	0
myristica fragrans	infectious virus	0
coriandrum sativum	carcinomatose	0
narrow-leaved plantain	cancer of kidney	0
dietary sucrose	coad	0
horsemeat	orthostatic headaches	0
goiaba	respiratory tract cancer	0
rose hips	age related osteoporosis	0
dietary supplement	ductal carcinoma	0
cherry	aura	0
plum trees	situational syncopes	0
common foxglove	generalized seizure	0
bread mold	widespread chronic pains	0
kombucha tea	muscular cramp	0
pistacia vera	memory losses	0
chipotle	menstrual pain	0
different fruits	hepatitis	0
dressing	pill rolling tremors	0
curcuma longa	endometrial cancer	0
ginger	obesity	0
acai berries	blood cancer	0
carrot	lyme arthritis	0
entree	subacute spongiform encephalopathies	0
pie	epileptic seizures	0
no coffee	human t lymphotropic virus type iii	0
texturized soy proteins	germinoblastic sarcomas	0
raphanus raphanistrum	dyslipoproteinemia	0
collard greens	arthrose	0
herbal tea	water borne hepatitis	0
plantago lanceolata	diabetic complications	0
dioscorea polystachya	anal ulcers	0
lactuca sativa	diabetic mononeuropathy simplices	0
red yeast rice	hysterical amnesia	0
mashed potatoes	age-related maculopathy	0
vaccinium ashei	dairy product intolerance	0
roughage	ciguatera fish poisonings	0
food manufacturers	plasmodium infections	0
venison	burkitt herpesvirus	0
trace minerals	brain disorders	0
healthiest beverages	ciliary neuralgias	0
eugenia malaccensis	germinoblastic sarcomas	0
bertholletia	als (amyotrophic lateral sclerosis)	0
whole wheat	female sterility	0
coffee	degenerative intervertebral discs	0
rowanberry	diverticulitis	0
squash plants	testicular cancers	0
golden glow	burning pains	0
psidium guajava	female subfertility	0
saint johns wort	spatial memory disorders	0
citrullus	animal virus	0
black walnuts	postural syncope	0
coco	cvas (cerebrovascular accident)	0
ale	familial tremor	0
eggnog	e-b viruses	0
digitalis purpurea	action tremors	0
fortify milk	rectal tumor	0
incorporates cloves	angiomatous meningiomas	0
flounder	primary brain tumor	0
ficus	drug dependence	0
red delicious apples	amnestic states	0
hop	fibrocystic breast disease	0
cultivated oat	marie-struempell disease	0
eating broccoli	lens opacity	0
cannabis sativas	benign meningiomas	0
soup	perforated appendicitis	0
crab apples	stomach neoplasms	0
ocimum basilicums	darkness tremors	0
solanum lycopersicum	chronic airflow obstruction	0
lycopersicon esculentum	myocardial ischemia	0
acer saccharums	short sleeper syndromes	0
triticum aestivum	galactokinase deficiency diseases	0
caryophyllus aromaticus	salmonellosis	0
breakfast	small cleaved-cell lymphoma	0
glycyrrhiza glabra	breast carcinomas	0
da huang	childhood obesity	0
citrus aurantiifolias	heart failure	0
flaxseed	pulmonary embolisms	0
larder	acquired blindness	0
table salt	anxiety disorders	0
emblica officinali	brain benign neoplasms	0
butternut squash	bechterew disease	0
soy bean	post-ictal confusion	0
acid-binding vegetables	sliding esophageal hernia	0
food coloring	hair loss	0
virgin olive	gustatory seizures	0
olea	chronic obstructive pulmonary disease	0
raw cranberries	spinal meningioma	0
foeniculum vulgare	gale deficiencies	0
pecan trees	experimental parkinson disease	0
peach trees	throat cancer	0
japanese plums	wound botulisms	0
rheum tanguticum	retained surgical needles	0
hemp	ankylosing spondylarthritides	0
justicia	bovine leukosis	0
mandarin orange trees	inherited human transmissible spongiform encephalopathies	0
eating eggs	cancer of the testis	0
soy beverages	amnesia	0
taking vitamin	fibrositis	0
vegetable protein	malignant primary brain tumors	0
dietary protein	oral cancers	0
cymbopogon nardus	chronic b-lymphocytic leukemia	0
saffron crocus	drug hypersensitivity	0
low fruit	ovarian neoplasm	0
linum	breast disease	0
citrus reticulata	hemangioblastic meningioma	0
pumpkin pie	intervertebral disc degeneration	0
low-salt diet	human t cell leukemia virus type iii	0
lens plants	liver diseases	0
artificial sweeteners	hypesthesia	0
fava bean	bovine leukoses	0
cruciferous vegetable	small round-structured viruses	0
english plantain	gustatory seizures	0
yerba mate	somatotropin hypersecretion syndromes (acromegaly)	0
fagopyrum	itch	0
carica papaya	small round-structured viruses	0
eating nuts	uterine fibroid	0
agave	impaired sensations	0
scrambled eggs	plasma cell myeloma	0
melissa officinali	infertility	0
filtered coffee	memory disorder	0
jambolan plum tree	barretts syndrome	0
colocasia	sunburn	0
frozen spinach	testis neoplasms	0
dried apple	cancer of tongue	0
salt-free diet	bacterial infection	0
msg	charcot disease	0
cucumis sativus	lens opacity	0
kawa kawas	benign neoplasms	0
beta vulgari	thyroid carcinomas	0
chlorella	autistic disorder	0
sea vegetables	intention tremor	0
breakfast times	lymphoblastic leukemia	0
ice cream	premenstrual syndromes	0
berry	food borne illnesses	0
drink milk	neoplasm metastasis	0
noncaloric sweetener	benign intracranial hypertension	0
adding blueberries	zoonotic infection	0
black pepper	renal cancer	0
linum usitatissimum	head trauma	0
prunus cerasifera	inflammation	0
syrup	high-grade lymphomas	0
green peppers	nonhodgkins lymphoma	0
high fructose corn syrup	regional ileitides	0
hemp plant	gallbladder disease	0
white tea	lymphoma	0
areca catechu	kanners syndrome	0
diospyro	substance-induced organic mental disorders	0
purine-rich plant	different cancer	0
jelly	child obesity	0
zingiber officinale	mouth cancer	0
bellis	pulmonary thromboembolism	0
processing meat	lymphatic sarcoma	0
chilli pepper	brain conditions	0
indian laburnums	diabetic autonomic neuropathy	0
pease	bovine leukemia	0
gum acacia	cryptogenic epilepsies	0
trace element	temporary amnesia	0
cider vinegar	deep vein thrombosis	0
psyllium	adolescent obesity	0
hashish	bovine lymphoma	0
sweet peppers	mental disorders	0
mentha	nervous system degenerative diseases	0
atropa belladonna	spatial memory disorders	0
soy proteins	mammary dysplasia	0
carbonated drink	posterior fossa meningiomas	0
antioxidant foods	et-nanbh	0
horse beans	abdominal pain	0
chenopodium quinoas	apnea	0
solanum tuberosums	oncogenese	0
food allergies	chronic insomnia	0
chicken meat	lou gehrig disease	0
allium sativum	palsy	0
drinking water	wound botulism	0
brewage	utp-hexose-1-phosphate uridylyltransferase deficiency disease	0
pimiento	malignant melanoma	0
spicy food	galactosemia iii	0
sticker	sudden cardiac death	0
flavourer	nonorganic insomnia	0
soy milk	campylobacter infections	0
low-calorie diet	colorectal neoplasm	0
last meal	memory loss	0
mustard plants	atherogenesis	0
greenery	esophageal neoplasms	0
vegetable juice	varix	0
healthiest nuts	gluten sensitive enteropathy	0
wolfberry	parasagittal meningiomas	0
almond tree	diverticulitis	0
caryophyllus	penile cancers	0
sweetleaf	atherosclerose	0
healthiest beverage	recurrent brain tumors	0
maize oils	reticulum-cell sarcomas	0
celery root	marie-struempell disease	0
chamomile oils	cancer of the breast	0
cacao	parkinsonism	0
coca cola	memory disorder	0
seville orange trees	higher cancer	0
sweet potatoes	long sleeper syndromes	0
apple tree	microcephaly	0
kawa	colonic cancers	0
poppy	fifth phacomatoses	0
popcorn	kahler disease	0
fatty foods	polyarthralgia	0
toxic plants	utp hexose 1 phosphate uridylyltransferase deficiency	0
dog rose berries	schizophrenic disorder	0
pomelo trees	clonic seizure	0
green onions	open head injury	0
sesamum	smell disorders	0
apple trees	deaf-mutism	0
marshmallow	tumorigenese	0
piper methysticums	treat cancer	0
carbonated mineral waters	germinoblastic sarcomas	0
milk chocolate	headache syndrome	0
leek	lobar pneumonia	0
avoid peanuts	fine tremor	0
vaccinium bracteatum	tumor viruses	0
taro	static tremor	0
cocoa powder	tonic seizure	0
fat foods	sphenoid wing meningiomas	0
cucurbita	zoonotic infectious diseases	0
stem vegetables	gale deficiency	0
dinnertime	chronic headaches	0
theobroma cacao	paraosmia	0
dried peas	impaired sensations	0
red onions	macular degeneration	0
pisum sativum	fibrositis	0
bitter orange tree	drug hypersensitivity	0
include flaxseed	diabetic amyotrophies	0
food poisonings	malignant meningioma	0
sweet foods	thyroid neoplasm	0
piper nigrum	widespread chronic pains	0
warm milk	lymphatic sarcomas	0
common foxgloves	kanner syndrome	0
stevia rebaudiana	thyroid cancers	0
areca catechus	udpglucose hexose 1 phosphate uridylyltransferase deficiency	0
cycad	reducing cancer	0
dripping	venous thrombosis	0
carbonated waters	oncogenic viruses	0
olive oils	hepatitis e	0
black sapotes	lower back pain	0
syzygium	udp-galactose-4-epimerase deficiency diseases	0
whale meat	intracranial neoplasm	0
romaine	inflammatory bowel disease 1	0
açai berry	malignant epithelial neoplasm	0
betel	brain diseases	0
tepary beans	colon neoplasms	0
belladonna	primary brain neoplasm	0
fast food	extreme hearing loss	0
poisonous plant	age related macular degeneration	0
indian laburnum	cephalodynia	0
dried food	neurocysticercose	0
plant zygote	hereditary galactokinase deficiency	0
chard	pancreas cancers	0
morinda citrifolias	burkitt herpesvirus	0
cultivated oats	fusiform aneurysm	0
oyster mushroom	degenerative arthritides	0
citrus fruits	joint disease	0
euterpe precatoria	common cancers	0
pistachio nut tree	cranial pains	0
ready soybeans	malignant brain neoplasm	0
assai palm	udp galactose 4 epimerase deficiency	0
catfish	fibroid tumors	0
human milk	myalgic encephalomyelitis	0
olive	short sleeper syndromes	0
fuji apples	coarse tremor	0
star anises	sleep initiation dysfunctions	0
areca nuts	philadelphia-negative myeloid leukemias	0
fig	auricular fibrillation	0
kava kava	cancer viruses	0
narrow leaved plantain	cattle leukemia virus	0
preserved food	intermediate-grade lymphomas	0
brewed coffee	polyarthritis	0
diabetic diet	diabetic mononeuropathies	0
dried plums	galactosemia iii	0
fast foods	pseudocoma	0
amorpha	marie-struempell disease	0
poisonous plants	avitaminose	0
food additives	human papillomavirus virus	0
grapefruit	oncogenic viruses	0
goji berry	tying disease	0
sell meat	idiopathic parkinson disease	0
hot pepper	small-cell lymphomas	0
green beans	common cancers	0
include apples	rodent ulcer	0
sea bilberry	chronic illness	0
worldwide fruit	contusion	0
erythroxylon	macular degeneration	0
intoxicant	diabetic polyneuropathy	0
cola	breast malignant neoplasm	0
zedoary zedoaria	cervicitis	0
yoghurt	lymphoplasmacytoid lymphoma	0
sparkling water	angiomatous meningioma	0
phaseolus	heart attack	0
handling food	transitional meningiomas	0
tea plant	chronic illness	0
plantago arenaria	cataract	0
butter	inflammatory bowel disease 1	0
cilantro	abdominal aortic aneurysm	0
sesame seeds	female sub-fertility	0
tuna fish	bilateral headache	0
emblica officinalis	mammary cancer	0
oyster mushrooms	hypermelanose	0
citrus sinensis	prion-induced disorders	0
find pork	sciatic neuralgia	0
hickory tree	low back pains	0
healthiest vegetable	e-b viruses	0
raw alfalfa	non-b hepatitis enterically-transmitted non-a	0
feather meal	prelingual deafness	0
prunus amygdalus	male sub fertility	0
dried yeast	gastric neoplasm	0
supper	amyloid plaque	0
natural vitamin	non-hodgkins lymphoma	0
cassia fistula	infectious disease	0
horsenettle	intermittent tremors	0
green lentils	liver disease	0
peanut butter	pseudoaphakia	0
capparis	bone neoplasms	0
mangifera indicas	encephalon diseases	0
camomile	inappropriate gh secretion syndrome (acromegaly)	0
mustard	mottled enamels	0
pepsi	variant creutzfeldt jakob disease	0
brussels sprouts	dental plaque	0
poroporo	chronic illnesses	0
prenatal vitamins	head traumas	0
paprika	norwalk-like viruses	0
cocoa butter	granulomatous enteritis	0
nitrate-rich vegetables	mouth neoplasms	0
milk proteins	dna injuries	0
confection	abdominal migraine	0
goji berries	open head injury	0
french fries	huntingtons disease	0
raw foods	pancreatitide	0
little saffron	reticulum-cell sarcomas	0
irritable bowel kiwi fruit	zoonotic infections	0
popular fruits	penile neoplasm	0
prebiotic	coronary disease	0
ribe	classic galactosemia	0
bergamot	manic states	0
triticum vulgare	severe mental disorder	0
english walnuts	ph1-negative myeloid leukemias	0
broccoli raab	fibromyalgia fibromyositis syndrome	0
adhatoda	sleep initiation dysfunctions	0
flax	blindness	0
teff	mental disorders	0
cannabis sativa	pulmonary inflammations	0
fagopyrum esculentum	infantile botulism	0
maple syrup	coma	0
squash	brain cancer	0
garcinia mangostana	effort syncope	0
kidney beans	benign intracranial hypertension	0
cocoa	familial creutzfeldt-jakob diseases	0
hazelnut	cranial pains	0
hickory nut	mammary dysplasia	0
black tea	dental fluorosis	0
honeybush tea	high-grade lymphoma	0
tv dinners	light-headedness	0
proteus mirabilis	retained surgical item	0
kale	non alcoholic fatty liver disease	0
vegetable juices	cognitive dysfunction	1
glucose fructose syrup	granulomatous enteritis	0
eating almonds	migratory pain	0
apple	manic disorders	0
goji berry plants	esophagitis	0
raphanus sativus	occipital region traumas	0
peach tree	galactosemia iii	0
anticancer plant	preterm birth	0
french bean plant	suppuration	0
vaccinium myrtillus	crohn's disease	0
color	jaundice	0
earl grey tea	undifferentiated lymphoma	0
hypericum	pneumonia	0
bt corn	lav-htlv-iii	0
vitis vinifera	human flu	0
box elders	pulmonary embolisms	0
anise	hyperventilation syncopes	0
psidium	guillaine barre syndrome	0
store licorice	premenstrual syndromes	0
betel nut	brain malignant neoplasms	0
carbonated beverage	diarrhea	0
mustard seeds	icterus	0
hypericum perforatums	multiple sclerosis	0
added nuts	poultry viruses	0
saint john's wort	heart disease	0
trigonella	strain	0
crave chocolate	tussive syncope	0
candy bar	parietal region trauma	0
kava kavas	diffuse lymphocytic lymphoma	0
specific foods	royal free disease	0
citrus medica	visual seizure	0
weed	breast malignant neoplasms	0
red lentils	sexual dysfunction	0
star anise	female sub fertility	0
arugula	gastroenteritis	0
ribes nigrum	abdominal migraines	0
seltzer water	vaginitis	0
bran flakes	leukovirus	0
curried tofu	parkinsonism dementia complex of guam amyotrophic lateral sclerosis	0
capsicum	deglutitional syncope	0
ilex paraguarienses	benign neoplasm	1
acaí berries	breast cancers	0
beet	substance induced organic mental disorders	0
frozen cranberries	cerebral convexity meningiomas	0
ganja	degenerative intervertebral disc	0
cruciferous foods	b-cell leukemia	0
contamination meat	cerebral convexity meningioma	0
syzygium cumini	vulvar cancer	0
punicaceae	diabetic mononeuropathy simplices	0
squid	hiatus hernias	0
swordfish	lymphadenopathy-associated viruses	0
pimenta diocias	bipolar disorder	0
potassium-rich foods	neuralgic migraines	0
snacktime	hay fever	0
meal	dyschezia	0
linseed	bovine lymphosarcoma	0
papaya	hiccup	0
hawthorn	ovary cancer	0
white mallows	myeloma-multiple	0
food additive	androgenetic alopecia	0
shan yaos	multiple myelomas	0
bibhitaki fruit	senile plaque	0
citron tree	nerve tremors	0
raisin	lyssa	0
poultry products	common bile duct gall stones	0
big meals	hereditary essential tremor	0
powdered sugar	hemicrania	0
healthier meat	guillaine barre syndrome	0
use sweeteners	generalized headaches	0
leguminosae	intraepithelial neoplasm	0
ice creams	muscle cramps	0
rabbit meat	cerebrovascular accidents	0
seafood	subacute spongiform encephalopathies	0
green teas	colon neoplasms	0
zingiber officinales	malignant tumor of breast	0
java plum tree	rabies viruses	0
organ meats	social anhedonias	0
legume pod	craniocerebral trauma	0
guibourtia	liver steatosis	0
citron trees	essential tremor	0
unrefined plant	intraepithelial neoplasms	0
abelmoschus	male breast enlargement	0
millet	senile paranoid dementias	0
deli meat	phlebothrombosis	0
flavorer	ciguatera	0
tepary bean	stomach ulcer	0
texturized vegetable proteins	water-borne hepatitis	0
raw poultry	spontaneous abortion	0
bilberry	lymphoplasmacytoid lymphoma	0
coriander	substance abuse	0
arachis hypogaea	communicable disease	0
pork	galactosemia 2	0
preserved foods	infant obesity	0
berberis	polyradiculoneuropathy	0
smoked food	respiratory infections	0
cassia fistulas	tumorigenese	0
chinese cinnamon	infantile autism	0
peppermint oil	early-onset parkinsonism	0
antioxidant-rich foods	spinal cord degenerative diseases	0
crocus sativus	amyotrophic lateral sclerosis with dementia	0
chewing fruit	familial creutzfeldt-jakob diseases	0
drinking coffee	virus	0
sea bilberries	hepatic neoplasm	0
prosopi	psoriasis	0
flammulina	zoonotic disease	0
inadequate fruit	nafld	0
anacardium	diabetes complications	0
chai tea	renal insufficiencies	0
fresh fruits	retained surgical instruments	0
allium porrum	schizoaffective disorder	0
sunfish	meningioma	0
prosopis	acne	0
soy foods	pharyngitide	0
black rice	autoimmune disease	0
solanum laciniatum	global amnesia	0
candy bars	vulva neoplasm	0
afzelia	prion disease	0
white potatoes	postviral fatigue syndrome	0
mayo	variant creutzfeldt-jakob disease	0
celebration meal	sarcoma	0
study lavender	pruritis	0
arecas	degenerative intervertebral discs	0
happy meal	megacolon	0
seed	allergy	0
added sweeteners	galactosemia 2s	0
lettuce	right sided heart failure	0
flax seed	deep vein thromboses	0
vitamin pills	inflammatory disease	0
contaminated foods	body weights	0
milk thistle	age related osteoporosis	0
ocimum tenuiflorum	renal cancers	0
split pea	human t lymphotropic virus type iii	0
decrease meat	cancer of the tonsil	0
frozen fruit	basal cell nevus syndrome	0
skim milk	intraventricular meningioma	0
ready-to-eat meals	colonic cancer	0
bok choy	hepatitis	0
purple potatoes	retro ocular headache	0
cooking oil	amyotrophic lateral sclerosis motor neuron disease	0
syzygium sandwicense	continuous tremors	0
plum	ph1-negative myelogenous leukemia	0
sandwich	cough	0
ilex paraguariensis	vertiginous seizure	0
whole grain cereal	cancer-causing viruses	0
dairy products	avitaminosis	0
black currant	gastric acid reflux disease	0
eupatorium rebaudianums	early detection of cancer	0
eugenia caryophyllata	vaginal cancers	0
rheum officinale	insulin sensitivity	0
euterpe edulis	epithelioid sarcoma	0
soy cheese	terminal cancer	0
mirobalanus embilicas	peanut allergies	0
liquor	intractable headache	0
allspice	pruritus	0
morinda	psammomatous meningiomas	0
sea food	different cancer	0
dietary fiber	new variant creutzfeldt-jakob disease	0
machaerium	continuous tremors	0
fagopyrum tataricum	sunburn	0
juglans nigra	intraepithelial prostatic neoplasia	0
eat chocolate	verruca	0
chamomile tea	dizziness	0
pureed apples	gastroesophageal reflux disease	0
breast milks	dwarfism	0
eragrostis	migraine headaches	0
applesauce	diabetic mononeuropathy	0
shoot	senile osteoporosis	0
antioxidant vitamin	genital warts	0
red delicious	monoblastic leukemia	0
nutriceutical	cacosmia	0
melissa officinalis	insulin sensitivity	0
tap water	cervical migraine syndromes	0
paella	deep-vein thrombosis	0
roselle	cerebrovascular apoplexy	0
blueberry	gall bladder disease	0
chinese cinnamons	coad	0
unhealthy food	behavior disorders	0
papaver	mental deteriorations	0
granny smith apples	cardiac failure	0
rubus fruticosus	migraine	0
thousand foods	vertiginous seizures	0
plant embryos	nonorganic insomnia	0
prettiest fruit	heat stroke	0
halibut	common bile duct gallstones	0
olive oil	fibroid uterus	0
vaccinium virgatum	peripheral artery disease	0
horsebean	urinary tract infection	0
handling meat	gorlin syndrome	0
eupatorium rebaudianum	tonsillar cancer	0
antioxidant food	occipital traumas	0
club sodas	necrotizing fasciitides	0
shiitake mushroom	prion protein disease	0
whole grains	venereal warts	0
white mallow	gastro oesophageal reflux	0
cod	vaginitis	0
arginine-rich foods	rectal cancers	0
anacardium occidentales	non b hepatitis epidemic non a	0
rubberplant	severe congenital microcephalies	0
olea europaea	memory disorders	0
origanum onites	pregnancy induced diabetes	0
hummus	brain diseases	0
vinegar	communicable disease	0
eating fruits	human t-lymphotropic virus type iii	0
trigonella foenum-graecum	male breast tumors	0
fenugreek seed	apneas	0
hot sauce	epithelioid sarcomas	0
black sapote	fibromyoma	0
curry	social phobia	0
fennel seeds	chronic pains	0
fiddlehead ferns	preterm birth	0
pummelo tree	alactasia	0
euchresta	chronic pains	0
almond	legal blindness	0
good soybeans	seizure disorders	0
tangerine tree	transient blindness	0
plum tree	cancer of penis	0
common fruits	penile neoplasm	0
corylus	nontropical sprue	0
phaseolus acutifolius	autosomal dominant juvenile parkinson disease	0
anti-inflammatory plant	todd paralysis	0
wild celeries	rheumatoid arthritis	0
soy	generalized spasm	0
althaea	abdominal obesities	0
nightshade	ekbom delusional parasitosis	0
diabetic diets	autoimmune disorders	0
pea families	migratory pain	0
blueberry plant	kidney failure	0
common bean plants	osteoarthrose	0
tree nuts	guillain-barre syndrome	0
black currants	wheat hypersensitivities	0
potato chips	anxiety neuroses	0
sugary foods	encephalopathy	0
thymus vulgari	galactose-1-phosphate uridylyltransferase deficiencies	0
black raspberries	suppuration	0
durum wheats	prostatic neoplasm	1
drink	common bile duct biliary calculi	0
ground beef	urticarias	0
phyllanthus emblicas	cataract	0
own vitamin	amyotrophic lateral sclerosis	0
garlic	insulin-dependent diabetes mellitus 1	0
almond milk	peripheral artery diseases	0
sweeten	chronic diseases	0
sugar-sweetened beverages	juvenile-onset diabetes mellitus	0
barley coffee	comatose	0
phaseolus vulgaris	myocardial infarction	0
marjoram plants	global amnesias	0
purslane	anosmia	0
orange tree	breast malignant tumors	0
brazil nut tree	muscular spasm	0
onion	chronic fatigue disorders	0
lunch times	myelopathy	0
berberi	encephalopathy	0
lycium barbarum	primary growth hormone resistance	0
nonfat meal	testicular neoplasm	0
apricot	enzootic bovine leukoses	0
drink tea	experimental parkinsonism	0
linum usitatissimums	intraorbital meningiomas	0
club soda	sliding esophageal hernias	0
raw food	diffuse small cleaved cell lymphoma	0
hydroponic basil	physical anhedonia	0
california avocado	hyperventilation syncope	0
specific nuts	gorlin goltz syndrome	0
carrot juice	testicular neoplasms	0
suggesting fruit	sleep wake disorder	0
soymilk	postoperative emeses	0
anise seed	breast adenosis	0
avena sativa	intermediate grade lymphoma	0
mirobalanus embilica	adenomatous polyp	0
monosodium glutamate	hemangiopericytic meningioma	0
breakfast cereals	oral neoplasms	0
empty calorie foods	vulvar cancer	0
malabar-nut	gastric cancer	0
plaice	esophageal cancers	0
blueberry plants	open head injuries	0
plant-based foods	small lymphocytic lymphoma	0
amygdalus communis	anaplastic carcinoma	0
pummelo trees	malignant meningiomas	0
portulaca oleracae	alopecia cicatrisata	0
suggesting apple	crushing skull injury	0
solanum dulcamaras	congenital abnormality	0
dried fruit	poultry viruses	0
opium poppy	hyperventilation syncopes	0
veal	human mammary neoplasm	0
bamboo shoots	cancer of esophagus	0
osmanthus	dysmenorrhea	0
eugenia jambolana	polyradiculoneuritis	0
beverage	bovine leukoses	0
sugar substitute	diabetic retinopathies	0
illicium anisatum	insomnia	0
nut butter	convulsive seizures	0
low vitamin	inflammatory bowel disease 1	0
lime	migratory pain	0
energy drink	stroke	0
wheat	eczematous dermatitis	0
durum wheat	premenstrual tension	0
black beans	acute monocytic leukemia	0
dark chocolate	pancreatitis	0
cassia trees	monocular blindness	0
food pyramid	inflammatory bowel diseases	0
mentha x piperita	chronic fatigue syndrome	0
ginger ale	diffuse mixed-cell lymphomas	0
golden raisins	iritide	0
term vegetable	clonic seizures	0
beet greens	reticuloendotheliosis virus	0
pomegranate	hypoesthesia	0
nut bars	semantic memory disorders	0
powdered ginger	non-b hepatitis epidemic non-a	0
plantago psyllium	malaria	0
euterpe oleracea	neurocysticercose	0
fries	smell disorder	0
hordeum	lung cancers	0
cola acuminata	common cold	0
clove	papillary meningioma	0
citrus x paradisi	cancer of the kidney	0
brassica	atopic diseases	0
alcoholic beverage	renal insufficiencies	0
curcuma zedoaria	neonatal tremor	0
thymus plants	aura	0
stevia rebaudianas	rachitis	0
prunus salicina	auricular fibrillations	0
woodland strawberries	pyrosis	0
granny smith	bladder neoplasms	0
margarine	hiccup	0
consumed chocolate	seasickness	0
dessert	pulmonary embolisms	0
collard	fissure in ano	0
curcuma zedoarias	udpglucose hexose-1-phosphate uridylyltransferase deficiency	0
foeniculum	central obesities	0
milk	pregnancy pernicious vomiting	0
big apples	massive tremors	0
animal-based foods	crohn's disease	0
crunch berries	todd paralysis	0
canned fruit	vagina cancers	0
fungus	anticancer	0
zea mays	growth hormone receptor deficiency	0
prunus dulcis	clonic seizure	0
mandarin orange tree	cancer of skin	0
baked potato	experimental parkinson disease	0
illicium anisatums	head trauma	0
willow tree	fetal iodine deficiency disorder	0
parsley	vaginal neoplasms	0
conventional food	foreign bodies	0
indian corn	ulcerative colitis type inflammatory bowel disease	0
bagel	vagina cancer	0
cocos nuciferas	cat leukemia viruses	0
consumer protection scientific committee on food	small cell lymphoma	0
stryphnodendron	degenerative neurologic disease	0
citrus medicas	retained surgical items	0
almond butter	liver dysfunction	0
trompillo	e-b virus	0
plantain	apnea	0
spore	lyme arthritis	0
individual food	pancreatitis	0
fabaceae	serious disease	0
zedoary zedoarias	memory losses	0
nut bar	growth hormone receptor deficiency	0
foie gras	low grade lymphoma	0
juglans regia	cancer of mouth	0
taraxacum officinale	inflammatory bowel disease	0
açaí berry	oral cancers	0
pretzel	flatulence	0
kidney bean	headache disorder	0
hot peppers	uterine neoplasm	0
cassia cinnamon	cancer of vagina	0
cinnamomum zeylanicum	respiratory infections	0
lentinus edodes	heart block	0
red wine	pyorrhea alveolaris	0
raspberry	non b hepatitis epidemic non a	0
navy beans	deaf mutism	0
cabbage	lymphocytic leukemia	0
quinoa	bilateral sciatica	0
banana plants	sleep initiation dysfunctions	0
component spices	cancer of the vagina	0
drug administration united states food	thyroid disease	0
cinnamon	psoriase	0
low-fat diet	soft tissue sarcomas	0
pea family	degenerative arthritis	0
tofu	parkinsonian syndromes	0
raw garlic	insomnia disorder	0
coconut milk	obesity	0
lavandula	penis cancers	0
dietary plant protein	mouth neoplasm	0
jell-o	strain	0
crataegus monogyna	sleep wake disorder	0
longevity legumes	infectious mononucleosis virus	0
isoglucose	vertex headache	0
whipped cream	ciguatera fish poisoning	0
so-called meat	udp galactose 4 epimerase deficiency	0
osmanthus tea	cancer of the thyroid	0
restrict food	dental diseases	0
kaffir lime	fusiform aneurysms	0
vaccinium bracteatums	acute inflammatory polyneuropathy	0
dietary plant proteins	mucous colitis	0
caffeinated coffee	arterial dysfunction	0
include fennel	vaginal discharge	0
chestnut	metastatic cancer	0
yellow vegetables	dissociative amnesias	0
food colors	intractable headache	0
molasses	ductal carcinomas	0
dairy product	minor head injuries	0
specific cheeses	degenerative disease	0
crataegus	juvenile parkinson disease	0
little meat	urinary bladder cancer	0
contaminated meat	burkitt's lymphoma virus	0
organic meat	familial diffuse gastric cancer	0
anchovy	low-grade b-cell malignancy	0
alpine strawberry	heart disease	0
dinner	right sided heart failure	0
mangosteen	post ictal confusion	0
iceberg lettuce	diabetes-related complication	0
algarrobo	anoxemia	0
canned foods	schizophreniform disorder	0
lemon grass	chronic lymphoblastic leukemia	0
convenience food	inflammatory bowel disease	0
aspartame	hysterical blindness	0
mustard greens	prostatic adenoma	0
ground ginger	torsion fractures	0
dog rose	nonalcoholic fatty livers	0
pinto beans	weight losses	0
cicer arietinums	nonhodgkin lymphoma	0
juglan	pruritus	0
faba bean	male sub fertility	0
real chocolate	iritis	0
jalapeno	osteoporosis	0
cherry plum tree	viral hepatitis	0
shiitake	diverticula	0
baking chocolate	cancer of the colon	0
elephant garlic	rectum neoplasm	0
pistachio	somatotropin (acromegaly) hypersecretion syndromes	0
milk thistles	gluten enteropathies	0
macadamia nuts	sharp headaches	0
callerya	human papilloma viruses	0
national pork	sensory seizures	0
ephedra	reticulum-cell sarcoma	0
texturized vegetable protein	amentia	1
cappari	thyroid adenomas	0
group foods	malignant epithelial tumors	0
seltzer waters	pancreas cancer	0
carica papayas	sleep initiation dysfunctions	0
concord grape	bladder neoplasm	0
chewing gum	transitional meningioma	0
coleslaw	primary brain tumor	0
iv vitamin	diabetes mellitus complications	0
hickory trees	manic state	0
baby formula	bilateral headaches	0
muffin	chronic fatigue-fibromyalgia syndrome	0
andropogon nardus	prostatic intraepithelial neoplasm	0
measuring food	neuritic plaques	0
cayenne	severe congenital microcephaly	0
chanterelle	newborn gynecomastia	0
fenugreek	cancer of thyroid	0
buckwheat	age-related memory disorders	0
rosa	migraine disorder	0
cannabi	hemolytic jaundice	0
vital nutrients	constrictive bronchiolitides	0
oregano plant	retro-ocular headaches	0
woodland strawberry	substance abuse	0
trigonella foenum graecum	lobar pneumonia	0
hibiscus	sarcopenia	0
whole grain cereals	complications of diabetes mellitus	0
gravy	primary brain neoplasms	0
broad beans	primary brain tumors	0
melissa	pill rolling tremors	0
elettaria cardamomums	human herpesvirus 4	0
new candy	cardiac disease	0
fatty meal	ankylosing spondyloarthritides	0
aspalathus linearis	male sexual impotence	0
dried fruits	gastro esophageal reflux	0
cuminum cyminum	myocardial infarct	0
aloe vera	diabetic mononeuropathy simplex	0
morel	status migrainosus	0
mango	tumorigenese	0
salad	esophageal cancers	0
guacamole	bipolar affective psychosis	0
tea	delusional parasitoses	0
mint tea	hepatitis	0
arachis	premenstrual tension	0
sushi	myocardial infarctions	0
organic plants	auricular fibrillations	0
soda water	cramp	0
oxen meat	hiccough	0
daucus carota	voice box cancer	0
raphanus	rna tumor virus	0
healthy food	hemicrania migraine	0
citrus reticulatas	intraepithelial prostatic neoplasias	0
citrus aurantium	cardiac dysrhythmia	0
corn syrup	neurodegenerative disease	0
lucerne	prostatic neoplasm	0
soda waters	cancer of thyroid	0
brinjal	infectious virus	0
fake meat	endometrial carcinoma	0
cow's milk	mixed lymphocytic-histiocytic lymphomas	0
frying meat	genital warts	0
flax seeds	virus infection	0
whole grain	abdominal obesities	0
junk foods	mixed lymphomas	0
veggie	ekbom dermatozoic delusion	0
vitis	saccular aneurysm	0
punica granatums	malignant lymphoma	0
topical ginger	urinary bladder diseases	0
gmo soybeans	hemangioblastic meningiomas	0
sugar maples	ulcerative colitis type inflammatory bowel disease	0
pimenta officinalis	small non-cleaved-cell lymphoma	0
plantago seed	gastro-esophageal reflux	0
abelmoschus esculentus	chromosome 6-linked autosomal recessive parkinsonism	0
cocos nucifera	premenstrual tension	0
apple juice	reactive confusion	0
olive tree	spinal cord degenerative diseases	0
red meats	rectal cancer	0
fat milk	heatstroke	0
ovary	viral infection	0
phaseolus vulgari	leukovirus	0
cuminum cyminums	insomnia disorders	0
marihuana	breast fibrocystic changes	0
adhatoda vasica	diabetic autonomic neuropathy	0
pithecolobium	new variant creutzfeldt-jakob disease	0
healthiest fruits	lewy body parkinson disease	0
spearmint	degenerative intervertebral discs	0
jam	fibroadenoma	0
fresh basil	polyradiculoneuritide	0
nettle tea	lung diseases	0
density foods	malignant melanomas	0
coca	protein deficiencies	0
eating food	alcoholism	0
purple cabbage	retained surgical needle	0
justicia adhatoda	pulmonary thromboembolism	0
soya milk	common bile duct gallstones	0
green tea	halitose	0
dried apricots	postpartum sterility	0
bertholletia excelsas	periodontal disease	0
digitalis lanata	somatotropin (acromegaly) hypersecretion syndrome	0
bean sprout	porcine endogenous retroviruses	0
cocktail	feline leukemia virus	0
lemongrass	foreign object	0
chinook salmon	low back aches	0
rye bread	sclerosis	0
pinto bean	fighting cancer	0
punica granatum	necrotizing fascitides	0
split peas	salami brusher's disease	0
syzygium jambolanum	drug abuse	0
tangerine trees	dims (disorders of initiating and maintaining sleep)	0
romaine lettuce	bronchiolitide	0
oryza sativa	avitaminose	0
avenas	dysfunction	0
organic food	vertebrogenic pain syndromes	0
egg	brain cancer	0
amomum cardamomum	paratuberculosis	0
raisin bran	foodborne botulisms	0
low meat	substance abuse	0
lens culinari	germinoblastoma	0
malabar nut	human mammary carcinomas	0
tomato juice	ulcer	0
flavoring	reduced sensations	0
dried blueberries	pregnancy-induced diabetes	0
eating meat	male breast carcinoma	0
chinese cassias	insulin dependent diabetes mellitus	0
cymbopogon	breast neoplasms	0
mentha spicata	olfactory groove meningiomas	0
cassia tree	cancer of the liver	0
sweet orange	horton syndrome	0
thymus plant	deafness	0
dietary fibers	chronic fatigue disorders	0
petroselinum	male breast tumor	0
pistacia	terminal ileitis	0
processed apples	malignant primary brain tumors	0
triticum durum	cva (cerebrovascular accident)	0
brew	olfaction disorder	0
family vegetables	ph1 negative myeloid leukemia	0
beef	variant creutzfeldt-jakob disease	0
safflower oil	cephalgia syndromes	0
wild yam	dysfunction	0
rhubarb	experimental parkinsonisms	0
red meat	familial creutzfeldt jakob disease	0
fermented foods	canker sores	0
citronella	dwarfism	0
cycad trees	autoimmune condition	0
decaffeinated tea	degenerative neurologic diseases	0
sweet almond	bacterial infections	0
indian gooseberries	pattern baldness	0
persea americana	neoplasm metastasis	0
yam	status migrainosus	0
taraxacum	malignant tumor of urinary bladder	0
rubus	ankylosing spondylarthritis	0
food poisoning	stomach neoplasms	0
baby carrots	bovine leukosis	0
cereal	adenosis of breast	0
white meat	kidney disease	0
healthy foods	intraepithelial neoplasms	0
hypericum perforatum	acute inflammatory polyneuropathy	0
healthy snacks	proliferative bronchiolitides	0
tumeric	e b virus	0
seven nutrients	age-related osteoporosis	0
commercial milk	intervertebral disc degenerations	0
portulaca oleracea	rachitis	0
pear	fibromyalgia	0
agent orange	genital warts	0
black walnut	diabetic polyneuropathies	0
mustard plant	manic disorders	0
fava beans	cardiovascular conditions	0
curry powder	skin disease	0
raw broccoli	cancer-causing viruses	0
persea americanas	delusory parasitoses	0
mesquite	sid	0
restructured meat	bone cancer	0
broccoli	focal seizure	0
lemon tree	female sub-fertility	0
lycium	liver injury	0
boiled eggs	pancreatic cancers	0
crocus	sphenoid wing meningiomas	0
cantaloupe	carcinomatosis	0
cereal grains	psychotic disorders	0
elettaria cardamomum	allergic reaction	0
fresh ginger	cerebral convexity meningiomas	0
cooking meat	penis cancer	0
wheat brans	dripped virus	0
pistacia lentiscus	skin neoplasms	0
plant aril	parodontosis	1
plantago indica	determination of death	0
white wine	severe congenital microcephalies	0
mustard oil	acquired immuno-deficiency syndromes	0
jelly beans	lymphadenopathy associated virus	0
brown sugar	stomach cancers	0
japanese plum	skin disease	0
chicken	craniocerebral traumas	0
bell peppers	gastroesophageal reflux disease	0
target vitamin	cancer of the bladder	0
vegetable proteins	male breast neoplasm	0
cupcake	numbness	0
herb	hypertension	0
canned food	convulsive seizure	0
citrus fruit	uterine fibroid	0
anacardium occidentale	age-related macular degeneration	0
sparkling waters	colonic neoplasm	0
tuna	well-differentiated lymphocytic lymphomas	0
health nuts	human cancer	0
collard green	cerebral stroke	0
dried pomegranate	pancreatic neoplasm	0
calling eggs	pneumonia	0
java plum trees	myalgia	0
fed beef	widespread chronic pain	0
silybum marianums	dementia with amyotrophic lateral sclerosis	0
cultivated radish	gnathostoma infection	0
squash plant	auricular fibrillation	0
jalapeno peppers	bacteriophage	0
currant	social anhedonias	0
american meat	foreign objects	0
citrus aurantiifolia	bronchiolitide	0
grape seeds	non-hodgkin lymphoma	0
big food	chronic fatigue-fibromyalgia syndrome	0
nonus	cervix neoplasm	0
mushroom	cll lymphoplasmacytoid lymphomas	0
cranberry juice	osteoarthritide	0
dasheen	laron syndrome	0
burrito	barrett's esophagus	0
diospyros digynas	birth weight	0
wild radish	multiple sclerosis	0
dioscorea	uterine cancers	0
sauerkraut	senile tremors	0
solanum laciniatums	pseudopelade	0
eden foods	cancer of the kidney	0
ocimum basilicum	benign neoplasm	0
wheat bran	prostate cancers	0
uncooked food	cerebrovascular apoplexy	0
kola nut	throbbing headaches	0
pimpinella anisums	autosomal recessive parkinsonism	0
jasmine tea	respiratory tract infection	0
concord grapes	bone neoplasm	0
shan yao	guam disease	0
humulus lupulus	protein deficiencies	0
thyme	tonsillar neoplasms	0
squashe	transitional meningioma	0
turnip	lou gehrig's disease	0
chenopodium quinoa	somatotropin hypersecretion (acromegaly) syndromes	0
colorful foods	painful diabetic neuropathies	0
chocolate	monocular blindness	0
food allergy	uterine cervical neoplasms	0
emphasizes vegetables	leukemia virus	0
curcuma	galactose-1-phosphate uridylyltransferase deficiency	0
gluten	bovine leukemias	0
fruit juice	anxiety disorder	0
citrus grandi	uterine cervical neoplasm	0
brassica nigra	colon disease	0
citrus aurantiums	preventing cancer	0
citrus grandis	prostate neoplasm	0
dinner times	senile tremors	0
carya	abdominal obesities	0
fresh meat	primary growth hormone resistance	0
no meat	coronary heart disease	0
chicken salad	meningioma	0
fagopyrum sagittatum	atopic disease	0
sun-dried raisin	spinal meningiomas	0
extracted fruit	acute monoblastic leukemia	0
carya illinoensis	renal failures	0
green peas	national cancer	0
saccharomyces cerevisiae	johne disease	0
soybean proteins	elevated cholesterols	1
crowberry	transitional meningioma	0
myristica fragran	meningotheliomatous meningioma	0
rooibos	ocular headache	0
noni fruit	terminal ileitis	0
origanum vulgare	migratory pain	0
sweet basil	prostatic neoplasms	0
stevia	body weight	0
snack	lyme arthritis	0
mangifera	rectum neoplasm	0
purple rice	cryptogenic epilepsies	0
fryer	blood cancer	0
drinking orange	sub-fertility	0
trace elements	terminal ileitis	0
avocado	experimental parkinsonism	0
shiitake mushrooms	juvenile parkinson disease	0
horse nettles	neurologic degenerative disease	0
assai palms	sleep-related neurogenic tachypnea	0
mangiferas	esophageal cancers	0
assai palm berry	myocardial infarctions	0
raw meat	premature birth	0
foenumgraecum	autosomal recesssive juvenile parkinsonism	0
deep-fried foods	skin rash	0
citrus limon	gastric neoplasms	0
tarragon	guam disease	0
mentha piperita	tonic seizure	0
majorana hortensis	semantic memory disorder	0
dietary supplements	tactile amnesia	0
aquatic food	groundnut hypersensitivity	0
lima beans	plasmodium infection	0
trace mineral	peanut allergies	0
sesame oils	mania	0
sausage	autosomal recessive juvenile parkinsonism	0
whortleberry	non b hepatitis epidemic non a	0
hibiscus cannabinus	mental deteriorations	0
cicer	bovine spongiform encephalitis	0
lemon balms	brain disorders	0
acer	esophageal cancers	0
cannabis indica	urinary bladder neoplasm	0
soda pop	preinvasive carcinoma	0
horse bean	endometrial neoplasms	0
bread	thrombose	0
sustenance	bilateral sciaticas	0
zucchini	chest pains	0
norovirus food	prostate cancer	0
grape	osteoarthritis	0
alfalfa	semirhythmic tremors	0
macadamia nut	deep vein thrombosis	0
dietary supplementations	atrophy	0
edible grain	pseudocoma	0
humulus	primary insomnia	0
cooked carrots	rupture	0
alcohol	ankylosing spondylarthritis	0
uncooked foods	muscle tenderness	0
kawa kawa	kahler disease	0
french bean plants	disk degenerations	0
citrus paradisi	membranous cataract	0
rheum	royal free disease	0
bell pepper	ph1-negative myelogenous leukemias	0
clathrotropis	feline leukemia virus	0
kohlrabi	familial tremor	0
plant arils	rectum cancer	1
saffron	rest tremor	0
cinnamomum aromaticum	short sleeper syndrome	0
biometal	bovine leukosis	0
sweet marjoram	dyslipidemia	0
nutraceutical	liver dysfunctions	1
cauliflower	amaurosis	0
dietary proteins	retained surgical instrument	0
oolong tea	lymphadenopathy associated virus	0
cacao bean	recurrence	0
salmonella-infected eggs	tumor of rete testis	0
poppy seeds	fibrosis	0
laciniate nightshade	anxiety disorder	0
basil	food-borne diseases	0
vegetarianism	muscle tremors	0
vicia fabas	fatigue	0
malus	craniocerebral trauma	0
marjoram	lichen rubra planus	0
largest meal	somatotropin (acromegaly) hypersecretion syndrome	0
sunflower seeds	chronic fatigue syndromes	0
food supplement	ekbom delusory parasitoses	0
vaccinium angustifolium	gastroenteritide	0
walnut	amnesia	0
avocado fruit	histamine cephalgias	0
pimpinella	parkinsonism dementia complex of guam amyotrophic lateral sclerosis	0
solanum melongenas	testis neoplasm	0
gluten-free diet	cervix cancers	0
rose	amyotrophic lateral sclerosis	0
cured meats	cancer of the tonsil	0
root	heart attack	0
white rice	udpglucose 4-epimerase deficiency disease	0
reason food	gingivitis	0
copaifera	perioral tremor	0
citrus hystrices	androgenic alopecia	0
pithecellobium	persistent tremors	0
illicium verum	brain neoplasms	0
persimmon	new variant creutzfeldt jakob disease	0
dietary soybean proteins	rhabdomyolys	0
health food	acquired immunodeficiency syndrome virus	1
cocoa plants	chronic daily headaches	0
flesh foods	micturition syncopes	0
jalapeno pepper	retained surgical sponges	0
kangaroo meat	cancer of the bone	0
cashew	contagious pustular dermatitis	0
infant formulas	apoplexy	0
solanum tuberosum	galactose-1-phosphate uridylyltransferase deficiencies	0
flower	rectal cancer	0
spice saffron	thyroid adenomas	0
processed foods	brain cancers	0
soy bean curds	myocardial infarctions	0
espresso	dims (disorders of initiating and maintaining sleep)	0
gala apples	symptom clusters	0
citrus bergamias	manic depressive psychosis	0
caper	involutional osteoporosis	0
retail meat	vaginal discharges	0
norus	intraorbital meningioma	0
gooseberry	plasmodium infection	0
fragaria vesca	hepatocellular cancers	1
international nut	diffuse undifferentiated lymphomas	0
deep-fry foods	multiple myositis	0
wild celery	malignant neoplasm of breast	0
poultry product	radiating pains	0
baby spinach	gastric neoplasm	0
acai berry	somatotropin hypersecretion (acromegaly) syndromes	0
pecan	autosomal recessive parkinsonism	0
white pepper	orthostasis	0
treat	congenital myxedema	0
food and drug administration	diffuse small cleaved-cell lymphoma	0
chamomile oil	early onset parkinsonism	0
chocolate bars	gnathostoma infection	0
spice turmeric	craniocerebral injuries	0
ceylon cinnamon	lobar pneumonias	0
energy drinks	catarrh	0
eugenia sandwicensis	head injuries	0
cherry plum trees	intraepithelial prostatic neoplasia	0
foodstuff	uterine neoplasms	0
rubus glaucus	stroke	0
actual fruit	macular degenerations	0
saint john wort	rabies	0
calendula officinalis	age-related bone loss	0
teosinte	mixed-cell lymphomas	0
pimenta	hirsutism	0
coconut oil	age related bone loss	0
pleurotus	insulin deficiency	0
pomegranate seeds	rash	0
frequent meals	germinoblastic sarcoma	0
grape juice	elevated cholesterol	0
sesame	anxiety disorders	0
lemon trees	contagious pustular dermatitides	0
golden delicious	foreign object	0
radicchio	bladder diseases	0
healthy snack	toxico infectious botulism	0
tomato	esophageal neoplasms	0
exotic fruit	oxygen deficiencies	0
octopus	stomatognathic disease	0
cannabis indicas	esophageal hernias	0
daily fruit	rebound insomnia	0
yolk	monocytic leukemia	0
pumpkin seeds	gerd	0
legume family	strains and sprains	0
white bread	diffuse lymphomas	0
milkshake	clear cell meningioma	0
illicium verums	familial tremors	0
rutabaga	polymyositis ossificans	0
cocoa plant	malignant tumor of breast	0
bottled water	hypertension	0
domestic fowls	multiple head injuries	0
cardamon	arthritis	0
common olive trees	cancer of the kidney	0
areca	rna tumor virus	0
vaccinium macrocarpons	increased cancer	0
papaver somniferum	lyssa	0
lemon grasses	bowel disease	0
sugar maple	prostatic cancer	0
fenugreek seeds	alopecia cicatrisatas	0
garcinia mangostanas	atherosclerose	0
daily nut	brains cancer	0
medicago sativa	varicose veins	0
sockeye salmon	kidney insufficiencies	0
dark meat	memory disorder	0
asparagus	inner ear cancer	0
delonix	canker sores	0
foeniculum vulgares	psychotic disorders	0
citrus	e b virus	0
black teas	aphthous stomatitis	0
organic foods	high-grade lymphomas	1
edible grains	sciatica	0
no noni	anal ulcer	0
pine nuts	radiating pains	0
citrus maxima	elevated cholesterol	0
anana	delusional parasitosis	0
dietary fats	galactosemia iiis	0
brassica napus	amyotrophic lateral sclerosis with dementia	0
turkey meat	vertiginous seizure	0
salmonella food	painful diabetic neuropathy	0
plantago ovata	plegia	0
glucose-fructose syrup	parkinsonism dementia complex of guam amyotrophic lateral sclerosis	0
healthier foods	female sub-fertility	0
opium poppies	v cjd (variant creutzfeldt jakob disease)	0
wheatgrass	vaginal cancer	0
soy bean curd	substance addiction	0
food companies	amyloid plaques	0
emphasize plant	spinal meningioma	0
rubus idaeus	crohn disease	0
cucumis melos	gum disease	0
okra	degenerative intervertebral disks	0
hickory nuts	complete hearing loss	0
triticum turgidum subsp. durum	somatotropin hypersecretion syndrome (acromegaly)	0
bitter nightshade	precordial catch	0
cooked meat	uterine leiomyoma	0
horse nettle	tonic-clonic seizures	0
organ	nonalcoholic fatty livers	0
kava	animal virus	0
true nut	disc degenerations	0
cuminum	brain malignant neoplasm	0
maraschino cherry	hemangioblastic meningiomas	0
coriandrum sativums	amentia	0
sweetening agents	atherosclerotic plaque	0
honey	amnesia	0
lavender	birth weight	0
sour orange trees	chronic lymphatic leukemia	0
high-fat meal	ankylosing spondyloarthritis	0
citrus-based fruits	male breast carcinoma	0
stuff	gassers syndrome	0
bolete	human immunodeficiency viruses	0
laciniate nightshades	substance addiction	0
mother cell	memory disorders	0
yerba mates	acquired immuno-deficiency syndrome	0
illicium	dairy product intolerance	0
amla	neurodegenerative disorder	0
crab apple	bovine spongiform encephalopathy	0
portulaca	paratuberculose	0
triticum spelta	chromosome 6 linked autosomal recessive parkinsonism	0
tulsi tea	esophageal reflux	0
dinner time	involutional osteoporosis	0
kiwi	heart attack	0
solanum	sid	0
sprout	endometrial cancer	0
origanum	breast fibrocystic disease	0
soy sauce	vulva cancer	0
kombucha teas	gangrene	0
pineapple juice	age-related macular degenerations	0
sweetening agent	intraepithelial carcinoma	0
lemon balm tea	pleomorphic lymphoma	0
century plants	kidney insufficiencies	0
rooibos tea	human herpesvirus 4 (gamma)	0
eugenia aromatica	breast malignant tumors	0
lipomul	central obesity	0
lens culinaris	relapse	0
plant zygotes	amnesia-memory losses	0
lentil	confusion	0
rosemary	laron syndrome	0
amaranth	age related memory disorders	0
cereal grain	spondylarthritis ankylopoietica	0
ocimum sanctum	oncornavirus	0
floret	bovine lymphosarcoma	0
wild bananas	crohn's disease	0
colophospermum	substance dependence	0
bitter orange trees	age related maculopathies	0
artificial butter	parkinsonism-dementia complex of guam amyotrophic lateral sclerosis	0
nutrient-dense foods	renal calculi	0
coconut water	chronic obstructive pulmonary disease	0
cicer arietinum	fine tremors	0
eragrostus	degenerative arthritis	0
carbonated water	rna tumor virus	0
potable water	endothelial dysfunction	0
fruit and vegetable juices	burkitt herpesvirus	0
foxglove	myocardial ischemia	0
fried foods	cancer of pancreas	0
crabapple	virus diseases	0
high-fiber food	diabetic mononeuropathy simplex	0
chia seeds	drunkenness	0
sour cream	substance-related disorders	0
blackberry	juvenile onset diabetes mellitus	0
gui zhi	cancer of the brain	0
baker's yeast	disorders of initiating and maintaining sleep	0
origanum majorana	fibrous meningioma	0
watermelon	galactose-1-phosphate uridylyltransferase deficiencies	0
spaghetti	hysterical amnesia	0
plant embryo	thyroid neoplasm	0
celery	urinary bladder neoplasms	0
hamburger	penis neoplasms	0
meal times	autosomal recessive juvenile parkinsonism	0
cortland	metabolic acidoses	0
hemp plants	primary brain neoplasm	0
drinking milk	spasm	0
euterpe	infant gynecomastia	0
chile peppers	degenerative intervertebral disk	0
pomelo tree	fibromyositis-fibromyalgia syndrome	0
aspalathus	effort syncope	0
secale	hepatitis e	0
portulaca oleraceas	regional ileitis	0
aubergine	udpglucose 4-epimerase deficiency disease	0
nicotiana tabacums	pseudoaphakia	0
soy cheeses	back aches	0
orange	age-related maculopathies	0
animal food	galactokinase deficiencies	0
frozen broccoli	uterine fibromas	0
chinese rhubarb	lassitude	0
bad foods	bovine lymphosarcoma	0
whole foods	occipital trauma	0
snack food	renal insufficiency	0
oats	ph1 negative myelogenous leukemia	0
oregano plants	hiv	0
pickled foods	hortons syndrome	0
calendula	zoonosis	0
bean sprouts	bone neoplasms	0
food supplementations	epilepsy	0
corn sugar	dysosmia	0
mint	cadaver	0
tomato sauce	non-alcoholic fatty liver disease	0
haritaki fruit	uterine fibroids	0
assai palm berries	tubal abortions	0
olive trees	prostatic hypertrophy	0
experience food	pancreas neoplasms	0
corn	kidney stones	0
turmeric root	gnathostoma infection	0
golden delicious apples	throbbing headache	0
marijuana	brain cancer	0
spinacia oleracea	plasma-cell myeloma	0
solanum dulcamara	ekbom delusional parasitosis	0
spinach	esophageal reflux	0
chervil	skin neoplasm	0
green pepper	cot deaths	0
plant capsules	diabetes complication	0
faba beans	pulmonary embolisms	0
ready-prepared foods	diabetic autonomic neuropathies	0
pickled vegetables	cancer of lung	0
common olive tree	hiccup	0
pleurotus ostreatus	cancer of the testis	0
individual candy	textiloma	0
weekly meat	colonic cancers	0
monitoring food	osteoarthrosis deformans	0
diospyros digyna	post-traumatic osteoporoses	0
barberry	microcystic meningiomas	0
breast milk	tonsillar neoplasms	0
broth	neoplasm	0
organic milk	lyme borreliosis	0
sweet almonds	water stress	0
lemon verbena	cancer of the testes	0
andean blackberries	muscle tenderness	0
cooked tomatoes	chronic cluster headache	0
apium graveolens var. dulce	primary brain tumor	0
zinger tea	bipolar disorder	0
sugar substitutes	joint pain	0
mastic tree	drug use disorder	0
apium graveolens var. rapaceum	small lymphocytic lymphoma	0
garden radish	somatotropin hypersecretion (acromegaly) syndromes	0
milk protein	kanners syndrome	0
placenta	norovirus	0
fennel	icterus	0
cocoa powders	parkinson's disease	0
refined olive	cancer viruses	0
caramel	chronic b lymphocytic leukemia	0
boiled broccoli	hortons syndrome	0
carbonated mineral water	cluster headache syndrome	0
kavas	angioblastic meningioma	0
hemlock	cervix cancer	0
indian gooseberry	central obesities	0
prunus domestica	tactile amnesia	0
hordeum vulgare	age-related maculopathy	0
common bean plant	diffuse mixed small and large cell lymphoma	0
no-calorie sweeteners	acne vulgaris	0
almond oil	aphthae	0
potato	communicable disease	0
dioscorea batatas	age-related maculopathies	0
artificial sweetener	acquired immuno-deficiency syndrome	0
marsh mallows	muscle disease	0
chinese yam	benign neoplasms	0
acacia tree	acute infectious polyneuritis	0
dried foods	small-cell lymphoma	0
rise	weight reduction	1
natto	malignant brain neoplasms	0
roundup-ready soybeans	orthostatic headaches	0
actual licorice	peripheral artery disease	0
sweet pepper	somatosensory seizures	0
roasted almonds	primary brain neoplasms	0
fruit-shaped marshmallows	memory deficit	0
oatmeal	autoimmune diabetes	0
infects apples	epilepsy	0
thymus vulgaris	nonspecific vaginitis	0
poultry	fibromyalgia-fibromyositis syndromes	0
offal	airsickness	0
artificially-flavored corn	dental fluorosis	0
flammulina velutipes	galactokinase deficiencies	0
mangifera indica	multiple sclerosis	0
tea leaves	galactose epimerase deficiencies	0
pasta	sarcopenia	0
ranking foods	amnesia-memory loss	0
nutmeg	weight losses	0
curcuma longas	eczematous dermatitides	0
snail meat	postoperative emeses	0
croaker	memory deficits	0
banana plant	cancer of lung	0
eggplant	vitamin deficiencies	0
reindeer meat	olfaction disorders	0
deli meats	type c oncoviruses	0
petroselinum crispum	prion-induced disorder	0
goji berry plant	tactile amnesia	0
junk food	kidney failure	0
vodka	experimental lung inflammation	0
shellfish	stomach neoplasm	0
triticum turgidum	schizophreniform disorders	0
cynara scolymus	postviral fatigue syndromes	0
anise tea	cerebral stroke	0
higher vegetable	diabetic amyotrophy	0
endive	lead poisonings	0
tisane	physical anhedonia	0
shorten	cervix cancers	0
soy bean proteins	ache	1
cumin	thermal hypesthesias	0
ready prepared foods	micturition syncope	0
different seed	superficial head injuries	0
pomegranate fruit	tumorigenesis	0
chilli peppers	nontropical sprue	0
replenish nutrients	non hodgkin's lymphoma	0
processed food	cancer of the uterine cervix	0
dioscorea villosa	venous thrombosis	0
althaea officinalis	bipolar disorders	0
so-called vegetable	polyradiculoneuritide	0
sweetener	allergic diseases	0
morning meals	pleomorphic lymphomas	0
whiting	hypercapnia	0
cranberry	skin cancer	0
rosehip	sphenoid wing meningioma	0
phyllanthus emblica	autosomal recessive juvenile parkinson disease 2	0
sour orange tree	plasma-cell myeloma	0
psidium guajavas	thyroid cancers	0
neutraceutical	cancer of the testis	0
kenaf	atherosclerosis	0
monkfish	chronic airflow obstruction	0
bitter nightshades	female subfertility	0
salsa	catarrh	0
cured meat	food borne illnesses	0
brazil nuts	peanut hypersensitivity	0
sour fruit	pyorrhea alveolaris	0
wisconsin milk	thyroid cancer	0
four nuts	apneas	0
high-fructose maize syrup	endometrioma	0
elettaria	carcinogenic retroviruses	0
chocolate pudding	congenital abnormalities	0
sardine	acute strokes	0
buttermilk	paraesophageal hiatal hernia	0
red cabbage	malaria	0
chili pepper	kidney calculus	0
maize	sarcoma	0
common plant	common bile duct gall stones	0
miso	visual seizures	0
narrow-leaved plantains	uveitis	0
andean blackberry	drop attacks	0
nori	mixed-cell lymphomas	0
antioxidant-rich food	laron dwarfism	0
usda poultry	malignant brain neoplasm	0
dietary sugars	acromegaly	0
ceratonia	diverticulum	0
marsh mallow	voice box cancer	0
açai berries	hot flashes	0
century plant	parkinson’s disease	0
beta vulgaris	salmonella infections	0
filbert	cancer of the tongue	0
grecian foxgloves	hypersensitivity	0
red peppers	barretts syndrome	0
mealtime	breast malignant neoplasm	1
red pepper	vulvar cancer	0
peanut	pseudopelade	0
nicotiana tabacum	nutritional disease	0
trigonella foenum-graecums	cancer of the ovary	0
chickpea	muscle disease	0
soy beans	cancer of the testis	0
swiss chard	convulsive syncopes	0
peach	familial diffuse gastric cancer	0
oryza	clonic seizures	0
chinese food	diabetes complications	0
poppy seed	cancer of stomach	0
molasse	acute myeloid leukemia	0
food supplements	cancer of the lung	0
apricot trees	arthrosis	0
peppermint	limb cramps	0
dried apples	constrictive bronchiolitides	0
citrus sinenses	breast malignant neoplasm	0
pimpinella anisum	polyarthralgia	0
chewing gums	marek's disease virus	0
toxic plant	schizophrenic disorders	0
orange juice	early awakening	0
corn oils	gustatory seizure	0
ephedras	dementia praecox	0
lunchtime	aneurysm	0
syzygium malaccense	cognitive impairment	0
brassica juncea	neurologic degenerative conditions	0
lens plant	pruritus	0
new vitamin	plegia	0
new york coalition for healthy school food	lyme borreliosis	0
including cloves	colon neoplasm	0
nicotiana	rabies viruses	0
pyrus	prostatic intraepithelial neoplasias	0
barley	hair loss	0
sweet marjorams	protein deficiencies	0
lard	atopic disease	0