
hypericum perforatums	fibroatheromatous plaque	0
cassia fistulas	transmissible dementia	0
fructose corn	ulcerative colitis	0
carduus marianus	testicular cancers	0
cassia fistula	massive tremor	0
origanum onites	virus disease	0
antioxidant food	age related memory disorders	0
measuring food	halitosis	0
cucurbita	pulmonary diseases	0
peach tree	trochanteric fractures	0
pureed apples	hhv-4	0
mangifera indica	hyperemesis gravidarum	0
fig	central nervous system cysticercosis	0
pleurotus ostreatus	ketosis prone diabetes mellitus	0
handling meat	rectal cancers	0
calendula officinalis	syncope	0
four nuts	left-sided heart failure	0
brassica nigra	gastric acid reflux disease	0
white bread	essential tremor	0
energy drinks	pancreas neoplasms	0
bacon	drop attack	0
milk proteins	paroxysmal atrial fibrillations	0
solanum tuberosum	long sleeper syndromes	0
althea officinalis	anticancer	0
carbonated drink	stokes adams syncope	0
secale	posterior fossa meningioma	0
syzygium	ph1-negative myelogenous leukemias	0
areca catechus	polyradiculoneuropathy	0
kawa kawa	peanut hypersensitivity	0
musa	pill rolling tremors	0
individual food	low-grade b-cell malignancy	0
mustard greens	status migrainosus	0
applesauce	diffuse small cleaved-cell lymphoma	0
spaghetti	low backaches	0
jerusalem artichokes	diffuse mixed cell lymphoma	0
sesame oils	atrophy	0
aspalathus	insomnia disorders	0
illicium verums	premenstrual syndromes	0
soybean proteins	mesothelioma	0
daily fruit	atypical chronic myeloid leukemia	0
powdered sugar	mixed lymphocytic histiocytic lymphoma	0
empty calorie foods	syndrome	0
corn oil	ocular headaches	0
cycad trees	congenital myxedema	0
almond tree	orthostatic headaches	0
green beans	low backache	0
almond	hormonal dysfunction	0
canned fruit	senile plaque	0
whole grains	galactose 1 phosphate uridyl transferase deficiency disease	0
muffin	ductal carcinomas	0
vicia fabas	tumor virus	0
convenience foods	textiloma	0
japanese plum	pattern baldness	0
red delicious	todd paralysis	0
baking chocolate	galactosemia 2	0
soft drink	idiopathic polymyositis	0
common bean plant	chronic fatigue syndromes	0
snack foods	prostatic cancer	0
mentha x piperita	occipital traumas	0
thymus vulgari	lewy body parkinson's disease	0
ganja	acquired immuno-deficiency syndrome	0
piper nigrum	long sleeper syndrome	0
meal time	rectal cancer	0
citrus reticulatas	terminal cancer	0
syrup	laron type dwarfism i	0
individual candy	head injuries	0
carica papaya	intermittent tremors	0
safflower	malignant lymphoma	0
cooked meat	recurrent low back pain	0
vaccinium angustifolium	degenerative diseases	0
rice milk	chronic disease	0
okra	cluster headaches	0
dog rose berries	diffuse mixed cell lymphoma	0
sea bilberries	marie-struempell disease	0
poppy seed	pus	0
eggnog	fibrositis	0
chewing gum	pulmonary embolism	0
hordeum vulgare	sleep initiation and maintenance disorders	0
kaffir lime	carsickness	0
pistacia lentiscus	sterility	0
lemon verbena	mastitis	0
include fennel	ovary cancer	0
white mallow	basal cell carcinoma	0
origanum	manic-depressive psychosis	0
chile pepper	amyloidose	0
dried fruit	syndrome	0
phaseolus acutifolius	tonic-clonic seizure	0
use sweeteners	pancreas cancer	0
happy meal	darkness tremors	0
rose	fibrous meningioma	0
lemon balms	age-related macular degenerations	0
wolfberry	variant creutzfeldt-jakob disease	0
vital nutrients	vertiginous seizure	0
celeriac	cancer of ovary	0
white tea	cancer of tongue	0
adhatoda vasica	human t cell leukemia virus type iii	0
fagopyrum	chronic insomnia	0
alcoholic beverage	human mammary neoplasms	1
laciniate nightshades	cancer-causing herpesvirus	0
red peppers	atopic disease	0
frozen spinach	male sub fertility	0
catfish	ulcerative colitis	0
narrow-leaved plantains	coronary diseases	0
ribe	gastric neoplasm	0
venison	juvenile onset diabetes	0
sea bilberry	mammary cancer	0
brown sugar	dairy product intolerance	0
national pork	paraesophageal hernia	0
food additives	memory loss	0
osmanthus tea	familial dementia	0
açaí berry	eczema	0
plant embryos	diabetes complication	0
grape seeds	esophagus neoplasm	0
amomum cardamomum	diabetic autonomic neuropathies	0
shoot	galactosemia 3	0
sesamum	muscle sorenesses	0
swiss chard	primary brain tumors	0
monkfish	rest tremors	0
curcuma	gustatory seizures	0
cannabis indicas	juvenile parkinson disease	0
grapefruit	perioral tremors	0
dog rose	oral cancer	0
dietary protein	rectum cancers	0
eupatorium rebaudianums	hyperventilation syncope	0
contaminated foods	diabetic neuralgias	0
soy bean proteins	inflammatory bowel disease	0
chervil	diffuse myofascial pain syndrome	0
sunflower seeds	fibroid uterus	0
ocimum basilicums	chicken virus	0
eating almonds	unilateral headaches	0
flavorer	vertex headaches	0
drink tea	plasmodium infections	0
solanum melongenas	myalgic encephalomyelitis	0
cranberry	heat stroke	0
sweetener	reticulum-cell sarcomas	0
buckwheat	germinoblastic sarcomas	0
basil	lymphoblastic leukemia	0
dairy eggs	carcinoma in situ	0
roundup-ready soybeans	rhabdomyolys	0
chili peppers	pill rolling tremor	0
poultry	disseminated sclerosis	0
red onions	pharyngitis	0
molasse	autoimmune diabetes	0
juglans nigra	foodborne disease	0
beta vulgaris	nonalcoholic steatohepatitis	0
french fries	membranous cataracts	0
spinach	light headedness	0
canned foods	burkitt lymphoma virus	0
sweetleaf	intermediate grade lymphoma	0
drinking orange	posterior compartment low back pain	0
food colors	heart failure	0
elettaria cardamomums	pediatric obesity	0
broth	thrombus	0
chile peppers	migraine variant	0
low-fat diet	huntington’s disease	0
nutritional yeast	ulcer	0
rheum rhaponticum	memory disorder	0
prenatal vitamins	endometriose	0
beverage	sliding esophageal hernias	0
plant arils	near-death experience	1
orange juice	ductal carcinoma	0
plant zygotes	neoplasm metastases	0
malabar-nut	rest tremor	0
nutriceutical	varicose vein	0
different fruits	prostatic adenoma	0
crab apples	microcephaly	0
emblica officinali	severe gh insensitivity	0
hop	fibroid	0
portulaca oleracae	bladder disease	0
anacardium	chronic fatigue and immune dysfunction syndrome	0
prunus salicina	orthostasis	0
trace element	sliding hiatal hernias	0
red cabbage	anoxia	0
bibhitaki fruit	barrett syndrome	0
thymus	campylobacter infections	0
zedoary zedoaria	hepatitis e	0
gluten-free diet	intervertebral disc degeneration	0
emblica officinalis	insulin-dependent diabetes mellitus 1	0
garlic	migraine headaches	0
origanum vulgare	bacterial infection	0
fava beans	nonalcoholic steatohepatitides	0
weed	allergic reaction	1
food pyramid	nevoid basal cell carcinoma syndrome	0
soy beans	well-differentiated lymphocytic lymphomas	0
saint johnswort	rectal cancer	0
flesh foods	testicular tumors	0
glucose-fructose syrup	delusory parasitosis	0
breast milks	neurocysticercosis	0
tepary beans	diffuse myofascial pain syndrome	0
health food	small noncleaved-cell lymphoma	0
poppy seeds	autistic disorder	0
oolong	oncornavirus	0
animal-based vitamin	blood clots	0
cymbopogon	legal blindness	0
almond milk	venereal wart	0
squid	regional enteritis	0
cardamom	cancer of tonsil	0
caryophyllus	prostatic intraepithelial neoplasm	0
acai berry	persistent tremors	0
favorite meals	dental fluorosis	0
decaffeinated tea	nonhodgkins lymphoma	0
morinda citrifolia	diabetic amyotrophies	0
family vegetables	renal insufficiencies	0
paprika	sliding esophageal hernias	0
zingiber officinales	higher cancer	0
isoglucose	huntington’s disease	0
chewed coca	mucous colitides	0
sweet potatoes	enzootic bovine leukoses	0
pepper	age related memory disorders	0
althaea officinalis	continuous tremor	0
beet greens	symptom cluster	0
sweet marjoram	autosomal recessive juvenile parkinson disease 2	0
arugula	manic depressive psychoses	0
amorpha	sudden onset diabetes mellitus	0
healthiest apple	ruptured appendicitis	0
euterpe precatoria	dehydration	0
english plantains	cough	0
tepary bean	small noncleaved-cell lymphoma	0
plum trees	psychosis	0
berberis	fibromyositis-fibromyalgia syndromes	0
bell pepper	htlv-iii	0
myristica fragrans	diabetes mellitus complication	0
digitalis	tonsil neoplasms	0
black sapote	bipolar affective psychosis	0
cocoa powders	intracranial neoplasms	0
lavandula angustifolia	basal cell epitheliomas	0
sesame oil	darkness tremors	0
celery	kidney disease	0
citrus medicas	acute monoblastic leukemia	0
edible grains	diffuse mixed-cell lymphomas	0
watercress	head traumas	0
avenas	amyloidose	0
indian laburnums	viral hepatitis	0
belladonna	cancer of the mouth	0
bilberry	regional ileitis	0
euterpe	thyroid adenoma	0
vinegar	bacterial infections	0
phaseolus vulgaris	dyslipoproteinemia	0
humulus	mental deterioration	0
algarrobo	utp-hexose-1-phosphate uridylyltransferase deficiency disease	0
incorporates cloves	lyssa	0
pumpkin	low backaches	0
mother cell	iron overload	0
english walnuts	foodborne diseases	0
tuna	reduced sensation	0
specific nuts	regional ileitides	0
sweet basils	viral infection	0
coconut oil	pulmonary thromboembolisms	0
chinese yam	rodent ulcer	0
spore	chronic infectious mononucleosis-like syndrome	0
recommend tea	granulomatous enteritis	0
high-fructose maize syrup	vulvar cancer	0
acer saccharums	nonspecific vaginitis	0
almond trees	social anhedonias	0
plantago seed	thyroid cancers	0
vitis vinifera	age related maculopathy	0
hydroponic basil	tumor	0
canned food	drug allergies	0
cauliflower	ischemic heart disease	0
baptisia	rectum neoplasm	0
poroporo	autosomal dominant. juvenile parkinson disease	0
offal	manic depressive psychoses	0
bad foods	carotid sinus syncope	0
cola acuminata	cranial pains	0
mangiferas	variant creutzfeldt jakob disease	0
bertholletia excelsa	blv	0
citrus aurantiifolia	ciguatera poisonings	0
horse bean	fibrocystic disease of breast	0
jalapeno peppers	lactose intolerance	0
antioxidant foods	schizophreniform disorder	0
tulsi tea	bechterew's disease	0
tomato	head injuries	0
component spices	colorectal carcinomas	0
raphanus raphanistrum	laron dwarfism	0
legume pod	gall bladder diseases	0
organic food	persistent tremors	0
assai palm berries	high grade lymphoma	0
prunus domestica	acute monocytic leukemias	0
amygdalus communis	degenerative neurologic diseases	0
black sapotes	influenza	0
breast milk	exudative bronchiolitides	0
red meat	rectal cancers	0
hickory trees	prion-induced disorders	0
soy bean curds	malignant brain neoplasm	0
melissa	gastric neoplasms	0
pimenta diocias	small non-cleaved-cell lymphoma	0
spearmint	kidney failures	0
white potatoes	chronic daily headaches	0
nettle tea	syncopal episode	0
ocimum sanctum	mild neurocognitive disorder	0
curcuma longas	central nervous system intracranial disorders	0
fragaria	numbness	0
dried food	autoimmune disorders	0
lens culinaris	infectious diseases	0
yellow vegetables	heart decompensation	0
marshmallow	retained surgical needles	0
dietary plant protein	migratory pains	0
citrus paradisi	relapse	0
illicium anisatum	cervicitis	0
hashish	postoperative vomiting	0
banana plant	cancer of bladder	0
cinnamomum cassia	chronic infectious mononucleosis like syndrome	0
smoked food	fibrous meningioma	0
warm milk	tussive syncope	0
chamomile oils	kidney disease	0
milk protein	mental deterioration	0
linum	status migrainosus	0
chicken	stomach ulcer	0
table sugar	lung disorders	0
anise seed	social anxiety disorders	0
soy bean	neurologic degenerative diseases	0
rice	fibromyositis-fibromyalgia syndrome	0
little meat	treat cancer	0
lemon	cirrhosis	0
nightshade	human mammary carcinomas	0
whole grain cereals	postural syncopes	0
pepsi	pyrose	0
fruit juice	smell disorder	0
cod	johne disease	0
curcuma zedoarias	infectious mononucleosis virus	0
whortleberry	hhv-4	0
artificially-flavored corn	cancer of breast	0
butter	delusory parasitosis	0
soy beverage	gastroenteritis	0
ketchup	myalgia	0
potassium-rich foods	orthostasis	0
spice saffron	cancer of endometrium	0
plant aril	diabetes-related complications	0
pimiento	endometrial carcinomas	0
common foxglove	thyroid neoplasm	0
thyme	diabetes mellitus complication	0
tarragon	insomnia disorder	0
prunis communis	urinary tract infections	0
plant embryo	mild neurocognitive disorders	0
chipotle	gastric neoplasm	0
organ meats	diabetic autonomic neuropathies	0
lentil	uterine fibroids	0
acaí berries	hiccup	0
peach	temporary amnesias	0
brazil nut tree	benign neoplasms	0
moose meat	temporal region traumas	0
noni fruit	galactokinase deficiency disease	0
saffron	ankylosing spondylitis	0
drink	basal cell carcinomas	0
mandarin orange tree	infantile autism	0
infects apples	gluten enteropathies	0
texturized vegetable protein	diffuse small cleaved-cell lymphoma	0
processed food	testicular tumors	0
flaxseed	penile cancer	0
citrus hystrices	sudden cardiac arrests	0
fruit and vegetable juices	pulmonary thromboembolisms	0
red yeast rice	age-related macular degeneration	0
persimmon	renal insufficiencies	0
purple grape	chronic cystic mastitis	0
marihuana	benign meningiomas	0
seville orange trees	breast malignant neoplasm	1
citrus grandis	obesity in childhood	0
fortify milk	rectal tumor	0
new vitamin	pernicious vomiting of pregnancy	0
iceberg lettuce	pruritus	0
açai berry	chronic obstructive airway disease	0
milk	brain vascular accident	0
black walnuts	paraesophageal hernia	0
serve	terminal cancer	0
black rice	experimental parkinson diseases	0
dried blueberries	motor seizures	0
salt-free diet	transitional meningioma	0
dangerous plants	diffuse mixed small and large cell lymphoma	0
reason food	joint diseases	0
nonus	cva (cerebrovascular accident)	0
berry	bladder tumors	0
psyllium	pulmonary diseases	0
walnut	intermediate-grade lymphomas	0
dragon fruit	low backache	0
poisonous plants	e-b virus	0
morinda citrifolias	malignant lymphoma	0
clathrotropis	human mammary carcinomas	1
citrus bergamias	bacterial vaginitides	0
fungus	liver injury	0
nicotiana	neuritic plaque	0
leaf lettuce	manic disorders	0
punica granatums	schilling type myeloid leukemia	0
pithecolobium	water borne hepatitis	0
citrus aurantiifolias	cadaver	0
whole grain	papillary meningioma	0
purslane	necrotizing fasciitis	0
table salt	mild neurocognitive disorders	0
collard green	human mammary carcinomas	1
morinda	renal insufficiencies	0
salsa	colicky pain	0
kava kava	cerebrovascular stroke	0
holy basil	periadenitis mucosa necrotica recurrens	0
box elders	cerebrovascular strokes	0
vegetarianism	male sexual impotence	0
white wine	water borne hepatitis	0
marsh mallows	spatial memory disorders	0
lentinus edodes	social anxiety disorders	0
citrus reticulata	mixed-cell lymphomas	0
mustard oil	tussive syncope	0
taraxacum	esophagitis	0
dinner times	galactosemia 2	0
oreo	cluster headache syndrome	0
organic foods	multiple meningioma	0
crab apple	skin rash	0
anchovy	peripheral autoimmune demyelinating disease	0
wild celery	hypermelanose	0
pistacia vera	psoriase	0
sweet pepper	motion sickness	0
antioxidant-rich food	lymphadenopathy-associated viruses	0
healthy snack	polyradiculoneuritis	0
citrus grandi	muscular cramps	0
bitter orange trees	insulin-dependent diabetes mellitus	0
mint	cancer of uterus	0
common olive trees	abdominal pain	0
mint tea	diabetic neuropathies	0
soya milk	foodborne botulism	0
fermented foods	schizophrenia	0
jelly beans	pleomorphic lymphoma	0
morning meal	testicular neoplasm	0
red lentils	anxiety disorder	0
broccoli raab	biliary calculi	0
colorful foods	heart diseases	0
pimenta diocia	ovarian cancer	0
sweet foods	foreign objects	0
nonfat meal	cardiogenic syncope	0
acacia tree	wart viruses	0
garcinia mangostana	short sleeper syndromes	0
theobroma cacao	mixed lymphomas	0
anacardium occidentale	coronary heart disease	0
soy foods	convulsive syncope	0
bellis	vulvar neoplasm	0
high-fat meal	endotoxemia	0
avena	amnesia-memory losses	0
olive oils	polymyositide	0
sea food	acute myeloid leukemia	0
hibiscus cannabinus	periadenitis mucosa necrotica recurrens	0
wild celeries	schizophreniform disorder	0
cabbage	gingivitide	0
skim milk	cluster headaches	0
squash plants	nontropical sprue	0
rubus idaeus	polyp	0
flax	crohn disease	0
soy food	oncogenic virus	0
anana	limb tremors	0
pea families	penis neoplasms	0
weekly meat	galactose-1-phosphate uridylyltransferase deficiencies	0
fruit-shaped marshmallows	stomach ulcers	0
rubus	polyradiculoneuropathy	0
dietary sugars	non epileptic convulsion	0
rheum	meningotheliomatous meningiomas	0
stryphnodendron	non-alcoholic fatty liver disease	0
eugenia sandwicensis	leukemia	0
diospyros digynas	intraventricular meningioma	0
cassia trees	pancreas cancer	0
wild bananas	leucocythemia	0
holy basils	diabetes complications	0
egg	esophageal hernia	0
neu5gc-rich food	uterine cervical neoplasms	0
popular fruits	disorders of initiating and maintaining sleep	0
citrus hystrix	lymphadenopathy-associated virus	0
no meat	constipation	0
glycine max	diffuse lymphocytic lymphoma	0
sugar maple	syncopal episodes	0
currant	influenza in humans	0
scrambled eggs	abdominal pain	0
soy beverages	hypospadia	0
pomegranate seeds	myeloma multiple	0
shorten	rectal tumor	0
whole grain cereal	ileocolitis	0
placenta	central nervous system degenerative diseases	0
anacardium occidentales	massive tremor	0
herbal tea	preventable cancers	0
grouper	pancreatic neoplasm	0
bitter orange tree	tubal abortion	0
wild yams	intention tremor	0
hibiscus	spiral fracture	0
dietary proteins	deep-venous thrombosis	0
fresh ginger	b-cell chronic lymphocytic leukemia	0
pomegranate fruit	plegia	0
toxic plants	sleep disorders	0
cannabis	fatigue	0
fava bean	vulva neoplasm	0
pomelo trees	tonsil cancers	0
colocasia	memory loss	0
barley	ovarian cancers	0
monosodium glutamate	bladder cancer	0
golden raisins	urinary bladder neoplasms	0
sweetened cereal	acquired blindness	0
sugar-sweetened beverages	cephalalgia	0
buttermilk	monocytic leukemia	0
eugenia aromatica	senile osteoporoses	0
citron tree	experimental parkinson disease	0
grapefruit juice	ulcerative colitis type inflammatory bowel disease	0
drug administration united states food	deglutitional syncopes	0
java plum trees	tumor	0
lamb chops	dizziness	0
abelmoschus	brain tumors	0
origanum majorana	ocular headache	0
cantaloupe	esophagitis	0
cashew	endometrioma	0
trigonella foenum-graecums	thermal hypesthesia	0
apium graveolens var. dulce	colicky pains	0
vaccinium myrtillus	peanut allergy	0
coriandrum	atypical cluster headache	0
added nuts	symmetric diabetic proximal motor neuropathy	0
olive oil	kidney failures	0
sweetening agent	hiatus hernia	0
fast food	corpse	0
sweeten	auditory seizures	0
hibiscus tea	rna tumor virus	0
cortland	pulmonary cancer	0
grecian foxgloves	forehead trauma	0
machaerium	posterior fossa meningiomas	0
garlic sauce	social anxiety disorder	0
junk food	cancer of the colon	0
regular carrots	headache disorder	0
gala apples	leukovirus	0
pea family	malignant epithelial neoplasms	0
crowberry	cardiogenic syncopes	0
raisin bran	apneas	0
mangosteen	stomach neoplasms	0
tomato sauce	juvenile parkinsonism	0
flavoring	human t cell leukemia virus type iii	0
mastictree	grave’s disease	0
black tea	wart	1
nutmeg	regional enteritis	0
trace minerals	disrupted in b-cell malignancy	0
porgy	growth hormone receptor defect	0
purple potatoes	halitose	0
citrus	ekbom dermatozoic delusion	0
soy protein	cancer of thyroid	0
sugar	syncopal vertigo	0
stevia	gassers syndrome	0
black teas	leucocythaemia	0
chinese cassias	germinoblastic sarcomas	0
mother cells	reticuloendotheliosis virus	0
mangifera indicas	back pain without radiation	0
chinese rhubarb	micturition syncopes	0
antioxidant-rich foods	manic states	0
sandwich	penis neoplasms	0
ready-prepared food	atrial fibrillations	0
maple	lichen rubra planus	0
cereal grains	motor seizures	0
cacao bean	tonsil cancers	0
replenish nutrients	cjd (creutzfeldt-jakob disease)	0
solanum dulcamaras	human t cell leukemia virus type iii	0
solanum dulcamara	hemorrhage	0
piper methysticums	cryptogenic epilepsies	0
chocolate bars	human t lymphotropic virus type iii	0
ceylon cinnamon	gale deficiencies	0
lime	colorectal tumors	0
raw tomatoes	essential tremors	0
romaine lettuce	bacterial vaginitis	0
mock meats	fibrous meningiomas	0
lycium chinense	premenstrual syndromes	0
mirobalanus embilica	ileocolitis	0
pecan tree	mixed lymphomas	0
new candy	tumorigenesis	0
da huang	brain diseases	0
eden foods	benign brain neoplasm	0
japanese plums	reticuloendotheliosis virus	0
big food	chronic headaches	0
trompillo	mental deterioration	0
alcoholic beverages	halitosis	0
pumpkin seeds	creutzfeldt jacob disease	0
myristica fragran	infectious mononucleosis virus	0
carica papayas	rabies viruses	0
eating eggs	male breast neoplasm	0
healthier meat	obesity in childhood	0
rubus glaucus	frontal region traumas	0
food supplement	suppuration	0
pummelo tree	resting tremors	0
chinese cassia	protein deficiency	0
pimpinella anisums	degenerative intervertebral disks	0
decaf	plasma-cell myeloma	0
cuminum cyminum	sneeze	0
almond oil	creutzfeldt jakob disease	0
group foods	human mammary carcinoma	0
salmonella food	bses (bovine spongiform encephalopathy)	0
herr	male sub-fertility	0
pancake	low backache	0
biometal	hansens disease	0
hibiscus sabdariffa	brain disease	0
curcuma longa	retained surgical tools	0
dried foods	thyroid disorders	0
pleurotus	dims (disorders of initiating and maintaining sleep)	0
prunus amygdalus	uterine neoplasm	0
largest meal	sea sickness	0
faba beans	non-b hepatitis enterically-transmitted non-a	0
soy proteins	food borne illnesses	0
kale	common bile duct gall stones	0
dinnertime	psoriasis	0
high fructose maize syrup	airsickness	0
breakfast cereal	infectious disease	0
include apples	hypermelanosis	0
coca	infectious mononucleosis viruses	0
cupcake	influenza	0
low vitamin	low grade lymphoma	0
drink milk	reticuloendotheliosis virus	0
food manufacturers	sinusitis	0
frying meat	coronary disease	0
trigonella foenum-graecum	thyroid neoplasm	0
pie	emphysema	0
fatty foods	hemorrhage	0
thymus vulgaris	ankylosing spondyloarthritis	0
beetroot	thermal hypesthesias	0
sparkling water	soft tissue sarcoma	0
mashed potatoes	malignant meningioma	0
vaccinium uliginosum	intracranial cns disorder	0
tap water	myelomatosis	0
triticum aestivum	pulmonary embolism	0
dinner time	muscle pain	0
banana plants	persistent tremors	0
avocado	lung inflammation	0
crocus sativus	diabetes mellitus complication	0
greenery	ekbom delusory parasitosis	0
vaccinium ashei	breast tumors	0
pasta	exanthem	0
syzygium jambolanum	amnesia-memory losses	0
fresh basil	infantile botulism	0
chamomile	deep vein thromboses	0
hummus	paralysis	0
woodland strawberries	terminal ileitis	0
miso	tick bite	0
chinese yams	infection	0
handling food	cognitive retention disorder	0
concord grapes	cognitive dysfunctions	1
atropa belladonna	galactose epimerase deficiency	0
exotic fruits	alopecia cicatrisatas	0
seville orange tree	human mammary carcinomas	1
curcuma zedoaria	salmonella infection	0
study lavender	human mammary carcinomas	0
sweet peppers	iritis	0
adding blueberries	pediatric cancers	0
portulaca oleracea	spontaneous abortions	0
olive trees	reticulum cell sarcoma	0
assai palm	vulvar neoplasm	0
brussels sprouts	stroke	0
watermelon	chronic insomnia	0
horsebean	cervical migraine syndrome	0
soy cheese	jakob creutzfeldt syndrome	0
red pepper	colorectal cancers	0
kangaroo meat	burkitt lymphoma virus	0
filtered coffee	age-related bone loss	0
pistachio nut trees	aphthous ulcers	0
dried pomegranate	spindle-cell carcinomas	0
apricot trees	high cholesterol levels	0
adhatoda	gastro-oesophageal reflux	0
lavandula	bovine lymphosarcoma	0
dressing	non b hepatitis epidemic non a	0
raspberry	undifferentiated carcinoma	0
century plants	breast carcinoma	0
unhealthy food	diabetes-related complication	0
soy sauce	ischemia	0
andean blackberry	colorectal tumor	0
pimpinella	right sided heart failure	0
specific foods	progressive disorder	0
ilex paraguarienses	chronic fatigue-fibromyalgia syndrome	0
cynara scolymus	symptom cluster	0
pea	fibromyalgia	0
deep-fry foods	small-cell lymphoma	0
steak	lymphatic sarcoma	0
cinnamomum verum	acute strokes	0
ocimum basilicum	microcystic meningiomas	0
granny smith	stomach ulcers	0
milk chocolate	somatotropin hypersecretion syndrome (acromegaly)	0
tea hibiscus	fissure in ano	0
low-sodium diet	malignant tumor of breast	0
blackberry	gastric acid reflux	0
saccharomyces cerevisiae	severe mental disorders	0
orange	bovine lymphoma	0
food companies	type 1 diabetes mellitus	0
elephant garlic	lung inflammations	0
flowering shrub	leukovirus	0
seafood	malignant primary brain tumors	0
bergamot	manic-depressive psychosis	0
gmo soybeans	histamine cephalgias	0
uncooked food	cervix neoplasms	0
topical ginger	anthrax	0
stuff	type c oncovirus	0
almond butter	degenerative disease	0
lycium	genital wart	0
solanum	renal neoplasms	0
food supplements	cancer of lung	0
dried plums	sleep wake disorders	0
higher vegetable	regional enteritis	0
fruit juices	darkness tremor	0
baby formulas	virus infections	0
cocos nuciferas	protein deficiency	0
flammulina velutipes	gluten enteropathies	0
processed foods	generalized seizure	0
illicium verum	ekbom psychogenic parasitoses	0
bamboo shoots	insulin dependent diabetes mellitus 1	0
eugenia cumini	complications of diabetes mellitus	0
carbonated mineral water	heart failure	0
split peas	pus	0
sweet almond	metabolic acidoses	0
laudable legume	dental diseases	0
sea vegetables	liver cancer	0
maize syrup	renal insufficiency	0
carbonated drinks	basal cell carcinoma	0
high-phytate foods	acute fulminating multiple sclerosis	0
poultry products	esophageal hernias	0
including cloves	lymphoma	0
vitamin	lymphoplasmacytoid lymphoma	0
durum wheat	subtrochanteric fractures	0
soda waters	polyradiculoneuritide	0
cucumber	cluster headache syndrome	0
citrus sinensis	impotence	0
inadequate fruit	pancreatitis	0
no coffee	bipolar affective psychosis	0
arginine-rich foods	cysticercosis	0
licorice	respiratory infections	0
banana	stokes-adams syncopes	0
garden radish	epileptic seizure	0
tv dinners	myelomatose	0
raw poultry	galactose 1 phosphate uridylyltransferase deficiency	0
foeniculum	halitosis	0
avocado fruit	muscle pain	0
olive	tying disease	0
honey	secretory meningioma	0
jalapeno pepper	galactosemia 2	0
cranberry sauce	gehrigs disease	0
bok choy	cysticercosis	0
include flaxseed	intervertebral disc degenerations	0
little saffron	fetal iodine deficiency disorder	0
so-called vegetable	bacterial vaginosis	0
tumeric	burn	0
walnut oil	tongue neoplasm	0
parsley	intermediate-grade lymphoma	0
low fruit	animal virus	0
citrus sinenses	sprue	0
food allergies	chronic b-cell leukemias	0
vegetable oil	colon neoplasm	0
mustard	baldness	0
guava	paraesophageal hernia	0
allium sativum	campylobacter infections	0
hypericum perforatum	guam form of amyotrophic lateral sclerosis	0
regular olive	sinusitis	0
soup	non b hepatitis epidemic non a	0
malus domestica	hansen disease	0
kidney beans	pulmonary neoplasm	0
aspartame	olfaction disorder	0
berberi	acquired immunodeficiency syndrome virus	0
safflower oil	hair loss	0
jambolan plum trees	udp-galactose-4-epimerase deficiency	0
hot sauce	type c oncoviruses	0
rhubarb	clear cell meningioma	0
cocoa plants	tick bites	0
snacktime	feline lymphoma virus	0
soy cheeses	burning pains	0
indian gooseberries	diffuse mixed-cell lymphomas	0
garcinia mangostanas	gehrig disease	0
pimenta officinali	rectum cancer	0
food and drug administration	atherogenesis	0
cannabis sativas	psammomatous meningioma	0
brassica juncea	elevated cholesterol	0
blueberry	posterior fossa meningiomas	0
foodstuff	craniocerebral injury	0
fragaria vesca	uterine fibromas	0
onion	diabetic mononeuropathy	0
chili	generalized seizure	0
cherry plum trees	diverticulosis	0
cooked tomatoes	post traumatic osteoporosis	0
tea leaves	craniocerebral injury	0
solanum lycopersicum	meningotheliomatous meningiomas	0
prunus dulcis	gorlin-goltz syndrome	0
citrus medica	bewilderment	0
silybum marianum	testis neoplasms	0
rubberplant	pyrose	0
rabbit meat	influenza in humans	0
celebration meal	body weights	0
sugar maples	memory losses	0
cocos nucifera	somatotropin (acromegaly) hypersecretion syndromes	0
cycad	hypercapnia	0
brewage	pulmonary inflammations	0
halibut	bovine leukoses	0
wheatgrass	human mammary carcinoma	0
common bean plants	menstrual pain	0
kawa	urticaria	0
lipomul	intraventricular meningiomas	0
goji berry plants	utp hexose 1 phosphate uridylyltransferase deficiency disease	0
lemon grasses	disorientation	0
mandarin orange trees	migraine	0
oryza	carcinogenesis	0
low meat	hernia	0
butter milk	vaginitis	0
broad beans	superficial head injuries	0
good soybeans	occipital region trauma	0
olea europaea	periorbital headaches	0
willow tree	psoriase	0
flax seeds	confusional states	0
oregano	aphthous ulcer	0
plantago lanceolata	phlebothrombose	0
pinto bean	high blood pressure	0
dried apple	urinary tract infection	0
poultry meat	breast cystic disease	0
zedoary zedoarias	rheumatoid spondylitis	0
stem vegetables	mental disorder	0
mentha spicata	chronic gum disease	0
healthiest fruits	prostatitis	0
psidium guajava	seizure disorders	0
cow's milk	foreign bodies	0
vegetable proteins	endometrial neoplasms	0
sour cream	gustatory seizure	0
extracted fruit	complete hearing loss	0
dandelion	cancer of the tongue	0
opium poppy	angioblastic meningiomas	0
zinger tea	impotence	0
bottled water	pulmonary embolisms	0
dioscorea batatas	cancer of the uterine cervix	0
boiled broccoli	premature aging	0
virgin olive	malignant lymphomas	0
calendula officinali	rabies	0
milkshake	neurological condition	0
clove	hypercapnia	0
amlas	ciguatera fish poisonings	0
delonix	blv	0
spinacia oleracea	migratory pain	0
brazil nuts	lead poisoning	0
low-calorie diet	diffuse lymphomas	0
common plant	human mammary neoplasms	0
healthiest foods	et-nanbh	0
aquatic food	monocytic leukemia	0
triticum spelta	leanness	0
processed apples	episodic cluster headache	0
smoked foods	pulmonary disorder	0
mirobalanus embilicas	viral hepatitis	0
celery root	early onset parkinson disease autosomal recessive	0
phytonutrient-rich food	galactokinase deficiency disease	0
quinoa	acute confusional migraine	0
rose berries	secondary fibromyalgias	0
cinnamomum trees	kidney insufficiency	0
beta vulgari	contagious pustular dermatitides	0
brown rice	epileptic seizures	0
raw food	age-related memory disorders	0
margarine	lou gehrig's disease	0
actual licorice	pyrosis	0
navy beans	cough	0
euterpe edulis	weight losses	0
nut	fibrositis	0
suggesting apple	cjd (creutzfeldt jakob disease)	0
caramel	gall bladder diseases	0
acer negundos	cervical migraine syndrome	0
zingiber officinale	foodborne botulism	0
cinnamon	atherosclerotic plaque	0
dioscorea opposita	breast fibrocystic changes	0
acer saccharum	graves disease	0
blossom	gum disease	0
natural vitamin	kidney diseases	0
cleistocalyx	continuous tremor	0
persea americanas	head pains	0
chewing gums	b-cell chronic lymphocytic leukemia	0
agaricaceae	disk degradation	0
vodka	ph1-negative myeloid leukemias	0
betel	wound botulism	0
citrus maxima	lymphocytic lymphomas	0
oolong tea	lav-htlv-iii	0
healthy fruit	gingivitis	0
peanut	dental diseases	0
dairy products	vulva cancers	0
apricot	adolescent gynecomastia	0
junk foods	anal ulcer	0
pistachio nut tree	psychogenic parasitoses	0
digitalis purpurea	mixed lymphocytic-histiocytic lymphomas	0
wheat brans	lumbago	0
yam	non hodgkin lymphoma	0
cooked meats	adenovirus	0
apricot tree	neoplasm metastases	0
whipped cream	dysmenorrhea	0
chickpea	pernicious vomiting of pregnancy	0
lycium barbarum	cattle leukemia virus	0
guacamole	prostatic neoplasms	0
conventional food	growth hormone receptor deficiency	0
ficus	diabetes-related complication	0
shiitake mushrooms	early diagnosis of cancer	0
cruciferous vegetable	joint pains	0
bertholletia excelsas	cancer of pancreas	0
intoxicant	polyradiculoneuritide	0
split pea	orthostatic headache	0
dasheen	brain diseases	0
gui zhi	osteoporosis	0
hemlock	anaplastic carcinoma	0
maize	mixed lymphocytic histiocytic lymphoma	0
red meats	meningioma	0
confection	unilateral headaches	0
java plum tree	bladder neoplasms	0
black currants	skin neoplasm	0
silybum marianums	cognitive impairment	0
low-salt diet	chicken embryo lethal orphan virus	0
macadamia nut	constrictive bronchiolitis	0
horse beans	spontaneous abortion	0
probiotic	auditory seizures	0
dried yeast	undifferentiated carcinoma	0
corn syrup	peripheral arterial diseases	0
phyllanthus emblicas	cryptogenic epilepsies	0
eugenia jambolana	retained surgical sponge	0
betel nuts	excess cancer	0
cola nitida	inflammatory disorder	0
goji berry plant	renal failure	0
pimenta	anal ulcers	0
colophospermum	eye diseases	0
pomelo tree	breast dysplasia	0
mentha	post-ictal confusion	0
ground flax	drug habituation	0
vegetable juices	intracranial cns disorders	0
hickory nut	paratuberculosis	0
no noni	virus diseases	0
tomato juice	uterine leiomyoma	0
ready-to-eat meals	guillaine-barre syndrome	0
molasses	dental plaque	0
cereal	determination of death	0
bran flakes	gastric acid reflux disease	0
prunus cerasifera	familial tremor	0
chinese cinnamons	intracranial cns disorder	0
pizza	substance addiction	0
cherry plum tree	sleep disorders	0
rooibo	varicose vein	0
whole foods	sudden onset diabetes mellitus	0
jam	e-b virus	0
brewed coffee	lobar pneumonias	0
plantain	cervical neoplasms	0
goji berry	fibromyalgia fibromyositis syndrome	0
frying foods	somatotropin hypersecretion syndromes (acromegaly)	0
nettle	visual seizure	0
rosa	diffuse well-differentiated lymphocytic lymphoma	0
lard	small non cleaved cell lymphoma	0
lemon tree	bovine leukemias	0
sea-food	arrythmia	0
justicia	male sub fertility	0
euterpe oleracea	central nervous system intracranial disorders	0
hawthorn	cancer of prostate	0
white pepper	chronic fatigue syndrome	0
yeast rice	convulsion	0
oyster mushroom	kidney stone	0
cumin	fights cancer	0
elettaria cardamomum	abdominal pain	0
oats	back ache	0
açai berries	toxico-infectious botulism	0
cheese	fibrous meningioma	0
chocolate pudding	sick headache	0
actual fruit	somatosensory seizures	0
restructured meat	hyperventilation syncopes	0
dried fruits	stomach neoplasm	0
ephedra	irritable bowel syndromes	0
safflower oils	involuntary quiver	0
club sodas	soft tissue sarcomas	0
soda pops	infantile autism	0
rheum tanguticum	lyme disease	0
ultra-processed foods	developed cancer	0
maize oil	myalgia	0
croaker	precordial catch	0
crave chocolate	skin diseases	0
incorporate cloves	lung cancers	0
teosinte	guillain barre syndrome	0
solanum tuberosums	small lymphocytic lymphoma	0
sour orange tree	lymphadenopathy associated virus	0
hemp plants	fibromyalgia-fibromyositis syndromes	0
cilantro	monocytic leukemia	0
kawa kawas	age-related maculopathies	0
vaccinium macrocarpon	intraventricular meningioma	0
golden delicious	myalgic encephalomyelitis	0
human milk	barretts esophagus	0
domestic fowl	semirhythmic tremor	0
marjoram	autosomal recessive juvenile parkinson disease	0
plum tree	nonalcoholic fatty livers	0
olive tree	chronic headaches	0
sustenance	non-alcoholic fatty liver disease	0
liquor	biliary calculi	0
poenumgraecum	infectious disease	0
turnip	cancer of the esophagus	0
coconut	situational syncopes	0
dress	dental diseases	0
pyrus	pancreas neoplasms	0
emphasize plant	headache syndrome	0
eating nuts	regional ileitis	0
herb	intermediate-grade lymphoma	0
green onions	anal ulcer	0
breakfast time	pediatric obesity	0
areca nuts	familial parkinson disease	0
melissa officinalis	lymphadenopathy associated virus	0
diospyro	long sleeper syndromes	0
feather meal	parkinsons disease	0
goji berries	angioblastic meningiomas	0
artificial sweetener	pancreatic cancers	0
carrot	acute autoimmune neuropathies	0
tangerine tree	head pain	0
lycopersicon esculentum	acute infectious polyneuritis	0
kiwi	central obesities	0
citrullus	low-grade b-cell malignancy	0
kenaf	confusional state	0
target vitamin	ph1-negative myelogenous leukemia	0
chinese cinnamon	growth hormone receptor defect	0
rye	epstein barr virus	0
indian laburnum	colitis gravis	0
digitalis lanata	acquired immuno-deficiency syndrome	0
food allergy	familial dementia	0
mustard seeds	stomach cancer	0
black coffee	cancer of the ovary	0
corn oils	spindle-cell carcinoma	0
alfalfa sprout	porcine endogenous retroviruses	0
cucumis melo	neoplasm metastasis	0
fenugreek	monocular blindness	0
frozen cranberries	auditory seizure	0
ready-to-eat meal	diabetes mellitus complications	0
breakfast times	osteoporosis	0
baby formula	abdominal obesities	0
healthy food	insulin sensitivity	0
cider vinegar	ciguatera	0
triticum	diabetic mononeuropathies	0
arecas	essential tremors	0
cardamon	hypospadia	0
macadamia nuts	foreign object	0
anticancer plant	skin cancers	0
raw meat	ph1-negative myeloid leukemias	0
raisin	cancer of the uterine cervix	0
gluten	cephalgia syndrome	0
foeniculum vulgare	gustatory seizures	0
amla	male pattern alopecia	0
deep-fried foods	different cancer	0
mentha piperita	scurvy	0
pecan trees	amyotrophic lateral sclerosis parkinsonism dementia complex 1	0
wild yam	oxygen deficiencies	0
different seed	early detection of cancer	0
legume family	gestational diabetes	0
sweet basil	wheat allergies	0
philadelphia cream cheese	gnathostoma infection	0
prettiest fruit	inflammatory disease	0
andropogon nardus	age-related memory disorder	0
zea mays	osteoarthrosis deformans	0
lettuce	apnea	0
rosemary	widespread chronic pain	0
potable water	joint diseases	0
purple cabbage	campylobacter infections	0
milk thistle	arrythmia	0
licorice root	degenerative intervertebral disks	0
abelmoschus esculentus	obesity in childhood	0
citrus x paradisi	atrophy	0
cruciferous foods	acute coryza	0
flaked coconut	hypoascorbemia	0
jelly	congenital abnormality	0
durum wheats	germinoblastic sarcoma	0
oryza sativa	acute inflammatory polyradiculoneuropathy	0
healthy foods	oral neoplasms	0
dairy product	pruritis	0
fast foods	open head injuries	0
ginger	ruptured appendicitis	0
citrus fruit	nevoid basal cell carcinoma syndrome	0
fresh meat	fibrocystic breast disease	0
cinnamomum zeylanicum	effort syncope	0
corylus	ph1 negative myeloid leukemia	0
porphyra	gastro-esophageal reflux	0
dietary supplement	cancer of uterus	0
healthiest beverage	genital warts	0
morel	stomach neoplasms	0
nuclear power plants	stokes-adams syncopes	0
club soda	somatosensory seizure	0
tempeh	sid	0
eating broccoli	sick headache	0
cocoa plant	epithelioid sarcoma	0
hemp plant	pruritis	0
acer negundo	bovine leukemia virus	0
retail poultry	social phobias	0
coriandrum sativum	endometrial carcinoma	0
cicer arietinum	uterine fibroma	0
seltzer water	early onset parkinsonism	0
cured meat	anaplastic carcinomas	0
cannabi	reverse cancer	0
octopus	adolescent obesity	0
allium cepa	familial atrial fibrillation	0
sell meat	kanners syndrome	0
american meat	human influenza	0
taking vitamin	foodborne botulisms	0
worldwide fruit	occipital region traumas	0
dark chocolate	malignant epithelial neoplasms	0
pork	vulva cancers	0
areca catechu	cancer of ovary	0
purple rice	degenerative arthritides	0
high fructose corn syrup	kidney insufficiency	0
drinking water	polyradiculoneuritis	0
rooibos	cellulite	0
pineapple	deep vein thromboses	0
sugar substitutes	endometriose	0
plaice	renal insufficiencies	0
yolk	uterine neoplasms	0
longevity legumes	non-b hepatitis epidemic non-a	0
burrito	wheat hypersensitivity	0
maguey	bilateral deafness	0
eugenia malaccensis	delusory parasitoses	0
citrus-based fruits	macular degeneration	0
organic milk	tonsillar cancer	0
bagel	exanthem	0
lima beans	htlv-iii	0
norus	human influenzas	0
chocolate	causes cancers	0
health nuts	head injury	0
linum usitatissimums	insulin deficiency	0
chewing fruit	tumor virus	0
lavender	autosomal recessive parkinsonism	0
store licorice	barretts esophagus	0
flammulina	intracranial cns disorder	0
caffeinated coffee	tumor virus	0
popcorn	aura	0
plantago	fibrocystic changes of breast	0
cicer	colorectal neoplasm	0
ice cream	ileocolitis	0
soymilk	small cell lymphoma	0
espresso	gerd	0
dioscorea villosa	rodent ulcers	0
turkey meat	age-related osteoporoses	0
shiitake	breast cystic disease	0
carbonated waters	stokes-adams syncope	0
texturized vegetable proteins	mixed-cell lymphoma	0
fatty meal	torsion fracture	0
prunus armeniaca	convulsive syncope	0
aspalathus linearis	nausea	0
irritable bowel kiwi fruit	pulmonary thromboembolism	0
juglan	craniocerebral traumas	0
whale meat	t virus	0
chili pepper	human influenza	0
fenugreek seed	transmissible dementia	0
vegetable juice	penis neoplasms	0
kola nuts	bladder neoplasms	0
antioxidant vitamin	hemangioblastic meningioma	0
mustard plant	adenoviridae	0
carob	disc degradations	0
plantago indica	familial tremors	0
foie gras	neurodegenerative disorders	0
sauerkraut	amaurosis	0
rubus fruticosus	prostate disease	0
plant capsule	nbcc	0
emphasizes vegetables	presyncope	0
chai tea	vertiginous seizures	0
kohlrabi	light headedness	0
mackerel	proliferative bronchiolitides	0
breakfast	monoblastic leukemia	0
phaseolus vulgari	tonic seizure	0
lens plant	parkinson disease	0
ground meat	exanthem	0
star anise	inflammatory disease	0
seven nutrients	semirhythmic tremor	0
capsicum annuum	oral cancers	0
chard	penis cancers	0
vitamin pills	peripheral artery diseases	0
chia seeds	massive tremor	0
pickled vegetables	diffuse undifferentiated lymphoma	0
cayenne peppers	malignant tumor of breast	0
ultra-processed food	burkitt herpesvirus	0
carbonated beverage	spiral fractures	0
commercial milk	infant obesity	0
eggplant	hiatus hernia	0
processed meat	ischemic heart disease	0
yogurt	drug allergy	0
lens plants	pituitary dwarfism iis	0
roasted almonds	rectum cancers	0
pineapple juice	familial tremor	0
true nut	milk sugar intolerance	0
shiitake mushroom	melanoma	0
garbanzo	gastroesophageal reflux	0
dietary fiber	male sexual impotence	0
soybean	meningiomatose	0
eugenia jambos	polyphagia	0
ice creams	norwalk like viruses	0
sweet marjorams	national cancer	0
proteus mirabilis	chronic fatigue-fibromyalgia syndrome	0
mesquite	mania	0
rise	back pain	0
so-called meat	aphthous ulcers	0
cultivated radish	male pattern baldness	0
prosopi	marsh fever	0
tofu	oncovirinae	0
brinjal	hemolytic jaundices	0
mentha spicatas	rete testis tumor	0
peanut butter	gestational diabetes	0
marijuana	leukemia virus	0
glucose fructose syrup	progressive disorder	0
pithecellobium	radiating pain	0
green tea	legal blindness	0
density foods	palmoplantaris pustulosis	0
indian corn	polyarthritis	0
collard	dairy product intolerance	0
eugenia caryophyllata	autistic disorders	0
maple syrup	todd paralysis	0
chilli pepper	myelopathy	0
leguminosae	cervix neoplasms	0
guibourtia	age related maculopathy	0
sparkling waters	diabetes-related complication	0
romaine	breast pain	0
syzygium cumini	bovine spongiform encephalopathy	0
plantago arenaria	pruritus	0
lucerne	zoonotic diseases	0
own vitamin	cancer of the testes	0
diabetic diets	insulin dependent diabetes mellitus	0
triticum turgidum subsp. durum	manic state	0
cannabis indica	neurologic degenerative disease	0
calling eggs	igf-1 deficiency	0
lemon trees	cancer of thyroid	0
sockeye salmon	basal cell epithelioma	0
cookie	rectal tumor	0
amaranth	hypermelanosis	0
capparis	vestibular seizure	0
apple	iron deficiency	0
areca	cancer of the vagina	0
millet	hemolytic uremic syndrome	0
healthiest snack	idiopathic intracranial hypertension	0
kiwi fruit	oncornavirus	0
nuclear power plant	intracranial central nervous system disorders	0
chicken meat	pleomorphic lymphoma	1
pimpinella anisum	central nervous system degenerative diseases	0
beet	chronic obstructive lung disease	0
sticker	dyslipoproteinemia	0
entree	atrophy	0
steamer	heart decompensation	0
narrow-leaved plantain	palsy	0
green teas	different cancer	0
kavas	basal cell carcinomas	0
carica	breast malignant neoplasms	0
dried peas	neoplasm metastases	0
sugar substitute	juvenile parkinsonism	0
saint john's wort	spindle cell sarcomas	0
blueberry plant	microcystic meningiomas	0
eating food	autoimmune diabetes	0
ground ginger	fibromyoma	0
usda poultry	type c oncoviruses	0
kola nut	rabies	0
hot pepper	galactokinase deficiency	0
wheat bran	vaginal neoplasm	0
thymus plants	reduced sensations	0
nitrate-rich vegetables	cancer of the vulva	0
food additive	microcephaly	0
jalapeno	arterial fatty streak	0
golden glow	vestibular seizure	0
chilli peppers	tussive syncopes	0
animal-based foods	human papilloma viruses	0
noncaloric sweetener	polyp	0
treat	chronic fatigue disorders	0
cocoanut	burkitt's lymphoma virus	0
goiaba	familial dementias	0
trigonella	limb tremor	0
poisonous plant	epithelial cancers	0
potato chips	cancer of kidney	0
soy milk	iddm	0
infant formulas	unilateral headaches	0
asparagus	stomach ulcers	0
brain-invasive pork	t virus	0
nori	deaf mutism	0
rose hips	diabetic amyotrophies	0
sour fruit	multiple meningioma	0
vicia faba	familial atrial fibrillation	0
larder	acute confusional migraine	0
spicy food	animal virus	0
food supplementations	atopic disease	0
edible grain	manic states	0
tangerine trees	dims (disorders of initiating and maintaining sleep)	0
sour orange trees	rectum neoplasm	0
persea	alzheimer’s disease	0
healthy snacks	familial atrial fibrillations	0
green peas	male pattern baldness	0
ananas	epstein-barr virus	0
tea	cysticercose	0
cultivated oat	hypoxemia	0
big apples	dizzyness	0
pease	carotid sinus syncopes	0
century plant	schizoaffective disorder	0
dietary sucrose	familial tremor	0
specific cheeses	pustulosis palmaris et plantaris	0
organ	bipolar affective psychoses	0
justicia adhatoda	hypercholesterolemia	0
caper	small-cell lymphomas	0
taraxacum officinale	myeloma-multiple	0
cassia cinnamon	pulmonary neoplasm	0
malabar nut	parietal region trauma	0
shan yao	myalgia	0
papaver	myocardial infarctions	0
food company	renal insufficiencies	0
shan yaos	stomach neoplasm	0
crataegus monogynas	rete testis tumor	0
texturized soy protein	non alcoholic fatty liver disease	0
cocoa powder	fibroid tumor	0
beef	nausea	0
persea americana	nonalcoholic fatty liver disease	0
bt corn	familial tremors	0
sea vegetable	peripheral autoimmune demyelinating disease	0
oregano plant	stomach cancers	0
rutabaga	peanut hypersensitivity	0
suggesting fruit	postpartum sterility	0
soda pop	chronic cluster headache	0
healthy nuts	galk deficiency	0
citrus aurantiums	prion protein disease	0
andira	meningiomatose	0
thymus plant	oral cancer	0
dioscorea	ductal carcinomas	0
anti-inflammatory plant	eczema	0
alfalfa	respiratory infections	0
syzygium sandwicense	familial guillain-barre syndrome	0
tachigalia	intestinal diseases	0
malus	long sleeper syndrome	0
no-calorie sweeteners	cancer of the kidney	0
term vegetable	bipolar depression	0
petroselinum crispum	spinal cord disease	0
french bean plant	variant creutzfeldt-jakob disease	0
sunfish	uterine cervical neoplasm	0
nut bars	age related maculopathy	0
barberry	hypertension	0
alpine strawberries	spondylarthritis ankylopoietica	0
national meat	left sided heart failure	0
morning meals	subacute spongiform encephalopathies	0
fermented cabbage	pancreas neoplasms	0
diabetic diet	diffuse undifferentiated lymphomas	0
linseed	varice	0
pistachio	lower back pain	0
opium poppies	diabetic neuropathies	0
coleslaw	vagina cancers	0
oat	cow disease	0
cranberry juice	iritide	0
coriandrum sativums	cancer of the penis	0
neutraceutical	nonalcoholic fatty liver disease	0
chestnut	endometriosis	0
flavourer	mechanical low back pain	0
olea	burkitt lymphoma virus	0
healthiest vegetable	suppuration	0
portulaca	persistent atrial fibrillations	0
sesame seeds	recrudescence	0
syzygium aromaticum	massive tremors	0
pomegranate	congenital hypothyroidism	0
nutraceutical	metabolic acidoses	1
silken tofu	central nervous system degenerative diseases	0
common olive tree	hiatus hernias	0
althaea	faint	0
crataegus monogyna	lyme disease	0
brewing tea	dysfunction	0
horsenettle	experimental parkinsonism	0
snack	schizophrenic disorder	0
kidney bean	inflammatory demyelinating polyneuropathy	0
grape	benign intracranial hypertension	0
apium graveolens var. rapaceum	lymphosarcoma	0
stevia rebaudianas	tonsillar cancers	0
syzygium jambos	alcoholism	0
juglans regia	unilateral headaches	0
cannabis sativa	sprain	0
cream cheese	iritis	0
consumer protection scientific committee on food	brain disorder	0
agave	cancer of the rectum	0
ribes nigrum	atrophy	0
dietary fat	diverticulitide	0
peppermint	intention tremor	0
zea	polymyositis ossificans	0
whiting	lymphocytic leukemia	0
meal	gluten enteropathies	0
domestic fowls	oral cancers	0
dried apples	psychotic disorder	0
ale	childhood onset obesity	0
soy	goiter	0
grilled meat	myocardial ischemias	0
fabaceae	experimental parkinsonisms	0
petroselinum	neurodegenerative disorder	0
food coloring	deep-venous thrombosis	0
veal	male breast cancer	0
root	paraesophageal hiatal hernias	0
consumed chocolate	ovarian neoplasms	0
squashe	allergic diseases	0
squash	type c oncovirus	0
tisane	massive tremor	0
common fruits	autoimmune disease	0
turmeric root	parkinsonian disorders	0
red rice	gallstone	0
cucumis melos	male subfertility	0
macadamia	galactokinase deficiencies	0
maraschino cherry	neuritic plaque	0
bhang	disk degeneration	0
seltzer waters	carcinoma of endometrium	0
paella	atherosclerose	0
alfalfa sprouts	delusory parasitosis	0
callerya	drop attacks	0
jell-o	inappropriate gh secretion syndrome (acromegaly)	0
decrease meat	communicable disease	0
aubergine	e-b virus	0
plant kingdom	cat leukemia viruses	0
corn sugar	malignant brain neoplasms	0
illicium	gastro-oesophageal reflux	0
dried apricots	dysosmia	0
pear	developed cancer	0
calendula	amyloid deposits	0
linum usitatissimum	hemicrania migraines	0
fed beef	testicular tumors	0
dietary plant proteins	todd paralysis	0
brew	galactose-1-phosphate uridyl-transferase deficiency disease	0
overpriced vitamin	prostatic intraepithelial neoplasia	0
find pork	heart decompensation	0
fryer	drug allergies	0
eating fruits	infertility	0
dietary fats	venous thrombosis	0
psidium guajavas	zoonotic infection	0
fiddlehead ferns	peripheral arterial diseases	0
raw garlic	spongiform encephalopathies	0
anise	psychogenic parasitosis	0
nicotiana tabacums	thyroid diseases	0
crocus	varicose veins	0
organic plants	royal free disease	0
roughage	mixed small and large cell lymphoma	0
cacao	transitional meningiomas	0
mayo	uterine cancers	0
cuminum cyminums	endometrial neoplasm	0
baby spinach	allergy	0
cultivated oats	ocular headaches	0
glycyrrhiza glabra	cow disease	0
petroselinum crispums	cancer of cervix	0
acid-binding vegetables	cancer of skin	0
capsicum	familial dementias	0
red tea	hemangioblastic meningioma	0
copaifera	heart failure	0
tree nuts	nanism	0
green grapes	chicken virus	0
natto	small cleaved cell lymphoma	0
kombucha teas	thyroid neoplasms	0
rye bread	oncogenic virus	0
mango	cat leukemia viruses	0
white rice	tonsil neoplasm	0
carrot juice	cognitive impairment	0
prosopis	aphthous ulcer	0
camomile	pustulosis palmaris et plantaris	0
pisum sativum	diffuse mixed cell lymphoma	0
leek	gastric cancers	0
plant zygote	urticaria	0
high-fiber food	fibrosis	0
pudding	wheat allergy	0
daucus carota	hypercapnia	0
rosehip	cancer of the breast	0
artichoke	paludism	0
apple juice	burning pains	0
carya illinoensis	complete hearing loss	0
food poisoning	guam form of amyotrophic lateral sclerosis	0
phyllanthus emblica	leucocythemia	0
hot peppers	gastric ulcers	0
apium graveolens	icterus	0
dairy yogurt	hyperventilation syncope	0
wisconsin milk	impaired sensation	0
dessert	esophageal cancers	0
honeybush tea	food-borne diseases	0
grecian foxglove	textiloma	0
baker's yeast	pancreas cancers	0
bread	cervical migraine syndrome	0
betel nut	endometrium carcinoma	0
punicaceae	disorder	0
soy bean curd	lou gehrig's disease	0
syzygium malaccense	sprue	0
pickled foods	small noncleaved cell lymphoma	0
leafy vegetables	non hodgkins lymphoma	0
snail meat	mental deterioration	0
black raspberries	age related memory disorders	0
filbert	brain vascular accident	0
yerba mates	lewy body parkinson's disease	0
cured meats	painful menstruation	0
boiled eggs	olfactory seizures	0
artificial butter	psoriasis	0
poultry product	endometriose	0
tea plant	esophagus cancer	0
broccoli	manic disorder	0
whole wheat	fibroatheromatous plaques	0
jambolan plum tree	endocrine breast disease	0
swordfish	hemicrania migraines	0
refined olive	lens opacities	0
experience food	infantile obesity	0
cocktail	ovarian cancers	0
flower	lung cancer	0
hordeum	cancer of the colon	0
anise tea	drug allergies	0
crataegus	secretory meningioma	0
wort	acute monoblastic leukemia	0
raphanus sativus	drug abuse	0
pummelo trees	arterial fatty streaks	0
sorrel	chronic fatigue-fibromyalgia syndrome	0
kiwi fruits	neuritic plaque	0
hazelnut	drug dependence	0
eupatorium rebaudianum	myelomatosis	0
fake meat	meningioma	0
bertholletia	muscle tremor	0
dietary fibers	penis neoplasm	0
majorana hortensis	posterior compartment low back pain	0
prebiotic	cerebral convexity meningiomas	0
green pepper	broken bones	0
processing meat	gnathostomiase	0
nut bar	acquired immune deficiency syndrome virus	0
contamination meat	widespread chronic pain	0
chicken salad	oncogenesis	0
preserved foods	barretts esophagus	0
curry	bechterews disease	0
candy bar	pancreatic neoplasms	0
pinto beans	hypoxemia	0
citrus fruits	polyradiculoneuropathy	0
lens culinari	action tremors	0
fried foods	ocular headaches	0
euterpe oleracea mart.s	diverticulum	0
allspice	testis neoplasm	0
bean sprout	atopic disease	0
fat foods	atypical diffuse small lymphoid lymphoma	0
narrow leaved plantain	esophageal cancers	0
official vitamin	contagious ecthyma	0
haritaki fruit	tumor of rete testis	0
fenugreek seeds	benign prostatic hypertrophy	0
carya illinoenses	thyroid carcinoma	0
arachis hypogaea	johne's disease	0
citrus bergamia	gastro-esophageal reflux	0
alcohol	utp hexose 1 phosphate uridylyltransferase deficiency	0
chamomile tea	chronic fatigue syndrome	0
carya	myocardial failure	0
cherry	small noncleaved-cell lymphomas	0
portulaca oleraceas	neurocysticercosis	0
nut butters	pancreas cancers	0
trace elements	long sleeper syndromes	0
chinese food	respiratory tract infections	0
oatmeal	tubal abortions	0
pretzel	food borne diseases	0
alpine strawberry	head trauma	0
yerba mate	cancer of the penis	0
indian gooseberry	granulomatous enteritis	0
papaver somniferum	meningotheliomatous meningioma	0
eragrostis	sinusitis	0
curried tofu	common cancer	0
oyster mushrooms	exudative bronchiolitides	0
infant formula	cervical migraine syndrome	0
glycyrrhiza	penile neoplasm	0
drinking coffee	drug use disorders	0
toxic plant	prevent and reverse heart disease	0
texturized soy proteins	mental deterioration	1
salmonella-infected eggs	muscular rheumatism	0
black pepper	tying disease	0
coconut water	neurological condition	0
fuji apples	male breast tumors	0
plant-based nutrients	ketosis-prone diabetes mellitus	0
citrus limon	diabetic neuropathy	0
peppermint oil	age related macular degeneration	0
aloe	ponv	0
black beans	cancer-causing herpesvirus	0
punica granatum	chronic pains	0
gravy	plasma-cell myeloma	0
dinner	psoriasis	0
dietary soybean proteins	new variant creutzfeldt jakob disease	0
preserved food	dementia	0
candy	sore throats	0
strawberry	cervix neoplasm	0
lunch times	diffuse well-differentiated lymphocytic lymphoma	0
scallion	migratory pain	0
exotic fruit	breast cystic diseases	0
billion eggs	osteoarthrose	0
vaccinium bracteatums	growth hormone receptor defect	0
sesame	bipolar disorders	0
cold-steeping tea	bladder tumor	0
lactuca sativa	peanut allergy	0
english walnut	alopecia cicatrisatas	0
candy bars	orthostatic headache	0
spice turmeric	tor-driven diseases	0
piper methysticum	short sleeper syndromes	0
saffron crocus	meningotheliomatous meningioma	0
tobacco	coronary heart disease	0
avena sativa	lactose intolerance	0
floret	tick bites	0
ephedras	air sickness	0
salami	peripheral demyelinating autoimmune disease	0
medicago sativa	malignant tumor of breast	0
wine	tussive syncope	0
marjoram plant	lymphocytic lymphomas	0
atropa belladonnas	diabetes-related complications	0
foenumgraecum	heart attacks	0
restrict food	cancer of the vulva	0
amomum cardamomums	udp-galactose-4-epimerase deficiency	0
cola	age-related maculopathy	0
toronja	jakob-creutzfeldt disease	0
rooibos tea	epstein barr virus	0
cayenne pepper	ovary neoplasm	0
breakfast cereals	bechterews disease	0
açaí berries	visceral obesity	0
big meals	age-related memory disorder	0
processed meats	pus	0
powdered ginger	exanthema	0
gum acacia	psoriase	0
lunchtime	age-related bone loss	0
pine nuts	low backache	0
energy drink	mixed lymphocytic-histiocytic lymphomas	0
supper	viral disease	0
saint johns wort	occipital trauma	0
milk thistles	bladder cancer	0
undercooked meat	auditory seizures	0
unrefined plant	malignant brain neoplasms	0
orange tree	mild cognitive impairment	0
deli meat	acidose	0
pimenta officinalis	foreign object	0
bitter nightshades	small non-cleaved-cell lymphoma	0
high-fructose corn	back pains	0
frozen fruit	fibromyositis-fibromyalgia syndromes	0
reindeer meat	memory losses	0
red wine	nontropical sprue	0
cayenne	mouth cancers	0
cereal grain	tumor	1
raphanus	acute infectious polyneuritis	0
acer	pulmonary cancer	0
soft drinks	poultry viruses	0
rheum officinale	salmonellosis	0
healthiest beverages	cadaver	0
bean sprouts	muscle spasm	0
curry powder	prion disease	0
taro	male breast enlargement	0
cassia tree	renal insufficiencies	0
ocimum tenuiflorum	retro ocular headache	0
sushi	migraine variant	0
plant capsules	microcystic meningiomas	0
illicium anisatums	deep venous thromboses	0
frosting	occipital region trauma	0
phaseolus	hepatic neoplasm	0
potato	cardiovascular conditions	0
rowanberry	coronary heart disease	0
mastic trees	senile tremors	0
horsemeat	cancer of the colon	0
agent orange	carcinogenic retroviruses	0
fries	guam disease	0
chinook salmon	spinal meningiomas	0
fagopyrum esculentum	malignant primary brain tumors	0
cocoa	herpesvirus	0
fagopyrum sagittatum	mechanical low back pain	0
raw alfalfa	malaria	0
white meat	intraventricular meningioma	0
granny smith apples	malignant epithelial tumor	0
artificial sweeteners	crohn disease	0
apple trees	cervical neoplasm	0
solanum melongena	weight loss	0
english plantain	prostatic intraepithelial neoplasms	0
meal times	iritis	0
zucchini	starvation	0
cider	autoimmune disorders	0
peach trees	spongiform encephalopathies	0
dietary supplements	sunburn	0
lemon balm	chicken embryo lethal orphan virus	0
chlorella	lymphatic sarcomas	0
sweet almonds	posterior fossa meningiomas	0
sugar water	stokes adams syncope	0
squash seeds	paludism	0
eat flax	semantic memory disorder	0
beer	protein deficiency	0
lemon balm tea	fibroatheromatous plaques	0
hickory nuts	crohns disease	0
sardine	fatty liver disease	0
chenopodium quinoas	todd's paralysis	0
concord grape	uterine fibromas	0
animal food	bacterial infection	0
sprout	craniocerebral injuries	0
legume pods	disk degeneration	0
norovirus food	barretts syndrome	0
healthier foods	head injuries	0
anti-inflammatory foods	infantile botulism	0
nicotiana tabacum	chronic cluster headache	0
horse nettles	subacute spongiform encephalopathies	0
cocoa butter	dyslipoproteinemia	0
retail meat	primary fibromyalgias	0
roselle	genital wart	0
earl grey tea	arterial dysfunction	0
raw cranberries	early diagnosis of cancer	0
elettaria	somatosensory seizure	0
real chocolate	phlebothrombosis	0
vaccinium corymbosum	spondylitis ankylopoietica	0
frier	fatty liver	0
daily nut	pill rolling tremors	0
fennel	nephrolith	0
pistacia	cancer of the stomach	0
fresh fruits	lung diseases	0
fagopyrum tataricum	vulvar neoplasm	0
marjoram plants	tonsil cancer	0
hypericum	monocular blindness	0
crabapple	lymphocytic lymphoma	0
ranking foods	minor head injury	0
unfiltered coffee	weight reductions	0
foeniculum vulgares	bilateral headaches	0
plum	aortic aneurysms	0
wild radish	acute confusional migraines	0
stevia rebaudiana	tonsil neoplasms	0
dioscorea polystachya	texidor's twinge	0
bread mold	disc degeneration	0
marsh mallow	lymphoplasmacytoid lymphoma	0
poppy	severe congenital microcephaly	0
kombucha tea	metastasis	0
triticum vulgare	nonalcoholic fatty livers	0
corn	male sterility	0
coffee	migraine disorder	0
barley coffee	reducing cancer	0
brussel sprout	myocardial ischemia	0
dried cranberries	impaired sensation	0
carbonated water	diabetes mellitus complication	0
plant-based foods	brain disorders	0
ready prepared foods	metastatic cancer	0
carthamus tinctorius	headache disorder	0
california avocado	peripheral arterial diseases	0
maize oils	vagina neoplasm	0
citrus aurantium	disrupted in b-cell malignancy	0
oregano plants	symptom cluster	0
msg	liver injury	0
avoid peanuts	disk degradation	0
mangifera	lyme borreliosis	0
vaccinium macrocarpons	vaginal cancer	0
nutrient-dense foods	bovine lymphosarcomas	0
herbal teas	autoimmune disease	0
laciniate nightshade	galactose-1-phosphate uridylyltransferase deficiencies	0
hamburger	urinary bladder neoplasm	0
blueberry plants	thinness	0
dark meat	cervical migraine syndromes	0
turmeric	kidney cancers	0
coca cola	effort syncopes	0
sweet orange	bewilderment	0
bean	lymphoblastic leukemia	0
olive family	severe mental disorders	0
apple tree	burning pains	0
trigonella foenum graecum	rodent ulcers	0
saint john wort	bladder cancer	0
horse nettle	eczematous dermatitis	0
pumpkin pie	physical sufferings	0
psidium	human t-cell lymphotropic virus type iii	0
oxen meat	colon neoplasm	0
eragrostus	flatus	0
kava	small noncleaved-cell lymphomas	0
ready soybeans	age related maculopathies	0
citron trees	malignant primary brain neoplasms	0
golden delicious apples	ankylosing spondylarthritides	0
vegetable protein	breast diseases	0
healthiest nuts	drug use disorders	0
ovary	early onset parkinson disease autosomal recessive	0
bitter nightshade	leprosy	0
nut butter	creutzfeldt jacob disease	0
trace mineral	chronic b lymphocytic leukemia	0
vaccinium bracteatum	johne disease	0
ground beef	food-borne disease	0
aloe vera	atherosclerosis	0
diospyros digyna	peripheral autoimmune demyelinating disease	0
new york coalition for healthy school food	cancer of the rectum	0
brassica napus	salmonellosis	0
humulus lupulus	postoperative emesis	0
pistil	resting tremor	0
radish	cardiovascular stroke	0
seed	hypolactasia	0
vaccinium virgatum	cancer of uterus	0
acai berries	insulin sensitivity	0
cooked broccoli	disorders of initiating and maintaining sleep	0
sunchoke	monoblastic leukemia	0
thousand foods	intracranial cns disorder	0
assai palm berry	cot deaths	0
caryophyllus aromaticus	megacolon	0
black currant	numbness	0
arachis	small cleaved-cell lymphoma	0
woodland strawberry	bilateral sciaticas	0
melissa officinali	hansens disease	0
cinnamomum aromaticum	drug allergy	0
solanum laciniatum	acquired immunodeficiency syndrome	0
sugary foods	congenital myxedema	0
faba bean	intervertebral disk degeneration	0
jasmine tea	galactose epimerase deficiencies	0
squash plant	cervical neoplasms	0
flounder	deaf-mutism	0
prunus persica	cancer of endometrium	0
star anises	histamine cephalgia	0
crunch berries	neurologic degenerative disease	0
mealtime	pancreas neoplasms	0
fennel seeds	acute monoblastic leukemia	0
coriander	nervous system degenerative diseases	0
juiced broccoli	male sub-fertility	0
hemp	action tremor	0
triticum durum	auricular fibrillations	0
chenopodium quinoa	near-death experience	0
triticum turgidum	sneeze	0
orange trees	substance use disorders	0
mastic tree	atopic diseases	0
tuna fish	acute cerebrovascular accidents	0
secale cereale	fibrositis	0
carbonated mineral waters	allergic reactions	0
radicchio	mental deteriorations	0
erythroxylon	memory deficit	0
lunch time	thrombosis	0
yoghurt	malignant meningioma	0
sausage	cancer of the uterus	0
teff	pyrexia	0
monitoring food	multiple sclerosis	0
last meal	orthostatic headaches	0
soda water	ekbom delusory parasitoses	0
cooking oil	infertility	0
wheat	polyradiculoneuropathy	0
dietary supplementations	clonic seizure	0
deli meats	low-grade lymphomas	0
green lentils	bipolar affective psychoses	0
coco	diabetic autonomic neuropathies	0
uncooked foods	undifferentiated carcinomas	0
butternut squash	dims (disorders of initiating and maintaining sleep)	0
not-necessarily-so-healthy foods	foreign bodies	0
papaya	auditory seizure	0
purine-rich plant	colitis	0
baked potato	schizophreniform disorders	0
cymbopogon nardus	germinoblastic sarcomas	0
cucumis sativus	myocardial failure	0
assai palms	age-related osteoporoses	0
cuminum	brain disease	0
endive	neurocysticercose	0
baby carrots	spinal cord disorders	0
iv vitamin	semantic memory disorder	0
allium porrum	prediabetic states	0
grape juice	situational syncope	0
veggie	colic	0
cooking meat	well differentiated lymphocytic lymphoma	0
kava kavas	cancer of the bone	0
cassia	wound botulism	0
holy basil tea	high cholesterol levels	0
snack food	norwalk like viruses	0
bell peppers	udpglucose 4 epimerase deficiency disease	0
cooked carrots	colicky pain	0
sweetening agents	cva (cerebrovascular accident)	0
prunus salicinas	coronary heart diseases	0
french bean plants	seizure disorder	0
cappari	memory losses	0
unfertilized eggs	periodontal disease	0
afzelia	exanthem	0
foxglove	endometriosis	0
collard greens	severe gh insensitivity	0
eat chocolate	hyperemesis gravidarum	0
salad	bladder tumors	0
lemon grass	diverticulum	0
green peppers	v-cjd (variant-creutzfeldt-jakob disease)	0
chamomile oil	transmissible dementia	0
international nut	lymphocytic lymphomas	0
drinking tea	renal neoplasm	0
citronella	zoonosis	0
mustard plants	spinal cord disorders	0
frequent meals	dehydration	0
antioxidant fruits	ruptured appendicitis	0
plantago ovata	cancer of the liver	0
ilex paraguariensis	cataract	0
mushroom	serious disease	0
euchresta	psoriasis	0
cicer arietinums	sliding hiatal hernia	0
andean blackberries	bladder diseases	0
black walnut	hepatitis	0
red delicious apples	deep venous thromboses	0
raw foods	early detection of cancer	0
brassica	bechterew's disease	0
ceratonia	malignant brain neoplasms	0
plantago psyllium	heat stroke	0
color	elevated cholesterols	0
know nuts	schizophrenic disorder	0
flax seed	acquired deafness	0
common foxgloves	ms (multiple sclerosis)	0
sun-dried raisin	food hypersensitivities	0
mussel	human mammary carcinoma	0
coconut milk	plegia	0
shellfish	benign essential tremor	0
bolete	malignant neoplasm of breast	0
raw broccoli	zoonotic infectious disease	0
solanum laciniatums	mixed lymphocytic-histiocytic lymphomas	0
hickory tree	superficial head injuries	0
contaminated meat	intermediate grade lymphoma	0
added sweeteners	tick bite	0
pecan	virus infections	0
food poisonings	colon neoplasm	0
osmanthus	darkness tremor	0
multivitamin	generalized spasms	0
drinking milk	epilepsy	0
fat milk	breast malignant neoplasm	0
vitis	female subfertility	0
liquorice	human immunodeficiency virus	0
convenience food	familial creutzfeldt-jakob disease	0
eating meat	primary gh resistance	0
frozen broccoli	hay fever	0
dripping	brain disease	0
gooseberry	spindle cell sarcomas	0
lemongrass	cerebrovascular accidents	0
organic meat	impaired sensation	0
ready-prepared foods	mastodynia	0
ginger ale	deep vein thrombosis	0
chanterelle	acute myeloid leukemia	0
carbonated beverages	early-onset parkinsonism	0
soy yogurt	parkinsonian syndromes	0
white mallows	autoimmune condition	0