
portulaca oleraceas	urticarias	0
plant embryo	disk degeneration	0
exotic fruit	seizure	0
onion	kidney insufficiencies	0
sunflower seeds	primary brain neoplasms	0
cocoa plants	breast cystic disease	0
miso	congenital abnormalities	0
capsicum	postural syncope	0
solanum lycopersicum	deep-vein thrombosis	0
kangaroo meat	a-v dissociation	0
pasta	hortons syndrome	0
petroselinum	johne's disease	0
plant kingdom	remittent fever	0
kavas	nerve tremors	0
rooibos	lyme arthritis	0
colorful foods	human papillomavirus viruses hpv	0
cassia tree	thrombose	0
digitalis	stomach cancers	0
rubus glaucus	variant creutzfeldt-jakob disease	0
prunus amygdalus	experimental parkinson diseases	0
eating eggs	urticaria	0
navy beans	cysticercosis	0
linseed	amnesia-memory loss	0
hawthorn	myalgic encephalomyelitis	0
thousand foods	breast malignant neoplasm	0
eupatorium rebaudianums	endometrial neoplasm	0
alfalfa	guam disease	0
purple potatoes	limb tremor	0
undercooked meat	rabies	0
horse bean	throbbing headache	0
nut butter	classic galactosemia	0
eat chocolate	tactile hypesthesias	0
pimiento	inappropriate growth hormone secretion syndrome (acromegaly)	0
unhealthy food	myelogenous leukemia	0
kiwi	hyperpigmentation	0
aspalathus	cancer of prostate	0
kava kava	breast cancers	0
roselle	chronic lymphoblastic leukemias	0
foodstuff	amyloid deposits	0
narrow leaved plantain	lav-htlv-iii	0
papaver somniferum	peripheral arterial disease	0
saint johnswort	fibrocystic mastopathy	0
rosemary	deficiency disease	0
fragaria	lung cancers	0
baker's yeast	early infantile autism	0
high-fructose maize syrup	autosomal dominant juvenile parkinsonism	0
citrus x paradisi	thermal hypesthesias	0
baking chocolate	short sleeper syndrome	0
beta vulgaris	breast tumors	0
anise tea	diabetic asymmetric polyneuropathy	0
ready-to-eat meal	schizoaffective disorders	0
flavoring	brief reactive psychosis	0
chervil	vulva neoplasm	0
hot peppers	proteinuria	0
hydroponic basil	high grade lymphoma	0
yoghurt	colon neoplasms	0
caryophyllus aromaticus	cerebral stroke	0
phyllanthus emblicas	insulin sensitivity	0
broth	chronic pains	0
big apples	familial dementias	0
flax seed	penile cancers	0
mandarin orange tree	hemangioblastic meningiomas	0
oregano plant	iodine deficiency	0
prenatal vitamins	alactasia	0
carbonated mineral water	testicular cancer	0
veal	enterocele	0
cinnamomum aromaticum	wart	0
pimpinella anisums	papillary meningioma	0
sparkling waters	jakob-creutzfeldt disease	0
healthy snack	posterior fossa meningiomas	0
baked potato	recurrence	0
vital nutrients	severe congenital microcephaly	0
snail meat	udpglucose hexose 1 phosphate uridylyltransferase deficiency	0
cream cheese	muscle tremors	0
solanum dulcamara	pancreatic neoplasms	0
national meat	regional enteritis	0
horsemeat	nasal cavity cancer	0
illicium anisatum	guillaine barre syndrome	0
candy bars	basal cell nevus syndrome	0
dairy products	diffuse lymphoma	0
oryza sativa	amnestic states	0
consumer protection scientific committee on food	graves disease	0
porgy	prediabete	0
infant formula	tubal abortions	0
sockeye salmon	alactasia	0
cardamom	weight gain	0
durum wheats	atrioventricular dissociation	0
morning meal	bechterew disease	0
raw tomatoes	sciatic neuralgias	0
colophospermum	ciguatera poisoning	0
lime	arthritis	0
malus	tussive syncopes	0
star anises	age related bone loss	0
digitalis purpurea	amyloid plaque	0
human milk	atheroma	0
breakfast cereal	epithelial cancers	0
lucerne	cancer of the bone	0
taro	congenital abnormality	0
noni fruit	arterial fatty streak	0
vegetable juices	colonic neoplasms	0
fryer	lou gehrig's disease	0
poppy seeds	human t lymphotropic virus type iii	0
herb	ulcerative colitis	0
dried blueberries	somatotropin (acromegaly) hypersecretion syndromes	0
flower	cardiac arrhythmia	0
chlorella	small noncleaved-cell lymphomas	0
cacao	physical sufferings	0
white rice	skin disease	0
flaked coconut	substance abuse	0
sparkling water	copd	0
oregano plants	saturnine tremors	0
antioxidant food	birth weights	0
flounder	cerebrovascular strokes	0
avocado	status migrainosus	0
basil	situational syncopes	0
cinnamomum verum	gluten enteropathies	0
ficus	dementia	0
yogurt	sharp headaches	0
goji berry	crushing skull injuries	0
peach tree	galactose-1-phosphate uridyl-transferase deficiency disease	0
orange trees	autosomal recesssive juvenile parkinsonism	0
bertholletia excelsas	joint pains	0
horsebean	kidney neoplasm	0
avena	age-related memory disorder	0
aubergine	intraepithelial prostatic neoplasias	0
chinese cassia	child obesity	0
club soda	mental deteriorations	0
peach	mechanical low back pain	0
plant zygote	neurologic degenerative condition	0
low-salt diet	spondyloarthritis ankylopoietica	0
almond tree	liver cancer	0
nutraceutical	bone neoplasm	0
include apples	bipolar depression	0
muffin	idiopathic polymyositis	0
citrus grandis	feline leukemia virus	0
euterpe oleracea	cardiac sudden death	0
taraxacum	arrhythmia	0
golden delicious apples	mptp-induced experimental parkinsonism	0
lemon	spindle cell carcinoma	0
bitter nightshades	environmental cancer	0
seville orange trees	cot death	0
caramel	fibrose	0
milk thistles	severe mental disorder	0
hazelnut	barrett metaplasia	0
shiitake mushrooms	hemicrania	0
juiced broccoli	malignant lymphoma	0
nicotiana tabacum	peripheral autoimmune demyelinating disease	0
stryphnodendron	appendicitis	0
coffee	malignancy	1
grouper	different cancer	0
pomegranate seeds	apneas	0
plantago	polymyositis ossificans	0
leafy vegetables	comatose	0
dasheen	cancer of penis	0
origanum majorana	familial tremors	0
chamomile oil	bacterial vaginoses	0
persea	papillomaviridae	0
cocos nuciferas	eye disease	0
malabar-nut	bronchiolitis obliterans	0
dietary protein	odontogenic keratocysts multiple basal cell nevi	0
sweetened cereal	endometriosis	0
fragaria vesca	degenerative neurologic disease	0
eragrostis	tussive syncopes	0
whole grains	sleep disorders	0
grapefruit	myeloid leukemia	0
hibiscus	marie struempell disease	0
low fruit	contusion	0
mentha	hemicrania	0
green onions	occipital region traumas	0
sugary foods	cervical migraine syndromes	0
holy basils	inhibit cancer	0
poultry	cancer of lung	0
black walnuts	polyradiculoneuritis	0
daucus carota	age-related maculopathies	0
solanum melongena	diabetic complication	0
tisane	liver neoplasms	0
mangifera indica	genital warts	0
salt-free diet	water-borne hepatitis	0
drink milk	dissociative amnesia	0
eugenia caryophyllata	scorbutus	0
isoglucose	age-related macular degeneration	0
cinnamomum zeylanicum	lower back pains	0
frying foods	coronary heart disease	0
frosting	neuralgic migraines	0
contaminated meat	chronic fatigue syndromes	0
clathrotropis	cancer of the vagina	0
indian gooseberry	vulva cancers	0
citrus aurantium	head pain	0
cannabis	episodic cluster headache	0
chile peppers	visceral obesity	0
citronella	ischemic heart disease	0
stem vegetables	neurodegenerative diseases	0
punica granatum	metastasis	0
lard	zoonotic diseases	0
filtered coffee	joint diseases	0
carduus marianus	diabetes mellitus complications	0
shan yaos	atrioventricular dissociation	0
coco	episodic cluster headache	0
flammulina	fibrositis	0
raw alfalfa	benign neoplasm	0
sweetening agent	western diseases	0
meal time	ischemia	0
common foxgloves	medical conditions	0
low meat	vulvar cancer	0
concord grapes	brain neoplasm	0
oyster mushroom	painful diabetic neuropathies	0
dried foods	semirhythmic tremor	0
cured meats	lymphadenopathy-associated viruses	0
peppermint	syncope	0
prosopis	insulin sensitivity	0
club sodas	colitis	0
black sapote	acquired immunodeficiency syndrome	0
noncaloric sweetener	ovary cancers	0
avena sativa	endothelial dysfunction	0
sesame oil	prostatic intraepithelial neoplasia	0
vaccinium ashei	iron overload	0
pistacia lentiscus	gorlin goltz syndrome	0
poisonous plant	familial creutzfeldt-jakob diseases	0
garlic	amyloid plaques	0
eating food	malignant meningioma	0
tumeric	painful menstruations	0
orange	retained surgical tool	0
cucumber	human papillomavirus viruses hpv	0
supper	lower back pain	0
chinese rhubarb	benign neoplasm	0
diospyros digyna	cirrhosis	0
green pepper	pulmonary cancers	0
kidney beans	intraventricular meningioma	0
mentha spicata	communicable diseases	0
rose berries	retained surgical sponges	0
crocus	breast malignant neoplasms	0
fed beef	ekbom delusory parasitosis	0
cruciferous foods	postoperative nausea	0
chamomile oils	crohns disease	0
handling meat	early detection of cancer	0
eugenia cumini	recurrent low back pain	0
root	hyperemesis gravidarum	0
dried apples	burkitt's lymphoma virus	0
whole foods	epithelioid sarcoma	0
zea mays	hepatic failure	0
chewing gum	osteoarthrosis	0
gum acacia	periodontal diseases	0
cocktail	acute strokes	0
organ meats	inflammatory bowel disease	0
paella	olfaction disorders	0
wolfberry	national cancer	0
maize syrup	urticaria	0
extracted fruit	testis neoplasms	0
fagopyrum sagittatum	cardiac arrhythmia	0
buckwheat	hypermelanosis	0
english walnut	testicular neoplasm	0
crab apple	manic disorders	0
watercress	muscle sorenesses	0
sweet basils	encephalon diseases	0
larder	wart	0
flaxseed	obesity in childhood	0
crave chocolate	diabetic complications	0
diabetic diet	gnathostomiasis	0
areca catechus	nephrolith	0
sugar water	hysterical amnesia	0
portulaca	oncogenic virus	0
soy bean proteins	thyroid carcinoma	0
taraxacum officinale	galactose-1-phosphate uridyltransferase deficiency	0
celery	kahler disease	0
low-calorie diet	cancer of rectum	0
black beans	amnestic states	0
sweet almond	weight losses	0
macadamia nut	shock	0
sorrel	hyperpigmentation	0
cocoa powder	abdominal migraines	0
blueberry plant	mild cognitive impairments	1
sea bilberries	sciatic neuralgia	0
red tea	presyncope	0
proteus mirabilis	relapse	0
origanum onites	adenoviridae	0
mustard plants	intention tremor	0
mastic tree	insulin resistance	0
pisum sativum	esophageal reflux	0
turmeric root	catarrh	0
yerba mates	brain neoplasms	0
curcuma zedoaria	aphthous stomatitides	0
poisonous plants	biliary calculi	0
whale meat	mucous colitides	0
salsa	rectal cancer	0
healthiest beverage	oral cancers	0
alpine strawberry	hiatus hernias	0
olive oil	fight cancer	0
cupcake	fusiform aneurysms	0
andean blackberry	kahler disease	0
dried pomegranate	condylomata acuminata	0
lens plants	chronic lymphatic leukemia	0
popular fruits	low-grade b-cell malignancy	0
neu5gc-rich food	phlebothrombose	0
stevia rebaudianas	lymphosarcoma	0
prunus persica	pustulosis palmaris et plantaris	0
yolk	galactosemia 3s	0
bitter orange trees	tonsillar neoplasm	0
density foods	lung neoplasms	0
emblica officinalis	polyp	0
vegetable protein	auriculo-ventricular dissociation	0
drink	pustulosis of palms and soles	0
junk food	small cleaved cell lymphoma	0
butternut squash	gallstone	0
split pea	testis neoplasms	0
dressing	mouth cancers	0
green peas	johne disease	0
collard	cephalgia	0
processing meat	prostatic hyperplasia	0
snack foods	sarcoma	0
cooking meat	breast fibrocystic changes	0
processed foods	ms (multiple sclerosis)	0
find pork	acquired immunodeficiency syndrome virus	0
contaminated foods	tonic clonic seizures	0
leek	human immunodeficiency virus	0
thymus	aphthous ulcers	0
pomelo trees	breast malignant tumors	1
cashew	deep vein thromboses	0
seltzer water	prostatic adenoma	0
okra	chronic b lymphocytic leukemia	0
granny smith apples	stomatognathic disease	0
adhatoda	tussive syncope	0
sardine	situational syncopes	0
guibourtia	cardiac arrhythmias	0
rice milk	medical conditions	0
chewed coca	polyarthritis	0
pleurotus	tactile hypesthesia	0
anacardium occidentale	insulin resistance	0
cow's milk	emesis	0
entree	breast carcinoma	0
coriandrum sativum	primary brain neoplasm	0
coleslaw	vulva cancers	0
bad foods	olfaction disorders	0
red cabbage	norwalk like viruses	0
plum	deep venous thromboses	0
eating fruits	membranous cataract	0
maraschino cherry	malignant melanomas	0
wheat bran	develop cancer	0
soy bean curds	dehydration	0
new candy	sleep-related neurogenic tachypnea	0
spearmint	social anxiety disorders	0
betel nuts	ovary neoplasm	0
agent orange	zoonotic infections	0
zingiber officinale	urinary bladder neoplasm	0
cicer arietinums	parkinson disease	0
mussel	deafness	0
roasted almonds	pleomorphic lymphomas	0
eating nuts	lobar pneumonias	0
beta vulgari	progressive disorder	0
andropogon nardus	phage	0
fava bean	polyp	0
mesquite	causes cancers	0
liquor	gehrig disease	0
fruit-shaped marshmallows	zoonotic infectious disease	0
curry powder	huntington’s disease	0
leguminosae	chronic b-lymphocytic leukemias	0
digitalis lanata	chronic diseases	0
coconut	obesity in childhood	0
red yeast rice	jacksonian seizure	0
flowering shrub	cervical migraine syndromes	0
pork	hepatic neoplasms	0
bread	delusional parasitosis	0
swiss chard	osteoarthritis	0
pizza	left-sided heart failure	0
lycopersicon esculentum	angioblastic meningiomas	0
ready soybeans	cephalodynia	0
kidney bean	mild neurocognitive disorder	0
ceylon cinnamon	abdominal pains	0
cacao bean	small round structured viruses	0
horsenettle	prostatitis	0
fagopyrum	peripheral artery disease	0
ground flax	static tremor	0
dietary plant protein	hiatal hernias	0
aloe vera	memory loss	0
phytonutrient-rich food	olfaction disorder	0
study lavender	ciguatera poisonings	0
food additive	limb cramps	0
belladonna	polyradiculoneuritide	0
beverage	kanner's syndrome	0
thyme	fibromyalgia fibromyositis syndrome	0
da huang	utp hexose 1 phosphate uridylyltransferase deficiency disease	0
cod	cognitive retention disorder	0
hypericum perforatum	cancer of rectum	0
soft drink	neurologic degenerative disease	0
phaseolus vulgari	paroxysmal atrial fibrillation	0
avenas	insomnia disorders	0
lemon grasses	cancer of the lung	0
dietary supplement	hemolytic-uremic syndrome	0
whole grain cereal	arthritis	0
seven nutrients	chronic daily headaches	0
baby carrots	numbness	0
psyllium	age-related memory disorder	0
nicotiana tabacums	constrictive bronchiolitides	0
cucumis melos	uterine fibroma	0
psidium guajava	schizophrenic disorder	0
pistil	cancer of the endometrium	0
morinda citrifolias	reticulolymphosarcoma	0
carica papaya	steatosis of liver	0
lipomul	thrombosis	0
common olive trees	adenomatous polyp	0
maize oils	skin neoplasms	0
salmonella food	celiac disease	0
lycium	lichen rubra planus	0
chilli pepper	retained surgical instruments	0
cauliflower	bacterial vaginoses	0
soy protein	fibroid uterus	0
breast milks	pulmonary disorder	0
reason food	barrett epithelium	0
croaker	small cell lymphoma	0
smoked food	retained surgical instrument	0
box elders	cerebrovascular accidents	0
cooked meat	meningioma	0
musa	dementia	0
white pepper	nutritional disease	0
brazil nuts	tonic seizure	0
oyster mushrooms	gastro oesophageal reflux	0
fennel	epithelial cancers	0
stevia rebaudiana	tonsil cancers	0
dog rose berries	brain benign neoplasms	0
popcorn	skin neoplasm	0
solanum tuberosums	gastroenteritis	0
kawa	clonic seizures	0
drug administration united states food	chronic illness	0
sesame seeds	parkinsonian syndrome	0
intoxicant	parkinsonism-dementia complex of guam amyotrophic lateral sclerosis	0
suggesting apple	inhibit cancer	0
chocolate pudding	kidney failure	0
chicken salad	common colds	0
acai berries	torsion fractures	0
mangifera	mania	0
pumpkin	hypospadia	0
fat milk	endometrial cancer	0
sweetener	barrett's esophagus	0
fuji apples	food-borne illnesses	0
energy drink	neurologic degenerative disease	0
rosa	parkinsons disease	0
black pepper	stroke	0
beet	paraesophageal hernia	0
tea leaves	benign neoplasm	0
soymilk	female sub-fertility	0
vitis vinifera	amnesia-memory losses	0
beef	colorectal tumor	1
healthiest beverages	chicken viruses	0
health nuts	halitosis	0
soy beverage	abdominal aortic aneurysm	0
french bean plants	recurrence	0
fabaceae	uterine cervical cancer	0
bacon	respiratory tract infections	0
fatty foods	phlebothrombosis	0
snack	kidney calculi	0
fagopyrum tataricum	ruptured appendicitis	0
carrot juice	arthrosis	0
sunchoke	thyroid carcinomas	0
sea-food	premature aging	0
mastictree	bovine leukemia virus	0
fermented foods	back pain with radiation	0
food additives	cancer of the endometrium	0
marijuana	crohn’s disease	0
pecan trees	colon disease	0
tachigalia	hair losses	0
foxglove	abdominal pains	0
dress	parkinson’s disease	0
bilberry	ulcerative colitis	0
areca nuts	cluster headache syndromes	0
pithecellobium	prostatic hypertrophy	0
vaccinium bracteatums	sick headache	0
soda water	arthritis	0
plant capsule	hemangiopericytic meningiomas	0
ephedra	degenerative neurologic disease	0
irritable bowel kiwi fruit	colorectal cancer	0
roundup-ready soybeans	urinary bladder neoplasm	0
triticum durum	galactose-1-phosphate uridyl-transferase deficiency disease	0
beer	lobar pneumonias	0
hashish	osteoarthrosis deformans	0
recommend tea	vagina cancers	0
different fruits	ovarian cancers	0
so-called vegetable	ekbom delusional parasitoses	0
grape juice	prostatic cancers	0
replenish nutrients	diabetes-related complications	0
blackberry	thyroid neoplasms	0
linum usitatissimum	bacterial vaginoses	0
sweet peppers	dripped virus	0
cranberry	hiatal hernia	0
grecian foxglove	muscle tenderness	0
celeriac	clonic seizures	0
carbonated drinks	physical anhedonias	0
amorpha	water borne hepatitis	0
kombucha tea	oncovirinae	0
eupatorium rebaudianum	pregnancy induced diabetes	0
whipped cream	a v dissociation	0
abelmoschus esculentus	brain cancers	0
syzygium cumini	occipital region traumas	0
junk foods	creutzfeldt-jakob syndrome	0
nuclear power plants	charcot disease	0
rheum tanguticum	drug hypersensitivity	0
olive	mink encephalopathy virus	0
apple trees	foreign object	0
frier	degenerative intervertebral discs	0
bolete	huntington’s disease	0
good soybeans	cancer of the endometrium	0
antioxidant vitamin	fibrous meningiomas	0
sugar substitutes	feline leukemia virus	0
feather meal	autosomal recesssive juvenile parkinsonism	0
nut butters	retained surgical tool	0
texturized soy protein	experimental lung inflammations	0
almond oil	ache	0
chenopodium quinoas	olfactory seizure	0
adhatoda vasica	massive tremor	0
dark chocolate	epstein barr virus	0
pistachio nut tree	lymphatic sarcoma	0
store licorice	atrophy	0
tea	lymphocytic leukemia	0
dried plums	kanner's syndrome	0
fiddlehead ferns	cephalgia	0
romaine	sore throat	0
berry	lens opacities	0
apricot tree	familial guillain-barre syndrome	0
eden foods	blood cancers	0
anacardium	parodontose	0
egg	senile plaques	0
carbonated drink	endometrium cancers	0
pease	motion sickness	0
plantago psyllium	oxygen deficiency	0
betel	idiopathic intracranial hypertension	0
zedoary zedoaria	laron type dwarfism i	0
frozen broccoli	age-related maculopathy	0
milk chocolate	higher cancer	0
solanum laciniatums	vagina cancers	0
syzygium malaccense	breast disease	0
java plum trees	mammary dysplasia	0
kawa kawa	prion-associated disorders	0
watermelon	psammomatous meningioma	0
lemon tree	vulvar neoplasm	0
trigonella foenum-graecum	psoriasis	0
bell peppers	recurrent brain tumor	0
papaver	food-borne diseases	0
mother cells	beriberi	0
holy basil tea	human mammary carcinoma	0
chewing fruit	atrophy	0
herbal teas	angioblastic meningioma	0
fried foods	focal seizures	0
bt corn	sarcoma	0
pyrus	pseudocoma	0
lentinus edodes	crushing pain	0
squash plant	diverticulum	0
soy bean	complete hearing loss	0
canned fruit	deep-vein thrombosis	0
pancake	vagina cancers	0
plant-based foods	intermediate-grade lymphomas	0
triticum aestivum	human herpesvirus 4	0
coriandrum	tongue cancer	0
century plants	psoriasis	0
ginger ale	appendicitis	0
sprout	degenerative neurologic disease	0
rye	low back pains	0
green grapes	relapse	0
cuminum cyminum	cjd (creutzfeldt-jakob disease)	0
portulaca oleracae	peripheral artery disease	0
walnut	female pattern baldness	0
eugenia sandwicensis	zoonotic infectious disease	0
shan yao	contusion	0
texturized soy proteins	ponv	0
grape seeds	primary fibromyalgias	0
sour orange trees	drunkenness	0
last meal	esophageal neoplasm	0
piper methysticum	barrett metaplasia	0
new vitamin	gastroesophageal reflux	0
kava	fibrositis	0
dioscorea polystachya	complete hearing loss	0
hickory trees	cancer of ovary	0
dripping	chronic fatigue syndromes	0
jambolan plum trees	malaria	0
seafood	cancer of bone	0
buttermilk	malignant meningiomas	0
alcoholic beverages	anaplastic carcinoma	0
confection	oral cancer	0
apium graveolens	cancer of stomach	0
mayo	arthritide	0
cold-steeping tea	cancer of rectum	0
food supplementations	spondylarthritis ankylopoietica	0
wisconsin milk	salmonella infection	0
citrus sinensis	huntingtons disease	0
healthy foods	dysosmia	0
spice turmeric	idiopathic parkinson's disease	0
syzygium aromaticum	hot flashes	0
solanum	gastroesophageal reflux	0
brewing tea	myalgia	0
prunis communis	gnathostoma infection	0
squash plants	coronary heart diseases	0
vaccinium macrocarpon	gnathostoma infections	0
areca catechu	deep vein thrombosis	0
faba beans	cellulite	0
mustard	primary malignant brain neoplasms	0
hibiscus tea	somatotropin hypersecretion (acromegaly) syndromes	0
organ	postural low back pain	0
so-called meat	human mammary carcinoma	0
preserved foods	undifferentiated lymphoma	0
ribe	degenerative neurologic diseases	0
chinook salmon	memory loss	0
brassica juncea	experimental parkinsonisms	0
carya illinoenses	autosomal dominant. juvenile parkinson disease	0
snacktime	arterial fatty streak	0
guava	jakob-creutzfeldt disease	0
cassia cinnamon	arthralgia	0
animal-based vitamin	neurotic anxiety state	0
thymus plants	diffuse small cleaved-cell lymphoma	0
crataegus monogyna	action tremors	0
cannabis sativa	chronic lymphocytic leukemias	0
suggesting fruit	abdominal cramp	0
pie	strains and sprains	0
wheatgrass	vulvar cancer	0
beet greens	communicable diseases	0
ovary	cervical neoplasms	0
maple	flatulence	0
dried fruit	male breast tumors	0
anti-inflammatory foods	passive tremor	0
sausage	seizure disorder	0
anchovy	cervical neoplasms	0
curry	inappropriate gh secretion syndrome (acromegaly)	0
cooking oil	essential tremors	0
acaí berries	bacterial infection	0
açaí berries	cirrhosis	0
red peppers	ekbom delusory parasitosis	0
low vitamin	numbness	0
pickled vegetables	post traumatic osteoporosis	0
algarrobo	endometrium cancer	0
high-fiber food	abdominal cramp	0
legume pod	diverticulum	0
uncooked food	kidney disease	0
yam	hemicrania migraine	0
malabar nut	male breast cancer	0
bibhitaki fruit	alopecia cicatrisata	0
organic food	upper respiratory infection	0
corn sugar	non-epileptic convulsion	0
atropa belladonna	throbbing headache	0
shoot	galactokinase deficiency disease	0
indian laburnum	non alcoholic fatty liver disease	0
breakfast cereals	endometrium carcinomas	0
gluten	udp-galactose-4-epimerase deficiency disease	0
nuclear power plant	polyradiculoneuritide	0
eugenia aromatica	spontaneous abortion	0
powdered ginger	abdominal migraine	0
cocoa powders	foreign body	0
dried yeast	spinal meningiomas	0
sweet pepper	macular dystrophy	0
plaice	deglutitional syncope	0
anticancer plant	philadelphia negative myeloid leukemia	0
hibiscus cannabinus	excess cancer	0
glucose-fructose syrup	necrotizing fasciitis	0
beetroot	acute confusional migraines	0
dried cranberries	botulism	0
broad beans	myocardial infarcts	0
wine	salmonellosis	0
artificial sweetener	heart decompensation	0
national pork	acute fulminating multiple sclerosis	0
squid	paratuberculosis	0
fatty meal	diffuse mixed-cell lymphomas	0
food pyramid	torsion fractures	0
apricot	oncogenic viruses	0
lamb chops	hysterical amnesia	0
trigonella	heart decompensation	0
warm milk	lactose intolerance	0
ice cream	carcinomatosis	0
barley	liver dysfunction	0
cultivated oats	severe mental disorders	0
plantago indica	myeloma-multiple	0
mother cell	sinusitis	0
dioscorea batatas	cardiovascular diseases	0
term vegetable	obesity in adolescence	0
common bean plant	udpglucose 4-epimerase deficiency disease	0
bok choy	small lymphocytic lymphomas	0
goji berry plants	water-borne hepatitides	0
trace element	bacteria-eating virus	0
soup	breast cancers	0
plant arils	anal ulcers	0
lavandula angustifolia	barretts esophagus	0
prettiest fruit	endometrial neoplasm	0
justicia	aortic aneurysms	0
soy cheese	crohn's enteritis	0
pear	infectious disease	0
juglans nigra	muscular spasm	0
cannabis indicas	physical anhedonia	0
healthier foods	zoonotic infectious diseases	0
thymus plant	anticancer	0
decaffeinated tea	terminal cancer	0
origanum vulgare	acne	0
white potatoes	uterine cervical cancers	0
contamination meat	brains cancer	0
japanese plums	cerebral strokes	0
dietary fibers	mental disorders	0
pecan	postviral fatigue syndromes	0
coconut water	bruise	0
citrus maxima	food-borne disease	0
lemon balms	liver steatosis	0
tuna fish	diabetic neuropathies	0
frequent meals	stomach ulcers	0
candy bar	spindle cell sarcoma	0
incorporate cloves	paratuberculose	0
ocimum sanctum	multiple head injuries	0
goji berries	birth defects	0
pummelo trees	cognitive dysfunctions	0
illicium verums	dermatosis	0
cocoanut	rabies viruses	0
raisin bran	obesity	0
machaerium	vulvar neoplasm	0
breakfast time	tonic seizures	0
brown sugar	continuous tremor	0
aloe	aphthae	0
goiaba	undifferentiated lymphoma	0
crocus sativus	preventing cancer	0
food colors	gastro esophageal reflux	0
lemongrass	early-onset parkinsonism	0
cymbopogon	intraepithelial prostatic neoplasia	0
pleurotus ostreatus	barrett's syndrome	0
vitamin	ciliary body spasm	0
shiitake mushroom	muscular cramps	0
fenugreek seed	stomach ulcers	0
dietary sugars	malignancy	0
pimenta officinali	retro-ocular headache	0
vaccinium bracteatum	bacterial infections	0
persea americana	cardiac failure	0
pistachio	amyotrophic lateral sclerosis-parkinsonism-dementia complex 1	0
melissa	ekbom psychogenic parasitoses	0
rabbit meat	galactokinase deficiency diseases	0
apricot trees	mouth and tooth diseases	0
honey	small non-cleaved-cell lymphoma	0
soy foods	coronary diseases	1
artificial sweeteners	canker sores	0
saffron crocus	prion induced disorder	0
nettle tea	food hypersensitivities	0
myristica fragrans	parodontosis	0
curcuma zedoarias	intraorbital meningioma	0
weed	cerebral strokes	0
citrus aurantiifolias	urticaria	0
kava kavas	galt deficiency	0
lemon balm	shock	0
millet	sneeze	0
cola acuminata	malignant brain neoplasm	0
edible grain	palmoplantaris pustulosis	0
including cloves	diffuse lymphoma	0
currant	lymphocytic lymphoma	0
cranberry sauce	substance abuse	0
jerusalem artichokes	lichen ruber planus	0
sweet marjorams	bacterial infections	0
lens culinaris	rectal cancers	0
yeast rice	cancer of the thyroid	0
black raspberries	bovine leukemia virus	0
flesh foods	broken bone	0
applesauce	degenerative arthritides	0
wheat brans	congenital defects	0
emphasizes vegetables	colitis	0
ilex paraguariensis	delusional parasitoses	0
melissa officinalis	condylomata acuminata	0
acacia tree	liver dysfunctions	0
lycium chinense	colonic neoplasms	0
peppermint oil	small noncleaved-cell lymphomas	0
prunus domestica	bladder diseases	0
açai berry	toxico-infectious botulism	0
acer negundos	drug hypersensitivity	0
rye bread	stomatognathic diseases	0
melissa officinali	flatulence	0
amygdalus communis	malignant meningiomas	0
rowanberry	episodic cluster headaches	0
cider vinegar	philadelphia-negative myeloid leukemias	0
pinto bean	lymphatic sarcoma	0
sesamum	kidney neoplasm	0
dinner time	malignant tumor of urinary bladder	0
commercial milk	liver diseases	0
avocado fruit	galactokinase deficiency diseases	0
baptisia	small cleaved cell lymphoma	0
chestnut	spatial memory disorder	0
cicer arietinum	feline leukemia viruses	0
carthamus tinctorius	lung cancer	0
arachis hypogaea	intention tremors	0
andira	igf-1 deficiency	0
olive oils	schilling-type myeloid leukemia	0
raw garlic	testis cancer	0
acid-binding vegetables	basal cell nevus syndrome	0
ready-to-eat meals	male pattern alopecia	0
agave	multiple myelomas	0
rubus	chronic cluster headaches	0
poultry meat	urinary bladder cancer	0
white wine	diffuse small cleaved-cell lymphoma	0
monitoring food	pulmonary thromboembolism	0
alcohol	dental diseases	0
pomegranate	chronic disease	0
infant formulas	stomach ulcer	0
morinda citrifolia	gestational diabetes mellitus	0
cassia fistulas	insulin deficiency	0
ilex paraguarienses	chronic insomnia	0
dangerous plants	acute strokes	0
vicia faba	idiopathic polymyositis	0
osmanthus	hepatitis	0
include fennel	bipolar depression	0
barley coffee	ductal carcinoma	0
hypericum	social phobias	0
little meat	fibroatheroma	0
soybean	sudden cardiac death	0
trace mineral	rectum cancers	0
flammulina velutipes	bovine spongiform encephalitis	0
areca	chronic fatigue-fibromyalgia syndrome	0
breakfast	barrett epithelium	0
lycium barbarum	grave’s disease	0
cortland	viral diseases	0
petroselinum crispums	crushing skull injury	0
prebiotic	landry guillain barre syndrome	0
rice	post ictal confusion	0
cannabis sativas	leanness	0
mashed potatoes	gasser's syndrome	0
mint tea	kidney diseases	0
apium graveolens var. dulce	post-traumatic osteoporosis	0
radish	hemolytic jaundices	0
jell-o	tongue neoplasm	0
golden delicious	contagious pustular dermatitides	0
sugar maple	nonalcoholic steatohepatitis	0
plum tree	cardiac dysrhythmia	0
cumin	hypercholesteremia	0
halibut	cancer viruses	0
vaccinium myrtillus	comatose	0
burrito	cancer of breast	0
dietary supplements	congenital defects	0
peanut	male pattern baldness	0
milk proteins	disorders of initiating and maintaining sleep	0
gooseberry	b cell chronic lymphocytic leukemia	0
alfalfa sprouts	stomach cancer	0
cereal grains	periodontal disease	0
kola nuts	cancer-causing viruses	0
monkfish	upper respiratory tract infections	0
citron trees	neonatal tremor	0
pimenta officinalis	fusiform aneurysms	0
strawberry	crib death	0
aspalathus linearis	amyotrophic lateral sclerosis parkinsonism dementia complex 1	0
dioscorea villosa	neoplasia	0
pineapple juice	chronic b-cell leukemia	0
bellis	neurologic degenerative condition	0
orange tree	temporal region trauma	0
milk thistle	barrett's esophagus	0
black currant	fusiform aneurysms	0
mango	ms (multiple sclerosis)	0
true nut	insulin dependent diabetes mellitus 1	0
lemon grass	vaginal discharge	0
vaccinium angustifolium	muscle spasms	0
vaccinium uliginosum	intention tremor	0
turmeric	autosomal dominant. juvenile parkinson disease	0
carya illinoensis	primary growth hormone resistance	0
stuff	hip fractures	0
split peas	transmissible spongiform encephalopathies	0
squash seeds	a-v dissociations	0
processed apples	retained surgical sponges	0
psidium guajavas	increased cancer	0
citrus hystrix	eye diseases	0
soy beverages	fine tremors	0
little saffron	recurrent low back pain	0
soy cheeses	acute myeloid leukemia	0
althaea officinalis	hepatitide	0
foeniculum vulgares	aortic aneurysms	0
capparis	diverticulosis	0
toronja	renal insufficiencies	0
gmo soybeans	migraine variants	0
green peppers	familial parkinson disease	0
diospyros digynas	malignant epithelial tumor	0
fast foods	abdominal obesities	0
prunus salicinas	dementia praecox	0
deli meat	infantile obesity	0
common plant	somatotropin hypersecretion syndrome (acromegaly)	0
drinking water	ciguatera	0
cultivated oat	postpartum sterility	0
amomum cardamomums	philadelphia-negative myeloid leukemia	0
nori	cerebrovascular accident	0
foenumgraecum	arthrose	0
almond butter	mesothelioma	0
crunch berries	mixed lymphocytic-histiocytic lymphoma	0
food supplement	b cell leukemia	0
conventional food	central nervous system degenerative diseases	0
garcinia mangostanas	papillomaviridae	0
official vitamin	benign prostatic hypertrophy	0
fenugreek	human influenza	0
soft drinks	paraesophageal hiatal hernias	0
chili peppers	degenerative arthritis	0
plant zygotes	secondary fibromyalgia	0
refined olive	human papilloma viruses	0
chicken meat	acquired immuno deficiency syndrome	0
processed meats	low-grade lymphoma	0
kaffir lime	anoxemia	0
worldwide fruit	mental disorders	0
fast food	fatty liver	0
chinese cassias	uveitide	0
ephedras	symptom clusters	0
sell meat	cerebral convexity meningioma	0
triticum	ciliary neuralgia	0
tangerine tree	crohn’s disease	0
syzygium sandwicense	juvenile parkinsonisms	0
jalapeno pepper	small noncleaved-cell lymphoma	0
eugenia malaccensis	fibrous meningiomas	0
oolong	mottled enamels	0
jalapeno	inherited human transmissible spongiform encephalopathies	0
radicchio	breast tumor	0
white mallow	cardiogenic syncope	0
saint john wort	ankylosing spondyloarthritis	0
olive trees	ovary cancer	0
baby spinach	apoplexy	0
added sweeteners	unilateral headache	0
baby formulas	inhibit cancer	0
hot sauce	barrett's esophagus	0
oats	psoriase	0
black sapotes	bechterew's disease	0
lens culinari	high-grade lymphomas	0
camomile	primary gh resistance	0
flavourer	lymphocytic lymphomas	0
pummelo tree	bipolar affective psychoses	0
raphanus	reticulum-cell sarcomas	0
mirobalanus embilica	effort syncope	0
seville orange tree	bovine lymphosarcomas	0
rheum officinale	cvas (cerebrovascular accident)	0
saint john's wort	creutzfeldt-jakob syndrome	0
pimpinella anisum	gale deficiency	0
specific cheeses	ketosis prone diabetes mellitus	0
rubberplant	heat stroke	0
emblica officinali	acute inflammatory polyneuropathies	0
drinking milk	autosomal dominant parkinsonism	0
glycine max	subtrochanteric fractures	0
maize	ciguatera fish poisonings	0
caper	prostate cancer	0
justicia adhatoda	diabetic mononeuropathy simplices	0
cayenne peppers	gasser's syndrome	0
no noni	guillaine barre syndrome	0
acai berry	sinusitis	0
probiotic	menstrual pain	0
brewed coffee	insulin dependent diabetes mellitus	0
molasse	eczematous dermatitis	0
no-calorie sweeteners	cognitive dysfunctions	0
sour orange tree	convulsive syncope	0
bhang	multiple myositis	0
brinjal	weight gain	0
dietary fat	mixed-cell lymphomas	0
asparagus	huntington’s disease	0
chinese cinnamons	early detection of cancer	0
chard	back pain without radiation	0
dinner times	intermittent tremor	0
abelmoschus	endometrial cancers	0
chinese yam	human immunodeficiency viruses	0
iv vitamin	peripheral artery disease	0
horse beans	venereal wart	0
unfertilized eggs	overeat	0
morning meals	clear cell meningiomas	0
cocoa	memory disorders	0
soda pop	hepatocellular cancers	0
drinking orange	bacterial infection	0
purple rice	cerebral strokes	0
salad	wound botulism	0
wild bananas	pharyngitis	0
boiled broccoli	autoimmune condition	0
chewing gums	parasagittal meningioma	0
cured meat	halitose	0
bottled water	parkinsonian diseases	0
broccoli	transmissible spongiform encephalopathy	0
pinto beans	chronic b-cell leukemias	0
ribes nigrum	head traumas	0
healthy snacks	foreign objects	0
olive tree	arthropathy	0
collard greens	chronic fatigue syndrome	0
food company	complications of diabetes mellitus	0
rhubarb	stomatognathic diseases	0
althaea	newborn gynecomastia	0
willow tree	penile neoplasm	0
sweetening agents	acute stroke	0
raphanus raphanistrum	cervix neoplasm	0
decaf	senile paranoid dementia	0
floret	saturnine tremor	0
wild celeries	neuralgic migraines	0
phaseolus vulgaris	transitional meningiomas	0
java plum tree	well-differentiated lymphocytic lymphoma	0
pumpkin seeds	colitis gravis	0
healthiest vegetable	zoonotic infectious disease	0
blossom	cancer of colon	0
marihuana	ankylosing spondyloarthritis	0
soy yogurt	primary fibromyalgias	0
papaya	central obesities	0
dietary proteins	acromegaly	0
fagopyrum esculentum	painful menstruation	0
piper methysticums	genital warts	0
daily nut	posterior fossa meningioma	0
monosodium glutamate	spondyloarthritis ankylopoietica	0
allium cepa	acute cerebrovascular accident	0
fruit and vegetable juices	rectum cancer	0
cassia	fusiform aneurysm	0
plantago ovata	tumor of rete testis	0
holy basil	cardiac sudden death	0
assai palm berries	postviral fatigue syndrome	0
rheum rhaponticum	peripheral artery diseases	0
mastic trees	sprains and strains	0
nonfat meal	mixed lymphoma	0
citrus-based fruits	peanut allergies	0
theobroma cacao	cerebrovascular stroke	0
amlas	amyloidosis	0
baby formula	hysterical amnesias	0
mackerel	chronic fatigue-fibromyalgia syndrome	0
kombucha teas	cancer of vulva	0
cooked broccoli	cancer of the skin	0
caryophyllus	central obesity	0
solanum laciniatum	age-related macular degeneration	0
tomato sauce	foreign body	0
flavorer	hip fractures	0
crowberry	retroviridae	0
carbonated beverage	neurotic anxiety state	0
soy milk	reticuloendotheliosis viruses	0
cola nitida	bilateral headache	0
red meats	viral infections	0
grecian foxgloves	autosomal recessive parkinsonism	0
clove	ovarian neoplasm	0
curried tofu	neurodegenerative disorder	0
seltzer waters	sudden-onset diabetes mellitus	0
cassia fistula	galactokinase deficiency disease	0
purslane	brain neoplasms	0
banana plants	vulvar cancer	0
nitrate-rich vegetables	horton syndrome	0
prunus armeniaca	ph1-negative myelogenous leukemia	0
healthier meat	cardiac arrhythmias	0
favorite meals	remittent fever	0
hibiscus sabdariffa	blood clot	0
cooked carrots	heat stroke	0
chile pepper	ductal carcinomas	0
tomato juice	viral diseases	0
solanum dulcamaras	non hodgkins lymphoma	0
ananas	deafness	0
coconut oil	testicular cancers	0
component spices	secretory meningiomas	0
veggie	heatstroke	0
apple tree	prion disease	0
gui zhi	metastasis	0
fresh fruits	male breast neoplasm	0
chilli peppers	chronic b-cell leukemia	0
vaccinium corymbosum	brain cancer	0
sour cream	perioral tremor	0
phyllanthus emblica	male breast neoplasms	0
caffeinated coffee	common cold	0
pineapple	cardiovascular diseases	0
poenumgraecum	oral neoplasms	0
carbonated mineral waters	mouth and tooth diseases	0
sweet orange	joint diseases	0
pepsi	infantile obesity	0
euterpe oleracea mart.s	parkinson's disease	0
coca	gastro-esophageal reflux	0
lactuca sativa	sciatic neuralgia	0
carya	macular degenerations	0
dried fruits	cardiovascular diseases	0
cassia trees	todd paralysis	0
cuminum	peripheral arterial disease	0
yellow vegetables	cot death	0
table salt	plasmodium infections	0
gravy	mild cognitive impairment	0
sauerkraut	kidney diseases	0
fresh basil	chronic daily headache	0
healthiest foods	sid	0
tulsi tea	hot flashes	0
drinking coffee	nbcc	0
rose	motor seizure	0
hypericum perforatums	neonatal tremor	0
agaricaceae	angiomatous meningioma	0
cantaloupe	postural syncopes	0
deli meats	secondary fibromyalgia	0
smoked foods	familial atrial fibrillations	0
hickory nut	abdominal obesity	0
berberis	acute infectious polyneuritis	0
common bean plants	throbbing headaches	0
humulus lupulus	small and large cleaved-cell lymphoma	0
banana plant	benign neoplasm	1
dinnertime	foreign bodies	0
cherry plum tree	high grade lymphoma	0
aquatic food	malignant meningiomas	0
guacamole	visual seizure	0
herbal tea	deep-vein thromboses	0
psidium	jakob creutzfeldt disease	0
euterpe precatoria	darkness tremor	0
sea vegetables	lav-htlv-iii	0
cannabis indica	pancreas cancer	0
bertholletia excelsa	post traumatic osteoporosis	0
whole grain cereals	auriculo-ventricular dissociation	0
moose meat	esophagitide	0
higher vegetable	spondyloarthritis ankylopoietica	0
elephant garlic	uveitis	0
triticum spelta	polymyositis ossificans	0
citrus sinenses	subfertility	0
shorten	intertrochanteric fractures	0
ready-prepared foods	disorientation	0
indian corn	resting tremors	0
maple syrup	blood clot	0
retail poultry	retained surgical item	0
salmonella-infected eggs	lewy body parkinson's disease	0
tepary beans	ischemia	0
osmanthus tea	histamine cephalgias	0
individual candy	sleep-related neurogenic tachypnea	0
prosopi	kidney neoplasm	0
pea	acquired immunodeficiency syndrome	0
cereal	lower back pains	0
deep-fry foods	substance dependence	0
plantago arenaria	familial atrial fibrillation	0
ale	intractable headaches	0
allium sativum	mental disorder	0
not-necessarily-so-healthy foods	infantile autism	0
cherry plum trees	t viruses	0
fresh ginger	diabetes mellitus complications	0
hordeum vulgare	bladder cancers	0
cheese	preventing cancer	0
majorana hortensis	substance use disorders	0
food supplements	rachitis	0
purple cabbage	cancer of the bone	0
syrup	insulin-dependent diabetes mellitus	0
vegetable oil	prostate cancer	0
illicium verum	exudative bronchiolitides	0
dietary plant proteins	small round-structured viruses	0
pistacia vera	mouth neoplasm	0
scallion	spinal cord disease	0
natural vitamin	drug addiction	0
wild radish	vertex headache	0
tempeh	morning sickness	0
usda poultry	autosomal dominant juvenile parkinsonism	0
cuminum cyminums	schizophreniform disorders	0
frozen cranberries	penis neoplasm	0
specific foods	resting tremors	0
horse nettle	cancer of bone	0
apple	tying disease	0
bean sprout	leukovirus	0
food allergies	oral disease	0
dandelion	mouth neoplasm	0
assai palms	minor head injuries	0
regular olive	olfaction disorders	0
big meals	ankylosing spondylarthritides	0
own vitamin	meningotheliomatous meningiomas	0
lunch time	colon cancer	0
artificial butter	stomach ulcers	0
tofu	auriculo-ventricular dissociation	0
narrow-leaved plantain	pancreas cancer	0
nut bar	postoperative nausea and vomiting	0
cannabi	food hypersensitivity	0
petroselinum crispum	rectal neoplasm	0
cherry	brain neoplasms	0
dairy eggs	undifferentiated carcinomas	0
safflower oil	visceral obesities	0
sugar	virus	0
potato chips	tumorigenesis	0
white mallows	low-grade b-cell malignancy	0
thymus vulgaris	drug use disorders	0
chocolate	animal viruses	0
phaseolus acutifolius	tactile amnesias	0
raw cranberries	virus infections	0
maize oil	tonsillar cancers	0
cinnamomum trees	lung cancers	0
bertholletia	arrythmia	0
spice saffron	cancer of testis	0
corn oil	esophagus neoplasms	0
kenaf	rhabdomyolys	0
preserved food	cat leukemia viruses	0
cleistocalyx	spinal cord diseases	0
sweet marjoram	treat cancer	0
emphasize plant	testis cancer	0
individual food	psychophysiological insomnia	0
legume pods	left-sided heart failure	0
grape	gall bladder diseases	0
mentha spicatas	macular dystrophy	0
red delicious apples	alopecia cicatrisata	0
vodka	muscle soreness	0
citrus fruit	fibroatheromatous plaque	0
purple grape	aphthous stomatitis	0
dessert	common cold	0
french fries	esophageal cancers	0
soda waters	gastroenteritide	0
dried food	foreign object	0
erythroxylon	hereditary galactokinase deficiencies	0
arachis	single seizure	0
citrus reticulatas	spiral fractures	0
regular carrots	disk degeneration	0
empty calorie foods	visual seizure	0
hickory nuts	gastric cancer	0
brassica napus	polymyositide	0
plant-based nutrients	cancer of bladder	0
animal-based foods	intervertebral disk degeneration	0
tomato	age related bone loss	0
prunus dulcis	dyschezia	0
calendula officinali	endocrine breast disease	0
foie gras	carotid sinus syncopes	0
spicy food	diffuse mixed-cell lymphoma	0
golden glow	virus diseases	0
catfish	zoonotic infectious disease	0
alfalfa sprout	tying disease	0
citrus	non-b hepatitis enterically-transmitted non-a	0
ocimum basilicum	social anhedonias	0
sweet basil	chronic airflow obstruction	0
cucumis sativus	experimental lung inflammation	0
fortify milk	cancer of the tongue	0
lemon trees	cranial pain	0
dark meat	anthrax	0
euterpe	paraosmia	0
ceratonia	sea sickness	0
chai tea	breast carcinoma	0
convenience food	fifth phacomatosis	0
red pepper	small-cell lymphomas	0
raisin	male breast carcinoma	0
sugar substitute	diabetes-related complications	0
leaf lettuce	malignant epithelial tumors	0
alcoholic beverage	postoperative emesis	0
chicken	liver steatoses	0
sun-dried raisin	cvas (cerebrovascular accident)	0
elettaria cardamomum	deep venous thrombosis	0
organic meat	cancer of rectum	0
mint	cranial pain	0
macadamia nuts	cancer of pancreas	0
brussel sprout	acquired immunologic deficiency syndrome	0
sandwich	birth defect	0
green tea	lung neoplasms	0
olive family	variant creutzfeldt jakob disease	0
mirobalanus embilicas	fibrocystic breast disease	0
pomelo tree	malignant epithelial neoplasms	1
triticum turgidum	breast neoplasms	0
mangiferas	myocardial infarction	0
laciniate nightshades	amyloid deposit	0
experience food	tonsil neoplasms	0
bran flakes	rectal tumors	0
soy food	brain tumor	0
pistacia	bilateral sciaticas	0
syzygium	degenerative disease	0
weekly meat	cancer of the skin	0
eating broccoli	posterior fossa meningiomas	0
lens plant	senile plaque	0
anise seed	gastric acid reflux	0
canned foods	auricular fibrillations	0
opium poppy	confusion	0
myristica fragran	amyloidosis	0
brain-invasive pork	coronary heart disease	0
raw broccoli	macular degenerations	0
eggnog	neurodegenerative disorder	0
frying meat	male subfertility	0
nightshade	alactasia	0
malus domestica	uterine cancer	0
brew	acquired immunologic deficiency syndrome	0
antioxidant foods	familial atrial fibrillation	0
marjoram plant	psychophysiological insomnia	0
porphyra	basal cell carcinoma	0
seed	breast carcinoma	1
anana	juvenile parkinsonism	0
licorice root	chronic disease	0
california avocado	iodine deficiency	0
ground beef	liver disease	0
exotic fruits	amnestic states	0
edible grains	seasickness	0
butter	cardiac dysrhythmia	0
hamburger	retained surgical items	0
dried apple	vaginal discharge	0
lentil	eczematous dermatitis	0
reindeer meat	syncopal vertigos	0
red rice	alzheimer’s disease	0
cocos nucifera	undifferentiated carcinomas	0
citron tree	malignant brain neoplasm	0
syzygium jambolanum	human immunodeficiency virus	0
pithecolobium	asymmetric diabetic proximal motor neuropathy	0
eating almonds	penile cancers	0
brussels sprouts	human papilloma viruses	0
red lentils	leukemogenic viruses	0
illicium anisatums	ciguatera poisonings	0
plant capsules	zoonotic disease	0
barberry	neoplasm	1
ultra-processed food	pulmonary neoplasms	0
hemlock	inflammatory bowel disease 1	0
drink tea	pulmonary disorder	0
canned food	esophagus cancers	0
green beans	bone cancer	0
raw meat	childhood onset obesity	0
low-sodium diet	intervertebral disc degeneration	0
cookie	rabies virus	0
whortleberry	gorlin syndrome	0
cinnamon	splitting pain	0
food poisonings	olfaction disorder	0
horse nettles	infectious mononucleosis virus	0
mustard seeds	acquired immuno-deficiency syndrome	0
common fruits	allergic reaction	0
kiwi fruit	heart block	0
cymbopogon nardus	scorbutus	0
poroporo	amnesia memory loss	0
green lentils	congenital myxedema	0
octopus	genital warts	0
overpriced vitamin	muscle disease	0
juglans regia	prion induced disorder	0
chili pepper	pyrexia	0
margarine	osteoarthritide	0
plum trees	physical suffering	0
nutmeg	forehead trauma	0
restructured meat	diabetic polyneuropathy	0
chipotle	hepatic neoplasm	0
coriander	virus diseases	0
healthy fruit	cancer of mouth	0
fungus	secretory meningioma	0
arugula	galactose-1-phosphate uridylyltransferase deficiencies	0
celebration meal	lead poisonings	0
faba bean	infectious virus	0
colocasia	esophageal neoplasm	0
squashe	visceral obesity	0
thymus vulgari	et-nanbh	0
healthy food	endometrium cancers	0
hemp plant	single seizures	0
cycad trees	acquired immune deficiency syndrome virus	0
nonus	ovary cancer	0
unfiltered coffee	acute cerebrovascular accidents	0
carob	bleed	0
lavandula	abdominal cramp	0
herr	menstrual disorders	0
artichoke	multiple sclerosis	0
tea hibiscus	cat leukemia virus	0
black tea	seasickness	0
indian laburnums	memory deficits	0
açai berries	mental disorders	0
peach trees	megacolon	0
pea family	intracranial meningioma	0
natto	breast neoplasm	1
skim milk	lymphadenopathy-associated virus	0
juglan	leukovirus	0
morinda	bronchial asthma	0
drinking tea	stomach cancers	0
tree nuts	mild neurocognitive disorder	0
saccharomyces cerevisiae	pleomorphic lymphoma	0
animal food	well-differentiated lymphocytic lymphomas	0
food companies	dyspepsia	0
uncooked foods	angiomatous meningioma	0
measuring food	emesis	0
food coloring	galactose 1 phosphate uridyltransferase deficiency	0
english plantain	galactosemia	0
elettaria cardamomums	migraine	0
soda pops	gall bladder diseases	0
spore	common bile duct biliary calculi	0
silken tofu	nonorganic insomnia	0
fenugreek seeds	secretory meningioma	0
raphanus sativus	constrictive bronchiolitis	0
bell pepper	rectal tumor	0
dairy yogurt	artery disease	0
frozen spinach	food-borne disease	0
topical ginger	benign brain neoplasm	0
consumed chocolate	iodine deficiency	0
milkshake	congenital defects	0
pimenta diocias	fibroid tumors	0
high fructose maize syrup	atherosclerotic plaque	0
dietary supplementations	paroxysmal atrial fibrillations	0
soy bean curd	right sided heart failure	0
kale	abdominal cramp	0
persimmon	low backaches	0
assai palm	gastroenteritide	0
trigonella foenum-graecums	indigestion	0
golden raisins	benign essential tremors	0
wheat	multiple meningioma	0
broccoli raab	sliding hiatal hernia	0
yerba mate	rachitis	0
citrus aurantiifolia	drug use disorder	0
mandarin orange trees	classic galactosemias	0
star anise	bladder disease	0
soy sauce	mild cognitive impairments	1
potato	vaginal discharges	0
hemp	ciguatera poisoning	0
citrus hystrices	somatotropin (acromegaly) hypersecretion syndrome	0
group foods	barrett's syndrome	0
shiitake	acute stroke	0
vaccinium macrocarpons	childhood onset obesity	0
black teas	schizophrenic disorders	0
mushroom	cancer of ovary	0
cooked tomatoes	torsion fractures	0
quinoa	inflammatory bowel diseases	0
pine nuts	painful menstruation	0
rosehip	lung inflammation	0
nut bars	gorlin syndrome	0
cooked meats	lyme borreliosis	0
eggplant	intervertebral disc degenerations	0
healthiest fruits	virus diseases	0
food manufacturers	udp-galactose-4-epimerase deficiency diseases	0
oxen meat	anticancer	0
brassica	palmoplantaris pustulosis	0
sesame	dyschezia	0
coconut milk	drug allergies	0
persea americanas	broken bones	0
whole grain	chronic fatigue and immune dysfunction syndrome	0
rubus fruticosus	penis neoplasms	0
glucose fructose syrup	transitional meningioma	0
hickory tree	prion protein diseases	0
amla	hypolactasia	0
hop	pulmonary cancer	0
solanum tuberosum	bses (bovine spongiform encephalopathy)	0
english plantains	cervical neoplasm	0
foeniculum vulgare	b12 deficiency	0
mealtime	reticulum-cell sarcomas	0
food allergy	ovarian neoplasm	0
linum usitatissimums	neurodegenerative disorders	0
jelly	hyperthermia	0
crataegus	intraorbital meningioma	0
decrease meat	tick bites	0
garden radish	retained surgical tools	0
kiwi fruits	gastric acid reflux disease	0
stevia	myelopathy	0
mock meats	spindle cell sarcomas	0
oreo	auditory seizures	0
parsley	lung neoplasms	0
solanum melongenas	diffuse mixed small and large cell lymphoma	0
pickled foods	chronic disease	0
raw poultry	fibrocystic mastopathy	0
romaine lettuce	strain	0
silybum marianums	hemolytic-uremic syndrome	0
dietary sucrose	ciguatera fish poisonings	0
zea	appendicitis	0
oryza	lav-htlv-iii	0
health food	somatotropin hypersecretion (acromegaly) syndrome	0
flax	hereditary galactokinase deficiencies	0
trigonella foenum graecum	familial tremor	0
secale	spongiform encephalopathies	0
infects apples	ischemic heart diseases	0
crataegus monogynas	inflammatory bowel diseases	0
whiting	nonalcoholic steatohepatitides	0
citrus bergamias	guam form of amyotrophic lateral sclerosis	0
mustard greens	rupture	0
shellfish	amyloidosis	0
cruciferous vegetable	histamine cephalgias	0
rubus idaeus	lichen ruber planus	0
calendula officinalis	visceral steatoses	0
century plant	postviral fatigue syndrome	0
andean blackberries	lewy body parkinson disease	0
longevity legumes	abdominal pain	0
food poisoning	guam form of amyotrophic lateral sclerosis	0
afzelia	diabetic polyneuropathies	0
wild yam	age-related bone losses	0
real chocolate	neoplasia	0
sea vegetable	dims (disorders of initiating and maintaining sleep)	0
dioscorea	cervical neoplasms	0
american meat	rectal tumor	0
no meat	somatotropin hypersecretion syndromes (acromegaly)	0
acer saccharums	aphthous stomatitides	0
tepary bean	reticuloendotheliosis virus	0
crabapple	leukemia	0
sour fruit	carotid sinus syncopes	0
amaranth	visceral steatosis	0
ground meat	neurodegenerative disease	0
target vitamin	urinary bladder neoplasm	0
nettle	spinal cord disorder	0
carbonated waters	short sleeper syndromes	0
chamomile	prion-induced disorder	0
delonix	allergic diseases	0
gluten-free diet	gastro-oesophageal reflux	0
restrict food	shock	0
healthiest apple	encephalon disease	0
macadamia	lewy body parkinson disease	0
curcuma longa	vaginitis	0
laudable legume	udp galactose 4 epimerase deficiency	0
snack food	cranial pains	0
lima beans	recurrence	0
cinnamomum cassia	reticulum-cell sarcoma	0
eugenia jambos	uterine cervical neoplasms	0
ice creams	sliding esophageal hernia	0
eugenia jambolana	parodontose	0
olea	car sickness	0
fermented cabbage	uveitide	0
plantain	post traumatic osteoporosis	0
chinese yams	mouth cancers	0
marshmallow	persistent tremor	0
garlic sauce	adenosis of breast	0
different seed	congenital hypothyroidism	0
fruit juices	sarcoma	0
cycad	toxico infectious botulism	0
norus	phlebothrombose	0
phaseolus	fibrous meningiomas	0
color	epithelioid sarcoma	0
taking vitamin	peripheral artery diseases	0
actual licorice	hypercholesteremia	0
blueberry	heat strokes	0
foeniculum	gasser syndrome	0
vaccinium virgatum	ulcerative colitis	0
narrow-leaved plantains	joint diseases	0
bagel	ekbom dermatozoic delusion	0
capsicum annuum	chronic fatigue fibromyalgia syndrome	0
peanut butter	hip fractures	0
handling food	chromosome 6 linked autosomal recessive parkinsonism	0
meal times	arrhythmia	0
filbert	mottled enamel	0
safflower	osteoporose	0
english walnuts	insulin dependent diabetes mellitus	0
prunus salicina	left sided heart failure	0
chinese cinnamon	uterine cervical neoplasms	0
zucchini	premenstrual tensions	0
mangifera indicas	parietal region trauma	0
sea bilberry	pattern baldness	0
rooibos tea	hyperventilation syncope	0
celery root	plegia	0
turnip	menstrual pain	0
durum wheat	memory disorders	0
treat	intention tremor	0
atropa belladonnas	gnathostomiase	0
kohlrabi	familial guillain-barre syndrome	0
eating meat	paroxysmal atrial fibrillation	0
bitter orange tree	acquired immuno deficiency syndrome	0
pureed apples	male sexual impotence	0
food and drug administration	symptom cluster	0
pudding	benign neoplasms	0
morel	intervertebral disc degeneration	0
cicer	hepatitide	0
marsh mallow	poultry viruses	0
adding blueberries	asymmetric diabetic proximal motor neuropathy	0
raspberry	macular degenerations	0
crab apples	poisoning	0
table sugar	gastroenteritis	0
biometal	back pains	0
dried apricots	lung inflammations	0
pepper	lichen planus	0
zinger tea	guam form of amyotrophic lateral sclerosis	0
origanum	sudden-onset diabetes mellitus	0
sustenance	renal cancers	0
fava beans	ocular headaches	0
nicotiana	aortic aneurysms	0
poppy seed	myeloma-multiple	0
use sweeteners	numbness	0
virgin olive	pulmonary thromboembolisms	0
norovirus food	syndrome	0
jambolan plum tree	foodborne illnesses	0
prunus cerasifera	status migrainosus	0
brewage	cluster headache syndrome	0
know nuts	hemicrania migraines	0
rise	bovine leukemia virus	0
sweetleaf	androgenetic alopecia	0
squash	foodborne botulism	0
powdered sugar	sunburn	0
rose hips	cephalodynia	0
largest meal	perioral tremor	0
aspartame	iddm	0
msg	benign prostatic hypertrophy	0
humulus	acute confusional migraines	0
big food	air sickness	0
carbonated beverages	hepatic failure	0
sugar maples	mouth cancers	0
allspice	appendicitis	0
organic plants	endometrioma	0
pistachio nut trees	vaginal discharges	0
mentha x piperita	utp hexose-1-phosphate uridylyltransferase deficiency	0
mentha piperita	rickets	0
euchresta	polyp	1
sweet almonds	pregnancy pernicious vomiting	0
cocoa plant	hyperemesis gravidarum	0
almond trees	postpartum sterility	0
ketchup	increased cancer	0
venison	heart diseases	0
soybean proteins	anemia	0
wild yams	mental deteriorations	0
citrus bergamia	human t-cell leukemia virus type iii	0
liquorice	social anhedonias	0
breakfast times	bovine lymphosarcomas	0
earl grey tea	hypesthesia	0
tobacco	premature birth	0
corn syrup	udp-galactose-4-epimerase deficiency disease	0
mustard plant	intracranial meningiomas	0
ocimum tenuiflorum	familial tremor	0
plant aril	steatohepatitis	0
potassium-rich foods	ekbom delusory parasitosis	0
carrot	status migrainosus	0
fig	chronic fatigue fibromyalgia syndrome	0
serve	allergic diseases	0
maguey	age related macular degeneration	0
placenta	contusion	0
mustard oil	deglutitional syncope	0
scrambled eggs	schizoaffective disorders	0
garcinia mangostana	neuritic plaques	0
pretzel	post-traumatic osteoporosis	0
ranking foods	clonic seizures	0
teosinte	breast neoplasm	0
linum	salmonella infections	0
white tea	blood cancer	0
sweet potatoes	renal failure	0
soy	manic depressive psychoses	0
jelly beans	brain malignant neoplasm	0
sea food	deep-vein thrombosis	0
dried peas	emphysema	0
piper nigrum	prion-induced disorders	0
energy drinks	anaplastic carcinoma	0
paprika	arthrose	0
fries	vulva neoplasm	0
marjoram plants	subwakefullness syndromes	0
chili	sexual dysfunction	0
jasmine tea	secondary fibromyalgia	0
gala apples	granulomatous colitis	0
four nuts	rete testis tumors	0
cucurbita	chronic gum disease	0
frozen fruit	pregnancy pernicious vomiting	0
triticum vulgare	chicken viruses	0
specific nuts	paludism	0
raw foods	chronic fatigue disorder	0
coriandrum sativums	substance use disorders	0
bergamot	parkinsonian syndrome	0
saffron	gastric cancers	0
oolong tea	neurologic degenerative disease	0
lavender	thinness	0
syzygium jambos	acute monoblastic leukemia	0
portulaca oleracea	spindle cell sarcomas	0
new york coalition for healthy school food	guam form amyotrophic lateral sclerosis	0
indian gooseberries	colicky pains	0
daily fruit	hysterical blindness	0
betel nut	intervertebral disk degeneration	0
fake meat	menstrual disorders	0
cocoa butter	kidney failures	0
breast milk	carotid sinus syncopes	0
teff	contagious pustular dermatitides	0
antioxidant-rich foods	auto-immune diseases	0
candy	heart blocks	0
citrullus	head pain	0
vitis	scurvy	0
triticum turgidum subsp. durum	histamine cephalgias	0
dietary fats	heatstroke	0
callerya	liver cancers	0
zingiber officinales	human t cell lymphotropic virus type iii	0
wild celery	amyotrophic lateral sclerosis motor neuron disease	0
healthiest snack	neuritic plaques	0
marjoram	lymphocytic lymphomas	0
dietary fiber	plasma cell myeloma	0
red meat	breast malignant neoplasm	1
euterpe edulis	benign prostatic hyperplasia	0
fennel seeds	human papilloma virus	0
milk protein	disorder	0
antioxidant-rich food	hyperthermia	0
oregano	fibroatheroma	0
eat flax	disk degenerations	0
haritaki fruit	central obesity	0
iceberg lettuce	baldness	0
silybum marianum	cll lymphoplasmacytoid lymphomas	0
tangerine trees	action tremor	0
offal	inappropriate gh secretion syndrome (acromegaly)	0
lettuce	senile plaque	0
high fructose corn syrup	uterine neoplasm	0
tap water	steatohepatitis	0
convenience foods	well differentiated lymphocytic lymphoma	0
kawa kawas	nontropical sprue	0
dairy product	glaucoma	0
high-fructose corn	pituitary dwarfism iis	0
black coffee	psammomatous meningiomas	0
chinese food	pyrexia	0
fructose corn	cystic breast disease	0
hummus	infectious virus	0
coca cola	colitis	0
curcuma longas	neurologic degenerative diseases	0
safflower oils	prostate neoplasms	0
poultry products	hemicrania migraine	0
assai palm berry	atherogenesis	0
avoid peanuts	central obesity	0
tarragon	colonic cancers	0
carica papayas	lou gehrig disease	0
boiled eggs	creutzfeldt-jakob syndrome	0
steamer	spindle-cell carcinomas	0
cynara scolymus	reproductive sterility	0
kola nut	gastric cancers	0
antioxidant fruits	multiple myositides	0
nutrient-dense foods	causes cancers	0
organic foods	malignant epithelial tumors	0
poppy	adolescent obesity	0
citrus fruits	cervicitis	0
brazil nut tree	peanut allergy	0
green teas	age related macular degeneration	0
glycyrrhiza glabra	palsy	0
anacardium occidentales	gastro esophageal reflux	0
tea plant	gall stone	0
carica	single seizure	0
vegetable proteins	ph1-negative myelogenous leukemia	0
diospyro	myeloma-multiple	0
texturized vegetable proteins	perforated appendicitis	0
vitamin pills	preventable cancers	0
legume family	myelomatose	0
jalapeno peppers	human immunodeficiency viruses	0
chenopodium quinoa	liver diseases	0
soya milk	bladder diseases	0
cultivated radish	marek's disease virus	0
woodland strawberry	skin cancers	0
sunfish	infant gynecomastia	0
zedoary zedoarias	inhibit cancer	0
flax seeds	celiac disease	0
sushi	carsickness	0
rooibo	liver diseases	0
dietary soybean proteins	acute autoimmune neuropathy	0
hemp plants	huntingtons disease	0
japanese plum	small cleaved cell lymphoma	0
acer	peripheral arterial diseases	0
ready-prepared food	bilateral deafness	0
cranberry juice	scorbutus	0
anise	temporal region traumas	0
allium porrum	liver neoplasm	0
lemon balm tea	mixed lymphocytic-histiocytic lymphoma	0
diabetic diets	sensory seizure	0
ultra-processed foods	leukemia	0
potable water	human t-lymphotropic virus type iii	0
toxic plants	sudden infant death	0
dog rose	age-related macular degenerations	0
orange juice	testicular tumors	0
acer negundo	human t cell lymphotropic virus type iii	0
arginine-rich foods	sharp headaches	0
chickpea	spondylarthritis ankylopoietica	0
citrus limon	granulomatous enteritis	0
arecas	diabetes related complications	0
plantago lanceolata	idiopathic parkinson disease	0
spaghetti	common cold	0
black currants	chromosome 6-linked autosomal recessive parkinsonism	0
vegetable juice	suppuration	0
vinegar	nervous system degenerative diseases	0
family vegetables	skin neoplasm	0
nut	cancer of vulva	0
grilled meat	uterine neoplasm	0
punicaceae	hemangioblastic meningiomas	0
almond	cancer of the liver	0
molasses	precordial catch syndrome	0
concord grape	sliding esophageal hernia	0
copaifera	galactose-1-phosphate uridyl-transferase deficiency disease	0
sesame oils	ischemic heart diseases	0
incorporates cloves	malignant brain neoplasm	0
collard green	gastric ulcers	0
french bean plant	skin disease	0
pimenta diocia	diffuse small cleaved-cell lymphoma	0
hot pepper	premenstrual syndromes	0
apple juice	gall stone	0
goji berry plant	burning pains	0
black walnut	convulsion	0
bamboo shoots	senile paranoid dementias	0
white meat	cancer of the stomach	0
brown rice	ulcerative colitis type inflammatory bowel disease	0
neutraceutical	menstrual pain	0
no coffee	prion disease	0
carbonated water	memory deficits	0
multivitamin	cardiac diseases	0
rutabaga	cll lymphoplasmacytoid lymphoma	0
international nut	endothelial dysfunction	0
citrus reticulata	head injuries	0
steak	abdominal obesities	0
bitter nightshade	bladder diseases	0
plant embryos	chronic b lymphocytic leukemia	0
common foxglove	sore throat	0
processed meat	bowel diseases	0
happy meal	bacterial infections	0
spinacia oleracea	kidney neoplasm	0
lunchtime	drug hypersensitivity	0
meal	thyroid cancers	0
high-fat meal	microcephaly	0
chamomile tea	pancreatic cancer	0
ginger	manic depressive psychoses	0
blueberry plants	familial tremor	0
marsh mallows	transitional meningiomas	0
dinner	endocrine breast disease	0
grapefruit juice	tick bite	0
ground ginger	rabies virus	0
include flaxseed	necrotizing fascitides	0
punica granatums	congenital abnormalities	0
glycyrrhiza	ulcerative colitis type inflammatory bowel disease	0
eragrostus	endometriosis	0
nutriceutical	joint diseases	0
raw food	small cleaved-cell lymphoma	0
granny smith	drug allergies	0
spinach	disk degradations	0
artificially-flavored corn	reticulum cell sarcoma	0
turkey meat	degenerative neurologic diseases	0
saint johns wort	spondylarthritis ankylopoietica	0
salami	episodic cluster headaches	0
ready prepared foods	common cancer	0
woodland strawberries	dripped virus	0
pomegranate fruit	senile osteoporoses	0
apium graveolens var. rapaceum	brain malignant neoplasm	0
pea families	vertiginous seizure	0
wort	chronic disease	0
citrus medicas	hiccup	0
cucumis melo	irritable bowel syndrome	0
sugar-sweetened beverages	undifferentiated carcinoma	0
purine-rich plant	atrioventricular dissociation	0
deep-fried foods	horton syndrome	0
licorice	uterine neoplasm	0
rheum	benign neoplasms	0
althea officinalis	deep-venous thrombosis	0
swordfish	als (amyotrophic lateral sclerosis)	0
inadequate fruit	malignant epithelial neoplasm	0
jam	hormonal dysfunction	0
processed food	gynecomastia	0
hordeum	vestibular seizure	0
sticker	wart	0
cider	diabetes-related complication	0
actual fruit	prostatic intraepithelial neoplasms	0
red wine	muscle spasm	0
acer saccharum	neurologic degenerative conditions	0
cereal grain	kidney neoplasm	0
fresh meat	soft tissue sarcomas	0
endive	diabetic neuropathies	0
corylus	cervical cancer	0
citrus aurantiums	endometrial cancer	0
citrus medica	cognitive retention disorders	0
espresso	cancer of stomach	0
opium poppies	human herpesvirus 4	0
lunch times	protein deficiency	0
high-phytate foods	plasmodium infection	0
black rice	spinal cord disorder	0
dioscorea opposita	nonalcoholic fatty livers	0
added nuts	chronic lymphoblastic leukemia	0
pimpinella	low back aches	0
ocimum basilicums	psoriasis	0
pumpkin pie	ductal carcinomas	0
domestic fowls	avian leukosis/sarcoma virus	0
cabbage	spinal cord disorders	0
plantago seed	multiple myelomas	0
cappari	nephrolith	0
garbanzo	symptom clusters	0
elettaria	primary brain neoplasms	0
bean sprouts	fibrose	0
calendula	bovine leukosis	0
bread mold	perioral tremors	0
chanterelle	cancer of the vulva	0
ganja	cancer of the penis	0
cola	hypercapnia	0
tuna	age related maculopathies	0
walnut oil	papillomaviridae	0
laciniate nightshade	recurrent brain tumor	0
texturized vegetable protein	periorbital headaches	0
butter milk	eczema	0
common olive tree	high blood pressure	1
citrus grandi	vaginal neoplasm	0
oatmeal	intertrochanteric fractures	0
fruit juice	alactasia	0
trompillo	high-grade lymphomas	0
cilantro	male breast tumor	0
retail meat	gerd	0
chocolate bars	monoblastic leukemia	0
white bread	prostatic intraepithelial neoplasms	0
nutritional yeast	encephalopathy	0
sweet foods	cardiac disease	0
oat	insulin deficiency	0
almond milk	tonic clonic seizures	0
banana	tumor	1
curcuma	creutzfeldt-jakob syndrome	0
philadelphia cream cheese	regional ileitides	0
greenery	galactose-1-phosphate uridyl-transferase deficiency disease	0
amomum cardamomum	back pains	0
cardamon	child obesity	0
cayenne	myalgic encephalomyelitis	0
vegetarianism	saturnine tremors	0
billion eggs	low grade lymphoma	0
fat foods	generalized seizures	0
trace elements	diabetes-related complications	0
trace minerals	stomatognathic disease	0
organic milk	bowel disease	0
pecan tree	situational syncopes	0
mangosteen	autosomal recessive juvenile parkinsonism	0
cayenne pepper	uterine fibromas	0
sweeten	oxygen deficiencies	0
medicago sativa	mesothelioma	0
açaí berry	temporary amnesias	0
chia seeds	tumor viruses	0
calling eggs	substance use disorder	0
healthy nuts	intermediate-grade lymphomas	0
roughage	tonic-clonic seizures	0
pimenta	pseudocoma	0
citrus paradisi	disorder	0
alpine strawberries	transmissible dementias	0
brassica nigra	psychosis	0
whole wheat	ekbom delusory parasitosis	0
anti-inflammatory plant	voice box cancer	0
secale cereale	udpglucose hexose 1 phosphate uridylyltransferase deficiency	0
lemon verbena	textiloma	0
illicium	age-related bone loss	0
soy proteins	male breast tumors	0
milk	bone fracture	0
olea europaea	dysfunction	0
berberi	paraosmia	0
healthiest nuts	drug abuse	0
red onions	hyperphagia	0
low-fat diet	crohn’s disease	0
dragon fruit	chronic airflow obstructions	0
domestic fowl	transmissible spongiform encephalopathy	0
red delicious	occipital traumas	0
unrefined plant	mental disorders	0
corn	sinusitide	0
honeybush tea	premenstrual syndromes	0
bean	hirsutism	0
toxic plant	vulvar cancers	0
poultry product	intracranial neoplasms	0
tv dinners	acquired immune deficiency syndrome	0
soy beans	leucocythaemia	0
corn oils	low back ache	0
vicia fabas	acne vulgaris	0