
snail meat	ciguatera fish poisoning	0
hordeum vulgare	post-traumatic osteoporosis	0
raphanus raphanistrum	esophageal neoplasms	0
dietary fibers	generalized seizure	0
iv vitamin	vagina neoplasms	0
legume pod	food borne diseases	0
trigonella foenum graecum	lymphadenopathy-associated viruses	0
callerya	colorectal tumor	0
so-called vegetable	upper respiratory infections	0
vicia faba	ciguatera	0
soy bean	stomach ulcer	0
antioxidant vitamin	hiccough	0
honeybush tea	deficiency disease	0
cocoa	abdominal aortic aneurysm	0
poultry meat	jakob-creutzfeldt disease	0
assai palm berry	drop attacks	0
crocus	galactose 1 phosphate uridyltransferase deficiency	0
noncaloric sweetener	creutzfeldt jacob disease	0
justicia	generalized seizures	0
vaccinium bracteatums	mouth cancers	0
sunchoke	utp hexose-1-phosphate uridylyltransferase deficiency	0
opium poppy	male sub fertility	0
soft drink	auditory seizure	0
garlic	memory disorders	0
cocktail	lichen ruber planus	0
horsenettle	disk degenerations	0
thymus plants	cystic disease of breast	0
popular fruits	pharyngitis	0
antioxidant food	diabetic mononeuropathy simplex	0
chocolate	infant botulism	0
noni fruit	papillary meningiomas	0
colophospermum	enzootic bovine leukoses	0
tobacco	philadelphia-negative myeloid leukemia	0
syzygium aromaticum	gastroesophageal reflux disease	0
seville orange tree	presyncope	0
bibhitaki fruit	endometrial neoplasm	0
purple rice	angiomatous meningioma	0
wheat	kidney insufficiency	0
soda waters	ciliary neuralgias	0
plant-based foods	mucous colitides	0
horse nettle	foodborne disease	0
green tea	high blood pressure	1
pineapple	prelingual deafness	0
bitter orange tree	diverticulitis	0
osmanthus tea	urinary bladder neoplasm	0
chile pepper	aortic aneurysm	0
frosting	jakob creutzfeldt disease	0
drink tea	glaucoma	0
lemon balm	ovary neoplasm	0
ocimum basilicums	t viruses	0
vegetable oil	infectious diseases	0
plantago indica	amyotrophic lateral sclerosis with dementia	0
euterpe precatoria	eczema	0
chard	mouth cancers	0
pistachio nut tree	mesothelioma	0
carrot juice	blv	0
dietary proteins	tongue neoplasm	0
corn oils	uveitis	0
pimpinella anisum	liver neoplasms	0
sugar substitutes	weight gains	1
carbonated water	low back pain	0
rubus idaeus	esophagus cancer	0
aspalathus linearis	liver cancer	0
jelly beans	muscle disease	0
candy bar	spinal meningioma	0
taraxacum	galactosemia iii	0
amygdalus communis	degenerative intervertebral disc	0
raw alfalfa	breast cancer	0
horsebean	recurrent low back pain	0
apium graveolens var. rapaceum	small round-structured viruses	0
soya milk	retroviridae	0
stevia rebaudiana	colicky pains	0
rowanberry	endometrial cancers	0
foxglove	birth weights	0
cardamon	pustular psoriasis of palms and soles	0
ginger	diabetic amyotrophy	0
açaí berries	weight reduction	0
prunus dulcis	gnathostomiase	0
aubergine	degenerative neurologic disease	0
monitoring food	bacteria-eating viruses	0
prunus salicinas	parkinsonian disorders	0
pistacia	carcinogenesis	0
anti-inflammatory foods	dental plaque	0
camomile	cardiovascular stroke	0
real chocolate	eczema	0
oolong tea	female subfertility	0
aspartame	chronic obstructive pulmonary disease	0
purslane	animal virus	0
texturized vegetable protein	confusion	0
liquorice	cluster headache syndrome	0
citrus medicas	megacolon	0
grouper	shock	0
origanum onites	age-related macular degeneration	0
foeniculum vulgares	infectious disease	0
coconut oil	cot deaths	0
spice turmeric	gout	0
rosemary	pyrexia	0
chinese food	epstein barr virus	0
food supplement	e-b viruses	0
anacardium occidentale	widespread chronic pain	0
common olive trees	foreign body	0
grapefruit juice	dysfunction	0
color	sore throat	0
wheatgrass	galactosemia iii	0
haritaki fruit	amnesia-memory loss	0
pecan tree	stomach neoplasms	0
medicago sativa	ciliary body spasm	0
orange tree	human cancer	0
ready-to-eat meal	muscular cramps	0
amomum cardamomums	hernia	0
atropa belladonna	car sickness	0
lettuce	endometrial carcinoma	0
suggesting fruit	intraepithelial prostatic neoplasia	0
arachis hypogaea	diabetic complication	0
berberis	sinusitide	0
crocus sativus	oncogenese	0
tomato sauce	overeat	0
beet	macular dystrophy	0
arachis	laron type dwarfism i	0
plantago seed	polyarthralgia	0
bertholletia	retained surgical items	0
apium graveolens var. dulce	food hypersensitivity	0
kiwi fruits	gasser's syndrome	0
cashew	orf	0
marsh mallow	ekbom delusory parasitoses	0
black raspberries	ankylosing spondylarthritis	0
espresso	udpglucose 4 epimerase deficiency disease	0
malus domestica	action tremor	0
solanum melongena	massive tremor	0
poppy seed	fibromyositis-fibromyalgia syndromes	0
illicium verums	crushing skull injury	0
citrus bergamias	sneeze	0
squash seeds	transmissible spongiform encephalopathy	0
cinnamomum zeylanicum	variant creutzfeldt jakob disease	0
pineapple juice	drug allergy	0
cod	spontaneous abortion	0
preserved foods	breast dysplasia	0
chinese cassia	nonalcoholic fatty liver disease	0
smoked food	liver cancers	0
favorite meals	confusional state	0
nitrate-rich vegetables	psychotic disorders	0
french bean plant	microglandular adenosis	0
prunus armeniaca	age related bone loss	0
tempeh	delusional parasitoses	0
infects apples	familial parkinson disease	0
citrus aurantium	mastitis	0
beta vulgari	muscle sorenesses	0
pork	angioblastic meningioma	0
roselle	influenza in human	0
alpine strawberry	sid	0
syrup	cognitive declines	0
citrus sinensis	huntington’s disease	0
proteus mirabilis	acute inflammatory polyneuropathies	0
hemp	hemicrania migraine	0
plantago ovata	galactosemia 3s	0
prebiotic	acute cerebrovascular accidents	0
fragaria	complete blindness	0
corn	primary fibromyalgias	0
oats	myocardial infarcts	0
veggie	seizure	0
yam	necrotizing fascitides	0
pummelo trees	adenovirus	0
rosehip	prediabete	0
chinese cinnamon	meningioma	0
dried yeast	hemorrhoid	0
cymbopogon nardus	epileptic seizures	0
billion eggs	testis cancer	0
dried pomegranate	diffuse lymphoma	0
vaccinium angustifolium	galactose-1-phosphate uridyl-transferase deficiency disease	0
venison	acute autoimmune neuropathy	0
healthy nuts	cvas (cerebrovascular accident)	0
ground ginger	human mammary neoplasm	0
bean sprouts	autosomal recessive juvenile parkinson disease	0
citron trees	social anxiety disorders	0
breast milks	cancer of cervix	0
marshmallow	cervix neoplasms	0
kombucha tea	dripped virus	0
cruciferous vegetable	multiple meningioma	0
sesame	semirhythmic tremor	0
soybean proteins	tonsillar neoplasms	0
zucchini	premature birth	0
french bean plants	bronchiolitide	0
healthiest beverage	amyotrophic lateral sclerosis parkinsonism dementia complex 1	0
low meat	dementia	0
black coffee	pancreatic cancer	0
cooking meat	marie struempell disease	0
pie	constipation	0
thymus plant	hypertension	0
acacia tree	human flu	0
dietary plant protein	manic states	0
cymbopogon	galactose-1-phosphate uridyl-transferase deficiency disease	0
goji berry plant	fibrocystic mastopathy	0
pickled foods	feline lymphoma virus	0
mustard plants	foodborne illnesses	0
red lentils	texidor twinge	0
squid	gastric neoplasms	0
dried apples	ocular headaches	0
tea	bone neoplasms	0
sweet basil	male pattern baldness	0
ilex paraguariensis	spindle cell sarcoma	0
guava	psoriase	0
experience food	type i diabetes mellitus	0
oolong	heart blocks	0
soymilk	relapse	0
sea bilberry	cancer of breast	0
tulsi tea	neurocysticercosis	0
jell-o	lou gehrig's disease	0
boiled broccoli	throbbing headache	0
plant capsules	fibrose	0
trompillo	acute monoblastic leukemias	0
sweet marjoram	parkinsonism dementia complex of guam amyotrophic lateral sclerosis	0
diospyros digynas	cancer of the skin	0
warm milk	transmissible dementia	0
thousand foods	limb tremors	0
baby spinach	mixed-cell lymphomas	0
osmanthus	sudden cardiac arrest	0
solanum dulcamara	reduced sensation	0
cocoa powders	inappropriate growth hormone secretion syndrome (acromegaly)	0
dietary sugars	brain diseases	0
energy drinks	transmissible dementia	0
syzygium malaccense	tonsillar neoplasms	0
berry	bladder disease	0
vaccinium macrocarpons	breast diseases	0
cherry	muscular cramps	0
peppermint	alopecia cicatrisata	0
garden radish	multiple myositides	0
solanum laciniatums	cerebral strokes	0
drink milk	groundnut hypersensitivity	0
meal times	landry-guillain-barre syndrome	0
sparkling waters	peripheral autoimmune demyelinating disease	0
reindeer meat	primary brain neoplasms	0
miso	lead poisoning	0
processed meats	unilateral headache	0
cannabis sativa	low back pain	0
neu5gc-rich food	food borne diseases	0
spice saffron	ekbom delusional parasitoses	0
star anises	left sided heart failure	0
baking chocolate	rna tumor viruses	0
lemon grass	cerebral strokes	0
juiced broccoli	fibromyalgia fibromyositis syndrome	0
plant embryos	cow disease	0
baby formulas	diffuse undifferentiated lymphoma	0
cooked meat	leucocythemia	0
crataegus	rete testis tumors	0
specific foods	endocrine breast disease	0
citrullus	mental deteriorations	0
sea bilberries	pneumonitide	0
prettiest fruit	psychotic disorders	0
nut	short sleep phenotypes	0
nettle	nerve tremors	0
extracted fruit	age related bone loss	0
sausage	brain neoplasm	0
ginger ale	colitide	0
carica papayas	muscular spasms	0
buckwheat	gluten sensitive enteropathy	0
cucurbita	postviral fatigue syndromes	0
eating food	bse (bovine spongiform encephalopathy)	0
lemongrass	gastric cancer	0
cranberry	tactile hypesthesias	0
drinking milk	foreign body	0
broad beans	crushing skull injuries	0
kombucha teas	tactile amnesias	0
linum	social phobia	0
tarragon	nonhodgkins lymphoma	0
nettle tea	phlebothrombosis	0
citrus x paradisi	torsion fractures	0
different fruits	olfactory seizure	0
vaccinium myrtillus	bronchiolitis	0
flaxseed	prostatic neoplasms	0
beverage	gastric cancers	0
include flaxseed	schizophreniform disorders	0
carbonated mineral water	barrett's syndrome	0
apple	iritis	0
cocos nucifera	sleep initiation dysfunctions	0
elettaria	hansen's disease	0
bagel	stokes adams syncope	0
green lentils	amnesia-memory loss	0
althaea officinalis	temporary amnesia	0
sweet potatoes	ankylosing spondylarthritides	0
yeast rice	hiv	0
texturized soy proteins	endometrial carcinomas	1
cranberry sauce	kidney neoplasm	0
acai berries	cervix neoplasm	0
mandarin orange trees	sneezing	0
nightshade	single seizure	0
amla	secondary fibromyalgia	0
basil	breast malignant neoplasm	0
ultra-processed foods	familial juvenile parkinsonism	0
morel	hemicrania migraine	0
butternut squash	memory disorders	0
walnut oil	bovine lymphomas	0
dairy products	age-related osteoporoses	0
box elders	bewilderment	0
food additive	oral cancer	0
artificial sweetener	lyssa	0
antioxidant-rich food	neurologic degenerative conditions	0
eggplant	acquired deafness	0
mangiferas	diabetes mellitus complications	0
erythroxylon	ph1-negative myeloid leukemia	0
paprika	intervertebral disk degeneration	0
lemon grasses	tumor viruses	0
mealtime	nonalcoholic steatohepatitis	0
drinking water	cluster headache syndrome	0
usda poultry	develop cancer	0
black teas	parkinson’s disease	0
soy beans	human t-lymphotropic virus type iii	0
toxic plant	zoonosis	0
elephant garlic	sore throat	0
kavas	zoonotic infections	0
pudding	small lymphocytic lymphoma	0
english walnut	proliferative bronchiolitis	0
anana	perioral tremor	0
punica granatums	parasagittal meningiomas	0
rise	encephalopathy	0
da huang	catarrh	0
golden delicious	new variant creutzfeldt-jakob disease	0
tv dinners	semirhythmic tremors	0
poultry product	deep vein thromboses	0
zedoary zedoarias	hemolytic jaundices	0
dried foods	periorbital headache	0
eating eggs	pediatric cancers	0
seven nutrients	thermal hypesthesias	0
little saffron	static tremor	0
treat	epstein-barr virus	0
shellfish	apneas	0
flax seeds	anthrax	0
pine nuts	sneeze	0
contaminated meat	oncogenesis	0
meal time	abdominal aortic aneurysms	0
blackberry	dental plaque	0
nut butters	gnathostoma infection	0
ground flax	insulin-dependent diabetes mellitus	0
sushi	alcoholism	0
worldwide fruit	familial parkinson disease	0
animal-based foods	barrett esophagus	0
cocoanut	drug allergy	0
celery	johne's disease	0
solanum melongenas	orf	0
leguminosae	kanners syndrome	0
octopus	foreign object	0
club soda	back pain without radiation	0
processing meat	cramp	0
high-fiber food	circulatory failure	0
cinnamomum verum	anxiety neuroses	0
sunflower seeds	hypertension	0
acer saccharum	spasm	0
tangerine trees	subacute spongiform encephalopathies	0
cynara scolymus	headache disorders	0
ephedra	androgenic alopecia	0
brown sugar	prostatic neoplasm	0
raw garlic	inflammatory disorder	0
punica granatum	human herpesvirus 4 (gamma)	0
crave chocolate	type c oncovirus	0
deep-fried foods	myalgic encephalomyelitis	0
capparis	acute monoblastic leukemia	0
stuff	barrett syndrome	0
japanese plum	degenerative intervertebral discs	0
sweetleaf	nonorganic insomnia	0
pisum sativum	membranous cataracts	0
syzygium cumini	pneumonia	0
fenugreek seed	disorder	0
linum usitatissimums	fibroadenoma	0
organ	breast fibrocystic change	0
low-calorie diet	pneumonitis	0
orange	autosomal recessive juvenile parkinsonism	0
biometal	heart block	0
know nuts	fibromyositis-fibromyalgia syndrome	0
dioscorea	gerd	0
snack	crohn's enteritis	0
agaricaceae	skin cancer	0
sweet almonds	dissociative amnesia	0
dietary fats	oral neoplasm	0
white mallows	psychophysiological insomnia	0
paella	todd's paralysis	0
stevia	cardiac diseases	0
fried foods	inflammation	0
phaseolus vulgari	ulcer	0
nutriceutical	myocardial infarction	0
mother cell	spondylarthritis ankylopoietica	0
olive oils	virus infection	0
citrus maxima	adenomatous polyps	0
black tea	stokes-adams syncope	0
lard	joint pains	0
andean blackberry	manic-depressive psychoses	0
milk chocolate	drug addiction	0
swiss chard	continuous tremor	0
stryphnodendron	chest pains	0
brassica napus	vaginal discharge	0
sticker	papillomaviridae	0
areca catechus	metastatic cancer	0
green peas	diffuse small cleaved-cell lymphoma	0
mango	intracranial cns disorders	0
acid-binding vegetables	age-related bone losses	0
shiitake mushroom	bacterial vaginoses	0
agave	age-related osteoporosis	0
onion	uveitide	0
bergamot	different cancer	0
alpine strawberries	breast malignant tumors	0
tofu	jakob creutzfeldt disease	0
glucose-fructose syrup	involutional osteoporosis	0
pistacia lentiscus	autosomal dominant juvenile parkinsonism	0
delonix	cardiovascular conditions	0
trace element	chronic daily headache	0
eugenia jambolana	substance dependence	0
chilli peppers	myalgic encephalomyelitis	0
diospyros digyna	galactokinase deficiency diseases	0
pomegranate fruit	muscle soreness	0
incorporates cloves	cow disease	0
dried peas	brittle diabetes mellitus	0
store licorice	schizophrenia	0
mentha spicata	malignant melanoma	0
sour orange tree	car sickness	0
navy beans	hypovolemic shock	0
purple grape	rheumatoid spondylitis	0
gravy	atrophy	0
milkshake	kanner's syndrome	0
crabapple	preventable cancers	0
grape	liver cancers	0
arugula	mastalgia	0
morinda citrifolias	hemangioblastic meningioma	0
abelmoschus esculentus	fatigue	0
atropa belladonnas	arthrose	0
flammulina	reticulum-cell sarcomas	0
lycium barbarum	obesity virus	0
different seed	diverticulosis	0
shorten	venous thrombosis	0
cacao bean	stokes-adams syncopes	0
hemlock	airsickness	0
beet greens	sleeplessness	0
fresh ginger	saturnine tremor	0
collard greens	udp-galactose-4-epimerase deficiency	0
jerusalem artichokes	pyrosis	0
confection	arthropathy	0
drink	static tremor	0
common bean plants	autosomal recessive juvenile parkinson disease 2	0
prunus persica	carcinogenic retroviruses	0
punicaceae	meningotheliomatous meningioma	0
capsicum	myocardial infarction	0
melissa officinali	early detection of cancer	0
eat chocolate	fine tremor	0
justicia adhatoda	neuritic plaque	0
cannabis indica	virus infections	0
acaí berries	mild neurocognitive disorders	0
junk food	regional ileitis	0
concord grape	carcinoma in situ	0
fries	age related memory disorders	0
kava	hypercapnia	0
raphanus	ruptured appendicitis	0
high fructose maize syrup	hyperpigmentation	0
chile peppers	cystic disease of breast	0
pumpkin	sterility	0
tap water	prediabetic states	0
sea food	colonic cancers	0
daily nut	esophageal neoplasms	0
smoked foods	renal neoplasms	0
sandwich	superficial head injuries	0
lens plants	cognitive decline	0
bamboo shoots	blood cancers	0
curry powder	drug addiction	0
beetroot	cancer of mouth	0
maple	malignant epithelial tumors	0
macadamia nut	auricular fibrillations	0
rosa	mad cow disease	0
individual food	venous thromboses	0
infant formulas	utp-hexose-1-phosphate uridylyltransferase deficiency disease	0
skim milk	fibrosis	0
toronja	hypoxia	0
vodka	migraine disorder	0
saffron	acute inflammatory polyradiculoneuropathies	0
texturized vegetable proteins	wart viruses	0
eupatorium rebaudianums	barrett's esophagus	0
secale cereale	penis cancer	0
white tea	involutional osteoporosis	0
fresh basil	food hypersensitivities	0
hot peppers	fibrose	0
theobroma cacao	colorectal cancers	0
chewing gums	temporal region traumas	0
lunchtime	cryptogenic epilepsy	0
syzygium	pyrosis	0
sour orange trees	chronic fatigue-fibromyalgia syndrome	0
nut butter	voice box cancer	0
breakfast time	felv	0
chipotle	diabetes-related complications	0
melissa officinalis	dyslipoproteinemia	0
contamination meat	pulmonary embolism	0
apple trees	amyloidose	0
health nuts	vaginal cancers	0
papaver	premature births	0
durum wheats	cancer of the tongue	0
acer	marie-struempell disease	0
soft drinks	action tremor	0
exotic fruit	plasma cell myelomas	0
cicer arietinums	urinary bladder cancer	0
rice	birth weight	0
sesame oils	mammary dysplasia	0
flounder	hypercholesterolemia	0
dietary protein	uterine cervical cancers	0
nicotiana tabacums	oral neoplasm	0
laudable legume	animal viruses	0
shiitake	sliding hiatal hernias	0
low fruit	male breast carcinoma	0
triticum spelta	wart	0
catfish	breast cystic diseases	0
powdered sugar	ankylosing spondylitis	0
portulaca oleracae	male breast neoplasm	0
narrow-leaved plantain	epimerase deficiency galactosemias	0
neutraceutical	neurotic anxiety states	0
piper methysticums	myeloid leukemia	0
restructured meat	hepatocellular cancer	0
raw broccoli	myelopathy	0
afzelia	muscular cramps	0
mangifera indica	lymphoblastic leukemia	0
oregano	creutzfeldt-jakob disease	0
oryza sativa	malignant brain neoplasms	0
betel	peripheral artery diseases	0
decaf	hepatic cancer	0
zea mays	bronchiolitide	0
faba bean	paralysis agitans	0
food pyramid	bipolar disorders	0
plantain	acute inflammatory polyneuropathy	0
eugenia sandwicensis	generalized spasms	0
fat foods	lymphoblastic leukemia	0
vitis vinifera	wart	0
sweet pepper	preventing cancer	0
last meal	enzootic bovine leukosis	0
sweet peppers	gastric cancer	0
oyster mushroom	vestibular seizures	0
cooked broccoli	prostate neoplasm	0
black rice	cardiac disease	0
caramel	somatotropin hypersecretion syndrome (acromegaly)	0
entree	e b virus	0
concord grapes	odontogenic keratocysts multiple basal cell nevi	0
bt corn	lung neoplasm	0
althea officinalis	degenerative neurologic disease	0
soy yogurt	cognitive dysfunction	0
mastic trees	type c oncoviruses	0
chervil	dysosmia	0
spearmint	human flu	0
triticum vulgare	basal cell carcinomas	0
unfertilized eggs	paraesophageal hernia	0
pear	chromosome 6-linked autosomal recessive parkinsonism	0
fig	generalized spasms	0
golden glow	reticulolymphosarcoma	0
lens culinaris	cranial pains	0
chamomile tea	backache	0
eugenia jambos	norovirus	0
soy proteins	auriculo ventricular dissociation	0
chinese cinnamons	breast malignant neoplasm	0
dried fruit	schizoaffective disorder	0
durum wheat	dermatozoic delusions	0
fast food	premature birth	0
antioxidant fruits	oral neoplasm	0
laciniate nightshades	nasal cavity cancer	0
baptisia	disc degenerations	0
high-fructose maize syrup	diabetic neuropathy	0
chamomile oil	spinal cord diseases	0
digitalis	reticuloendotheliosis virus	0
ficus	common bile duct calculi	0
artificially-flavored corn	sea sickness	0
zedoary zedoaria	vaginal discharge	0
vegetable proteins	hirsutism	0
ceratonia	penile cancer	0
red meat	hyperpigmentation	0
lemon trees	epileptic seizure	0
food coloring	non hodgkins lymphoma	0
rose berries	cognitive declines	0
breakfast cereals	sleep related neurogenic tachypnea	0
porgy	burkitts lymphoma virus	0
watermelon	leukemia virus	0
cardamom	guam form amyotrophic lateral sclerosis	0
olive family	olfactory groove meningiomas	0
ocimum sanctum	felv	0
machaerium	inhibit cancer	0
study lavender	ovary neoplasms	0
contaminated foods	hemolytic uremic syndrome	0
papaya	multiple myositides	0
coriandrum sativums	syncopal vertigos	0
eating almonds	cancer of the liver	0
wisconsin milk	nonalcoholic fatty livers	0
ale	constrictive bronchiolitides	0
morinda	convulsive seizure	0
tree nuts	food hypersensitivity	0
dioscorea batatas	age related macular degeneration	0
use sweeteners	regional ileitis	0
citrus-based fruits	lou gehrig's disease	0
tea leaves	anxiety neuroses	0
agent orange	mixed lymphocytic-histiocytic lymphomas	0
drinking tea	childhood onset obesity	0
ganja	tonsil neoplasm	0
brussels sprouts	nonalcoholic fatty liver	0
carbonated beverage	skin neoplasms	0
dressing	back pain without radiation	0
squash plants	mammary dysplasia	0
lime	amyotrophic lateral sclerosis motor neuron disease	0
acer negundos	abdominal cramps	0
cider	cancer of prostate	0
milk protein	charcot disease	0
frequent meals	jakob creutzfeldt disease	0
pepsi	schizoaffective disorder	0
bottled water	insulin deficiency	0
white wine	confusion	0
health food	pulmonary embolisms	0
weed	chromosome 6-linked autosomal recessive parkinsonism	0
goiaba	senile plaques	0
hibiscus	generalized headaches	0
gala apples	develop cancer	0
table salt	familial parkinson disease	0
myristica fragran	paratuberculosis	0
cereal	chronic gum disease	0
mesquite	drug allergy	0
no noni	thinness	0
rye bread	study cancer	0
lycopersicon esculentum	degenerative intervertebral discs	0
actual fruit	deep venous thromboses	0
copaifera	foodborne illnesses	0
fuji apples	fibroatheromatous plaques	0
coca	anaplastic carcinomas	0
food company	deep-venous thrombosis	0
oatmeal	arrhythmia	0
caffeinated coffee	small-cell lymphomas	0
incorporate cloves	udpglucose hexose 1 phosphate uridylyltransferase deficiency	0
kenaf	cognitive impairment	0
dripping	cancer of the pancreas	0
lycium	infant botulisms	0
sweet almond	fibrocystic breast disease	0
woodland strawberries	human t lymphotropic virus type iii	0
whole grain	ph1-negative myeloid leukemia	0
trigonella foenum-graecums	acne	0
fenugreek seeds	leucocythaemia	0
guacamole	chronic fatigue fibromyalgia syndrome	0
sockeye salmon	abdominal pain	0
beer	udp-galactose-4-epimerase deficiencies	0
syzygium sandwicense	primary parkinsonism	0
beef	schizoaffective disorder	0
red meats	liver neoplasm	0
orange juice	retro-ocular headaches	0
raisin	galactosemia 3s	0
bean sprout	epstein-barr virus	0
cayenne pepper	drug use disorder	0
ilex paraguarienses	hepatic failure	0
meal	urticaria	0
alfalfa sprout	sub-fertility	0
eugenia malaccensis	endometrial carcinomas	0
fat milk	pseudocoma	0
portulaca oleracea	postoperative vomiting	0
processed apples	zoonotic infectious disease	0
chewing fruit	gall stone	0
scrambled eggs	intention tremor	0
radish	spinal cord disorder	0
narrow leaved plantain	cancer of the vagina	0
ready soybeans	prostatic intraepithelial neoplasia	0
bell pepper	papillomaviridae	0
empty calorie foods	different cancer	0
peach tree	germinoblastoma	0
rooibo	small non cleaved cell lymphoma	0
maize oils	ph1-negative myelogenous leukemia	0
hibiscus tea	new variant creutzfeldt jakob disease	0
musa	parkinsonian syndromes	0
turnip	painful menstruation	0
amlas	intracranial neoplasm	0
salmonella-infected eggs	eye diseases	0
chamomile oils	malignant melanoma	0
golden raisins	mucous colitides	0
brussel sprout	colon neoplasm	0
diabetic diets	acute inflammatory demyelinating polyneuropathy	0
areca nuts	early awakening	0
dietary supplementations	dysmenorrhea	0
malus	multiple meningioma	0
norovirus food	mixed lymphocytic histiocytic lymphoma	0
root	chronic cluster headaches	0
cooked carrots	senile tremors	0
food supplementations	syncopal vertigo	0
almond trees	multiple myositis	0
plantago	fine tremors	0
poultry	osteoarthrosis	0
fruit juice	hemicrania migraine	0
ketchup	foreign object	0
emphasize plant	reactive confusion	0
hawthorn	adenoviridae	0
amomum cardamomum	age-related maculopathies	0
almond oil	polyarthritis	0
sorrel	virus	0
fagopyrum sagittatum	exanthem	0
zinger tea	myalgia	0
unfiltered coffee	muscle disease	0
organic foods	bone cancer	0
trace mineral	pancreas cancers	0
avocado	nasal cavity cancer	0
dietary supplement	male sexual impotence	0
triticum turgidum subsp. durum	growth hormone insensitivity syndrome	0
yolk	cacosmia	0
citrus reticulatas	orthostatic headache	0
overpriced vitamin	hepatitis	0
bok choy	sleep wake disorders	0
organ meats	cryptogenic epilepsies	0
refined olive	somatotropin hypersecretion (acromegaly) syndrome	0
soup	carotid sinus syncopes	0
saint johns wort	burning pains	0
black walnut	sharp headaches	0
papaver somniferum	rectal cancers	0
cassia cinnamon	plasma-cell myeloma	0
dinner time	non b hepatitis epidemic non a	0
persea	fibromyalgia	0
hydroponic basil	coronary heart disease	0
tepary beans	lumbago	0
olive trees	abdominal aortic aneurysms	0
brazil nut tree	uterine leiomyoma	0
cereal grains	reticulum cell sarcoma	0
nutritional yeast	hepatitide	0
apricot trees	cerebrovascular stroke	0
allspice	carcinogenesis	0
cleistocalyx	ocular headaches	0
shan yao	muscle pain	0
soy milk	paralysis agitans	0
mackerel	esophageal cancer	0
placenta	ocular headaches	0
kidney bean	neoplasm metastasis	0
yerba mates	v-cjd (variant-creutzfeldt-jakob disease)	0
specific cheeses	benign meningiomas	0
taro	muscle sorenesses	0
fiddlehead ferns	neurotic anxiety state	0
psyllium	nutritional disease	0
fake meat	malignant tumor of breast	0
apple juice	cancer of the tonsil	0
fragaria vesca	brain benign neoplasm	0
grape juice	manic states	0
decrease meat	memory disorder	0
trigonella foenum-graecum	testicular tumors	0
soy	kill cancer	0
pleurotus	rabies viruses	0
narrow-leaved plantains	bovine lymphosarcomas	0
triticum turgidum	atheromatous plaques	0
prunus domestica	encephalon disease	0
green peppers	nonalcoholic fatty liver disease	0
marijuana	food-borne disease	0
steamer	bladder neoplasm	0
pleurotus ostreatus	retained surgical sponge	0
curcuma zedoarias	cancer of skin	0
nicotiana	burkitt herpesvirus	0
healthiest beverages	stokes adams syncope	0
persimmon	acute fulminating multiple sclerosis	0
dairy eggs	epileptic seizures	0
walnut	deglutitional syncope	0
soy food	rectal cancer	1
soy bean curd	lower back pains	0
strawberry	olfactory groove meningiomas	0
ovary	xanthomatous meningioma	1
dietary plant proteins	chronic infectious mononucleosis like syndrome	0
citrus fruits	bone neoplasm	0
cicer	human t-lymphotropic virus type iii	0
caryophyllus aromaticus	effort syncope	0
belladonna	human papilloma virus	0
pimenta diocias	schizophrenia	0
preserved food	dental fluorosis	0
juglan	darkness tremors	0
ultra-processed food	acute inflammatory demyelinating polyradiculoneuropathy	0
plum trees	prostatic intraepithelial neoplasias	0
red onions	ulcerative colitis	0
chinese yams	cancer of brain	0
vinegar	hyperpigmentation	0
so-called meat	preinvasive carcinoma	0
apricot tree	variant creutzfeldt-jakob disease	0
crab apple	ekbom dermatozoic delusions	0
sweet foods	acidosis	0
crab apples	ischemia	0
fabaceae	preterm births	0
holy basil tea	coronary heart disease	0
carbonated drink	bruise	0
carthamus tinctorius	pancreas cancer	0
vegetable juices	substance abuse	0
orange trees	stokes-adams syncopes	0
romaine	reduced sensations	0
pickled vegetables	bacteria-eating virus	0
monkfish	paralysis	0
allium porrum	leukemogenic viruses	0
eden foods	gasser's syndrome	0
bran flakes	acquired immunodeficiency syndromes	0
crowberry	oral neoplasm	0
dried apricots	angioblastic meningiomas	0
vaccinium macrocarpon	chronic fatigue syndromes	0
breakfast	mink encephalopathy virus	0
black sapotes	macular dystrophies	0
mirobalanus embilicas	fifth phacomatoses	0
chocolate pudding	bladder cancers	0
organic food	acidose	0
english walnuts	cancer of brain	0
largest meal	chronic airflow obstruction	0
rubus fruticosus	lymphoma	0
rooibos	liver steatoses	0
sugar-sweetened beverages	renal insufficiency	0
white meat	salmonellosis	0
tumeric	coronary heart diseases	0
malabar nut	lactose malabsorption	0
alfalfa sprouts	acute monoblastic leukemia	0
linseed	cognitive impairment	0
syzygium jambos	foreign object	0
peach	retained surgical needles	0
official vitamin	prostatic neoplasms	0
raisin bran	cerebrovascular apoplexy	0
portulaca oleraceas	hemicrania	0
hypericum perforatums	multiple head injury	0
rheum rhaponticum	type 1 diabetes mellitus	0
croaker	acute inflammatory polyneuropathy	0
poenumgraecum	diabetic polyneuropathies	0
solanum tuberosum	hemicrania migraine	0
food additives	anaplastic carcinomas	0
french fries	gnathostoma infections	0
filbert	leukovirus	0
red yeast rice	congenital defect	0
lipomul	involuntary quiver	0
fryer	parkinson's disease	0
chewing gum	uterus cancers	0
sea vegetable	bacterial vaginoses	0
pureed apples	rhabdomyolys	0
snacktime	aphthae	0
ceylon cinnamon	renal neoplasm	0
crataegus monogynas	manic state	0
emblica officinalis	retained surgical needle	0
cilantro	mental deterioration	0
new vitamin	nonorganic insomnia	0
vitamin pills	diffuse mixed-cell lymphoma	0
silken tofu	cognitive retention disorder	0
family vegetables	chronic insomnia	0
kiwi fruit	chronic fatigue disorder	0
include fennel	car sickness	0
hibiscus sabdariffa	variant creutzfeldt-jakob disease	0
multivitamin	thyroid disease	0
herbal tea	retained surgical sponges	0
granny smith	smell disorders	0
citrus	focal seizures	0
triticum	splitting pains	0
milk proteins	deep-venous thromboses	0
ocimum tenuiflorum	bowel disease	0
saccharomyces cerevisiae	ph1-negative myeloid leukemias	0
cumin	chronic lymphocytic leukemia	0
rice milk	amyotrophic lateral sclerosis with dementia	0
animal-based vitamin	female sterility	0
sustenance	somatotropin hypersecretion (acromegaly) syndromes	0
plaice	pharyngitis	0
sugar	cancer of the lung	0
olive	ebv	0
mangifera	cancer of the lung	0
burrito	membranous cataract	0
hot sauce	semantic memory disorders	0
international nut	experimental parkinsonism	0
seville orange trees	paraesophageal hiatal hernia	0
marjoram plants	hot flashes	0
molasse	low grade lymphoma	0
watercress	esophageal cancers	0
suggesting apple	galactose-1-phosphate uridylyltransferase deficiency	0
blueberry	carcinoma	0
brown rice	visceral obesities	0
dragon fruit	sea sickness	0
anchovy	tying disease	0
fagopyrum esculentum	splitting pain	0
marjoram	preterm birth	0
peach trees	cerebrovascular stroke	0
citrus fruit	olfactory seizure	0
healthy fruit	acute autoimmune neuropathy	0
honey	udp-galactose-4-epimerase deficiency diseases	0
healthiest fruits	grippe	0
dietary supplements	cjd (creutzfeldt jakob disease)	0
eugenia caryophyllata	poisoning	0
hickory nuts	common cancer	0
raw tomatoes	tongue neoplasms	0
commercial milk	ciguatera poisonings	0
broccoli raab	cardiogenic syncopes	0
peppermint oil	sciatic neuralgia	0
plantago lanceolata	fusiform aneurysms	0
bell peppers	undifferentiated carcinoma	0
bellis	mesothelioma	0
butter milk	feminization	0
lemon verbena	peripheral artery diseases	0
coriander	cancer of the mouth	0
glycyrrhiza	utp hexose-1-phosphate uridylyltransferase deficiency	0
fava beans	pill rolling tremors	0
potato chips	liver dysfunctions	0
philadelphia cream cheese	age related memory disorders	0
consumed chocolate	anhedonia	0
gluten-free diet	stomach cancers	0
prosopi	sliding esophageal hernias	0
red tea	liver dysfunction	0
anti-inflammatory plant	penis cancer	0
higher vegetable	increase cancer	0
citrus grandis	hypercapnia	0
chicken salad	resting tremors	0
probiotic	craniocerebral trauma	0
allium sativum	penile cancer	0
sell meat	schizophreniform disorder	0
maize	ruptured appendicitis	0
cola nitida	senile tremors	0
cola acuminata	ekbom delusory parasitoses	0
snack food	clear cell meningiomas	0
individual candy	insomnia	0
lemon balm tea	endotoxemia	0
citrus grandi	multiple myositis	0
peanut	generalized spasms	0
mussel	plasmodium infections	0
chia seeds	neuritic plaque	0
handling meat	limb tremor	0
msg	fibromyositis-fibromyalgia syndromes	0
flax seed	head injury	0
spore	diffuse lymphocytic lymphoma	0
bread mold	common colds	0
collard green	periorbital headaches	0
deep-fry foods	pregnancy pernicious vomiting	0
specific nuts	jaundice	0
fresh fruits	high-grade lymphoma	0
pistacia vera	prostatic neoplasm	0
human milk	preinvasive carcinoma	0
vital nutrients	amnestic state	0
purple potatoes	orthostasis	0
corylus	preterm births	0
plant kingdom	insulin resistance	0
black currants	myocardial failure	0
brew	prostatic adenomas	0
fava bean	microglandular adenosis	0
recommend tea	epstein barr virus	0
cream cheese	human flu	0
indian laburnums	atopic disease	0
origanum majorana	hypertension	0
currant	testicular neoplasm	0
trace minerals	cow disease	0
club sodas	migraine variant	0
dangerous plants	muscular rheumatism	0
juglans nigra	atherogenesis	0
food poisoning	retinitis	0
teff	mptp induced experimental parkinsonism	0
dietary soybean proteins	basal cell carcinomas	0
molasses	cancer of thyroid	0
red cabbage	body weight	0
eating meat	cancer of tonsil	0
legume pods	sleep related neurogenic tachypnea	0
whole grain cereals	barrett epithelium	0
ice creams	nerve tremor	0
artificial sweeteners	cardiac sudden death	0
jalapeno peppers	psychogenic parasitosis	0
squash plant	mouth and tooth diseases	0
oxen meat	stroke	0
salami	low back aches	0
triticum aestivum	cognitive dysfunction	0
longevity legumes	venous thromboses	0
happy meal	infertility	0
ready-prepared food	lung diseases	0
kangaroo meat	reproductive sterility	0
carica	female sub fertility	0
teosinte	human immunodeficiency virus	0
chlorella	pulmonary neoplasms	0
cheese	prion protein diseases	0
persea americanas	uterus cancers	0
cuminum cyminum	non-hodgkin lymphoma	0
high-phytate foods	peanut hypersensitivity	0
norus	bleed	0
cycad	low back ache	0
dried cranberries	excess cancer	0
potable water	esophagus neoplasm	0
red peppers	fine tremor	0
mentha x piperita	creutzfeldt jakob syndrome	0
phaseolus vulgaris	hydrophobia	0
bread	torsion fractures	0
find pork	barrett epithelium	0
carduus marianus	male sub fertility	0
plant aril	clear cell meningiomas	0
nori	gehrig disease	0
coconut milk	autosomal recessive juvenile parkinson disease	0
added nuts	congenital abnormality	0
romaine lettuce	fatigue	0
cherry plum trees	insulin dependent diabetes mellitus 1	0
emblica officinali	barrett's esophagus	0
jalapeno pepper	gale deficiencies	0
eggnog	ph1 negative myeloid leukemia	0
tomato juice	visual seizures	0
raw meat	peripheral artery diseases	0
barberry	terminal ileitis	0
cooked meats	mptp induced experimental parkinsonism	0
goji berries	atypical cluster headaches	0
shoot	insulin dependent diabetes mellitus 1	0
kola nut	acute monocytic leukemias	0
fermented foods	cll lymphoplasmacytoid lymphomas	0
filtered coffee	rabies viruses	0
red pepper	spiral fractures	0
rheum	cancer-causing viruses	0
tepary bean	diabetic amyotrophies	0
prunus salicina	craniocerebral injuries	0
cranberry juice	sclerosis	0
potato	small round-structured viruses	0
adding blueberries	stokes-adams syncope	0
spicy food	galactose 1 phosphate uridylyltransferase deficiency	0
white pepper	forehead trauma	0
arecas	muscle sorenesses	0
supper	fibromyoma	0
sesamum	postoperative vomiting	0
phytonutrient-rich food	phlebothrombosis	0
lunch times	high blood pressure	0
saint john wort	cryptogenic epilepsies	0
leaf lettuce	cancer of the tonsil	0
ephedras	pulmonary inflammation	0
elettaria cardamomums	high grade lymphoma	0
barley coffee	prostate neoplasm	0
english plantain	barretts syndrome	0
prosopis	barrett metaplasia	0
cocoa powder	delusional parasitosis	0
edible grains	intervertebral disc degeneration	0
isoglucose	human papillomavirus viruses hpv	0
ground beef	lymphocytic leukemia	0
thymus vulgari	hypercholesteremia	0
soda water	meningiomatosis	0
yerba mate	age related bone loss	0
glucose fructose syrup	intervertebral disc degenerations	0
regular olive	mechanical low back pain	0
green teas	chronic b-cell leukemias	0
wild radish	menstrual disorders	0
millet	laron type dwarfism i	0
golden delicious apples	prostatic hypertrophy	0
carbonated mineral waters	pseudocoma	0
offal	light headedness	0
healthy foods	primary brain tumors	0
alcoholic beverage	male breast tumors	0
frying meat	posterior fossa meningioma	0
daily fruit	cellulite	0
abelmoschus	kidney cancers	0
deli meat	gastric neoplasms	0
white bread	mink encephalopathy virus	0
wild yam	oncovirinae	0
kale	colorectal neoplasm	0
silybum marianums	atherosclerotic plaques	0
coleslaw	diffuse lymphomas	0
pomegranate seeds	varix	0
big food	kidney failure	0
glycine max	liver steatoses	0
poultry products	primary growth hormone resistance	0
goji berry	pituitary dwarfism ii	0
clove	breast malignant tumors	0
citrus aurantiifolias	proteinuria	0
boiled eggs	lyme borreliosis	0
milk thistles	retained surgical instrument	0
wort	adenosis of breast	0
triticum durum	social anxiety disorders	0
eragrostis	postural low back pain	0
hickory tree	olfactory seizure	0
adhatoda	peripheral artery disease	0
food allergy	anal ulcer	0
solanum laciniatum	ocular headaches	0
curried tofu	drunkenness	0
whiting	ms (multiple sclerosis)	0
vaccinium ashei	osteoarthrosis	0
candy bars	penis neoplasm	0
carob	ebv	0
citron tree	heart disease	1
dioscorea opposita	malignant melanomas	0
infant formula	johne disease	0
ribe	tumorigenesis	0
taraxacum officinale	substance use disorders	0
big meals	weight reductions	0
vegetable juice	respiratory tract infection	0
hickory nut	obesity in childhood	0
avena sativa	huntingtons disease	0
rubus glaucus	somatosensory seizure	0
portulaca	bovine leukemia virus	0
java plum tree	menstrual pains	0
digitalis lanata	parkinsonism	0
cookie	enzootic bovine leukoses	0
faba beans	hemicrania	0
radicchio	neuritic plaques	0
cassia	itch	0
brassica juncea	degenerative intervertebral discs	0
unrefined plant	severe congenital microcephaly	0
trace elements	esophageal hernia	0
safflower oils	tactile hypesthesia	0
citrus hystrices	carcinoma in situ	0
origanum	plasmodium infection	0
edible grain	cancer of the liver	0
curry	skin neoplasm	0
exotic fruits	lymphoma	0
popcorn	chronic infectious mononucleosis like syndrome	0
greenery	zoonotic infections	0
amaranth	neoplasm metastases	0
almond milk	paralysis agitans	0
monosodium glutamate	amyotrophic lateral sclerosis	0
sweeten	gingivitis	0
eupatorium rebaudianum	fusiform aneurysm	0
pecan	malignant lymphomas	0
prunis communis	impotence	0
soy foods	colon disease	0
dietary fat	inflammatory bowel disease 1	0
thyme	human influenza	0
sweetening agents	virus infection	0
dried plums	tonsillar cancer	0
breast milk	eczematous dermatitis	0
white potatoes	airsickness	0
hypericum perforatum	plasma cell myeloma	0
regular carrots	et-nanbh	0
horse nettles	early detection of cancer	0
euterpe oleracea mart.s	inflammatory bowel diseases	0
english plantains	barrett's esophagus	0
brassica	deficiency disease	0
oryza	chronic lymphoblastic leukemias	0
chicken meat	birth defects	0
texturized soy protein	low back ache	0
wild yams	non-epileptic convulsions	0
yogurt	non b hepatitis enterically transmitted non a	0
split peas	udp galactose 4 epimerase deficiency	0
majorana hortensis	hepatic neoplasm	0
rheum officinale	hiatus hernia	0
flammulina velutipes	human t-cell lymphotropic virus type iii	0
cultivated oats	regional ileitis	0
cupcake	ovary cancers	0
saint johnswort	odontogenic keratocysts multiple basal cell nevi	0
retail poultry	nonalcoholic fatty liver disease	0
amorpha	venereal warts	0
lucerne	acne	0
coco	benign neoplasm	0
soda pops	pharyngitis	0
muffin	insomnia disorders	0
artificial butter	fibromyalgia fibromyositis syndrome	0
cooking oil	auriculo ventricular dissociation	0
breakfast times	allergy	0
safflower oil	plasma cell myeloma	0
pimenta officinalis	food-borne illnesses	0
solanum lycopersicum	deficiency disease	0
areca catechu	cholera	0
soy sauce	autosomal recessive familial parkinson disease	0
eugenia cumini	mastodynia	0
petroselinum crispums	age related macular degeneration	0
organic milk	hyperventilation syncopes	0
emphasizes vegetables	osteoarthritide	0
citrus hystrix	benign meningioma	0
pumpkin pie	degenerative diseases	0
flaked coconut	intracranial cns disorders	0
drug administration united states food	bovine lymphosarcoma	0
soy protein	intermediate-grade lymphomas	0
mentha	broken bone	0
raw food	bipolar disorders	0
oregano plant	steatosis of liver	0
raw foods	semirhythmic tremors	0
no-calorie sweeteners	necrotizing fascitis	0
dark chocolate	kanners syndrome	0
food companies	chronic b-cell leukemias	0
food manufacturers	passive tremor	0
liquor	familial atrial fibrillations	0
including cloves	cancer of vulva	0
healthiest vegetable	plasma cell myelomas	0
decaffeinated tea	frontal region traumas	0
rhubarb	iron overload	0
cultivated radish	sleep initiation and maintenance disorders	0
sugary foods	non-b hepatitis epidemic non-a	0
hibiscus cannabinus	oral cancers	0
citrus sinenses	membranous cataract	0
mashed potatoes	polymyositis	0
citronella	amyotrophic lateral sclerosis motor neuron disease	0
cannabis	cancer of ovary	0
citrus aurantiifolia	substance dependence	0
lemon balms	bses (bovine spongiform encephalopathy)	0
pimiento	bipolar disorder	0
century plant	todd's paralysis	0
moose meat	royal free disease	0
frying foods	carcinomatosis	0
humulus	leukemia virus	0
pistachio nut trees	ovary neoplasm	0
cruciferous foods	biliary calculi	0
antioxidant foods	atypical cluster headache	0
chinook salmon	acquired immuno-deficiency syndrome	0
indian gooseberry	uterus cancers	0
holy basil	transitional meningiomas	0
collard	steatosis of liver	0
dietary sucrose	hyperpigmentation	0
digitalis purpurea	pustulosis of palms and soles	0
nutmeg	gluten-sensitive enteropathy	0
hamburger	muscular cramps	0
cannabis sativas	memory deficit	0
virgin olive	menstrual pains	0
andropogon nardus	low-grade lymphoma	0
purple cabbage	spindle cell carcinoma	0
porphyra	sub-fertility	0
eragrostus	tonic seizures	0
inadequate fruit	brain conditions	0
dried apple	v cjd (variant creutzfeldt jakob disease)	0
pizza	mammalgia	0
blueberry plant	preterm births	0
jasmine tea	nonalcoholic steatohepatitis	0
elettaria cardamomum	breast fibrocystic change	0
ready-prepared foods	block cancer	0
earl grey tea	sliding hiatal hernia	0
olea europaea	basal cell epithelioma	0
wolfberry	upper respiratory tract infections	0
mock meats	contagious pustular dermatitis	0
salt-free diet	rheumatoid spondylitis	0
green grapes	polymyositis ossificans	0
opium poppies	esophagus cancers	0
mint	angiomatous meningiomas	0
iceberg lettuce	childhood obesity	0
andira	drop attacks	0
piper methysticum	amyloid plaques	0
kawa kawas	uterine neoplasms	0
actual licorice	stomach ulcer	0
poisonous plant	gestational diabetes	0
cultivated oat	rest tremors	0
cold-steeping tea	mild cognitive impairments	0
hazelnut	renal failures	0
retail meat	chronic fatigue syndromes	0
nonus	male infertility	0
toxic plants	skin neoplasm	0
chamomile	nonspecific vaginitis	0
poisonous plants	utp hexose-1-phosphate uridylyltransferase deficiency	0
healthier meat	androgenic alopecias	0
butter	rna tumor virus	0
marihuana	neurodegenerative diseases	0
tuna fish	malignant meningioma	0
food colors	wound botulism	0
ribes nigrum	ocular headaches	0
horsemeat	myocardial infarction	0
whipped cream	substance-related disorders	0
eating fruits	subfertility	0
term vegetable	tonic seizure	0
thymus vulgaris	atypical cluster headaches	0
cucumis melos	autistic disorder	0
whole grain cereal	iddm	0
taking vitamin	tumorigenese	0
saffron crocus	primary malignant brain neoplasms	0
gluten	motion sickness	0
century plants	stomatognathic diseases	0
fermented cabbage	voice box cancer	0
cooked tomatoes	intraepithelial neoplasms	0
organic meat	paroxysmal atrial fibrillations	0
bitter orange trees	passive tremor	0
celebration meal	chronic fatigue fibromyalgia syndrome	0
diabetic diet	necrotizing fascitis	0
fresh meat	miscarriage	0
lentil	guillain-barre syndrome	0
soy bean proteins	early detection of cancer	0
cola	reactive confusion	0
healthy food	familial tremors	0
mandarin orange tree	paratuberculose	0
healthiest foods	fibromyalgia-fibromyositis syndrome	0
aspalathus	deficiency diseases	0
measuring food	brain vascular accidents	0
applesauce	premenstrual syndrome	0
pistil	fibrous meningioma	0
adhatoda vasica	gallbladder diseases	0
salmonella food	cerebral strokes	0
allium cepa	degenerative neurologic disorder	0
aloe vera	growth hormone insensitivity syndrome	0
berberi	ebv	0
leek	sciatica	0
dinner	myelomatosis	0
eating nuts	retained surgical instruments	0
red delicious apples	esophageal neoplasms	0
juglans regia	texidor's twinge	0
red wine	starvation	0
assai palm	delusional parasitosis	0
bitter nightshade	fibrous meningiomas	0
avena	neurotic anxiety state	0
leafy vegetables	faint	0
anticancer plant	mixed cell lymphoma	0
low-sodium diet	bruise	0
lentinus edodes	tumor	0
hummus	non b hepatitis enterically transmitted non a	0
turmeric root	hot flashes	0
black pepper	parasagittal meningiomas	0
pimpinella	near-death experience	0
whole grains	clear cell meningiomas	0
fennel	gale deficiencies	0
herr	torsion fractures	0
pecan trees	skin neoplasm	0
pimenta diocia	type c oncovirus	0
citrus reticulata	male breast carcinoma	0
cured meat	neurocysticercose	0
illicium verum	diffuse mixed-cell lymphoma	0
common plant	congenital abnormalities	0
carica papaya	paratuberculosis	0
bitter nightshades	leukemogenic viruses	0
kola nuts	throbbing headaches	0
vaccinium corymbosum	sterility	0
fruit and vegetable juices	monocular blindness	0
breakfast cereal	eczematous dermatitides	0
pimenta officinali	diabetic neuropathies	0
handling food	congenital defect	0
seltzer waters	ekbom delusory parasitoses	0
fenugreek	headache disorders	0
nuclear power plants	gestational diabetes mellitus	0
dried blueberries	cancer of breast	0
solanum dulcamaras	hypertension	0
steak	infertility	0
pomelo trees	plasma-cell myeloma	0
foodstuff	primary brain tumor	0
pasta	breast dysplasia	0
licorice root	thyroid neoplasms	0
lavandula angustifolia	brain tumors	0
citrus paradisi	auricular fibrillations	0
euterpe	vulva neoplasm	0
acer negundo	dwarfism	0
wine	bilateral headache	0
reason food	ketosis-prone diabetes mellitus	0
illicium anisatum	canker sore	0
morinda citrifolia	todd's paralysis	0
vitis	thermal hypesthesia	0
mentha spicatas	muscle pains	0
rutabaga	heart decompensation	0
buttermilk	periorbital headaches	0
alcohol	dyslipoproteinemia	0
dried fruits	body weight	0
common foxglove	massive tremor	0
turmeric	intestinal diseases	0
ocimum basilicum	vertiginous seizures	0
sweetener	mania	0
bolete	schizophrenia	0
cereal grain	bacterial infection	0
macadamia nuts	hemolytic jaundices	0
salsa	acute monoblastic leukemias	0
grecian foxgloves	mouth cancer	0
dinner times	acquired immunodeficiency syndrome virus	0
lens plant	cancer of cervix	0
food allergies	cancer of the skin	0
sweet basils	anxiety neuroses	0
horse bean	small round structured viruses	0
healthiest snack	vagina cancers	0
rooibos tea	male sub-fertility	0
jambolan plum trees	motor seizure	0
pinto beans	cervical neoplasms	0
natural vitamin	lou gehrig's disease	0
high-fat meal	cerebral convexity meningioma	0
plum tree	chronic illness	0
pumpkin seeds	anal ulcers	0
baby carrots	parkinsonism-dementia complex of guam amyotrophic lateral sclerosis	0
lavandula	cancer of pancreas	0
chinese cassias	anticancer	0
kohlrabi	peripheral artery diseases	0
energy drink	intracranial central nervous system disorders	0
chili peppers	fissure in ano	0
broth	burkitt lymphoma virus	0
split pea	liver cancers	0
roughage	leukemia	0
sugar maples	diabetic polyneuropathy	0
mirobalanus embilica	galactosemia iiis	0
kiwi	low-grade b-cell malignancy	0
humulus lupulus	drug allergy	0
flavoring	substance-induced organic mental disorders	0
grape seeds	senile paranoid dementia	0
banana plants	acquired immuno deficiency syndrome	0
high fructose corn syrup	disrupted in b-cell malignancy	0
kawa kawa	utp hexose 1 phosphate uridylyltransferase deficiency disease	0
cinnamomum trees	guam disease	0
trigonella	hiccough	0
andean blackberries	ciliary body spasms	0
avoid peanuts	ankylosing spondylarthritides	0
lactuca sativa	cluster headaches	0
pyrus	autosomal recessive parkinsonism	0
mastictree	gastro oesophageal reflux	0
cow's milk	prevent and reverse heart disease	0
bhang	cancer of rectum	0
table sugar	toxic megacolon	0
wild celeries	congenital abnormality	0
cacao	retro ocular headache	0
floret	chicken viruses	0
squash	lewy body parkinson disease	0
sparkling water	endometrium cancer	0
seltzer water	colitis gravis	0
phaseolus acutifolius	viral infections	0
carya illinoensis	fever	0
fungus	fibroid	0
fed beef	rest tremor	0
rubus	nausea	0
dandelion	benign meningiomas	0
colocasia	johne disease	0
big apples	vertex headache	0
granny smith apples	pancreas cancer	0
nicotiana tabacum	retro ocular headache	0
margarine	udp galactose 4 epimerase deficiency disease	0
olive tree	abdominal migraines	0
sugar water	nonalcoholic steatohepatitides	0
whortleberry	age-related memory disorder	0
yellow vegetables	liver neoplasm	0
powdered ginger	venous thrombosis	0
corn oil	brain cancers	0
true nut	low-grade lymphomas	0
pomegranate	udp galactose 4 epimerase deficiency disease	0
stem vegetables	inflammatory disease	0
unhealthy food	schizoaffective disorders	0
asparagus	blood clot	0
licorice	breast tumor	0
gui zhi	abdominal cramp	0
apricot	hereditary galactokinase deficiencies	0
citrus medica	bladder neoplasms	0
rose hips	somatotropin (acromegaly) hypersecretion syndromes	0
black walnuts	bovine spongiform encephalopathy	0
dioscorea villosa	muscular cramp	0
chickpea	venereal wart	0
bertholletia excelsas	blood clot	0
green pepper	dermatosis	0
rose	primary malignant brain tumors	0
linum usitatissimum	senile plaque	0
cuminum	autistic disorders	0
bad foods	diabetic asymmetric polyneuropathy	0
clathrotropis	heat strokes	0
brewing tea	galk deficiency	0
peanut butter	cancer of brain	0
mentha piperita	recurrent low back pain	0
plantago psyllium	guillain-barré syndrome	0
sweetening agent	lou gehrig disease	0
salad	age-related macular degeneration	0
flesh foods	melanoma	0
glycyrrhiza glabra	dyschezia	0
ranking foods	myocardial failure	0
areca	chicken viruses	0
national pork	b12 deficiency	0
cappari	lumbago	0
prunus amygdalus	age related maculopathy	0
ready prepared foods	ulcerative colitis	0
processed food	insulin deficiency	0
drinking coffee	acute inflammatory polyneuropathy	0
halibut	lassitude	0
pithecellobium	fetal iodine deficiency disorder	0
soy beverage	malignant tumor of breast	0
açai berry	cerebrovascular strokes	0
willow tree	infarction	0
food and drug administration	cognitive decline	0
curcuma	coronary diseases	0
convenience food	growth hormone insensitivity syndrome	0
lima beans	plasmodium infection	0
cayenne	penile cancers	0
chestnut	variant creutzfeldt-jakob disease	0
hordeum	focal seizures	0
cortland	gerd	0
whale meat	radiating pain	0
kaffir lime	cancer of skin	0
syzygium jambolanum	bone neoplasms	0
garcinia mangostana	diffuse small cleaved-cell lymphoma	0
foenumgraecum	pill rolling tremors	0
artichoke	vitamin deficiency	0
cassia trees	uterine cervical neoplasms	0
cocos nuciferas	inflammatory disorder	0
foeniculum	v-cjd (variant-creutzfeldt-jakob disease)	0
psidium guajava	carotid sinus syncopes	0
foie gras	liver disease	0
sour cream	airsickness	0
psidium guajavas	non-alcoholic fatty liver disease	0
safflower	sliding esophageal hernias	0
dinnertime	temporary amnesia	0
guibourtia	infectious diseases	0
hickory trees	micturition syncopes	0
animal food	neoplasia	0
common foxgloves	utp hexose 1 phosphate uridylyltransferase deficiency disease	0
almond	cancer of the testis	0
rye	sliding hiatal hernia	0
indian gooseberries	glaucoma	0
no meat	radiating pain	0
cassia fistula	rash	0
irritable bowel kiwi fruit	prediabetic states	0
milk	rhabdomyolys	0
common olive tree	retained surgical sponges	0
black currant	lung diseases	0
dioscorea polystachya	viral disease	0
vegetable protein	deep venous thromboses	0
red delicious	scurvy	0
ice cream	inappropriate growth hormone secretion syndrome (acromegaly)	0
cauliflower	sea sickness	0
betel nuts	prion-induced disorder	0
snack foods	sterility	0
zea	bacterial vaginoses	0
flavourer	mammalgia	0
brewage	itch	0
chili	back pains	0
swordfish	horton syndrome	0
cucumis sativus	small round-structured viruses	0
maize oil	orthostatic headaches	0
silybum marianum	cerebrovascular strokes	0
celery root	premature birth	0
bacon	polyarthralgia	0
prenatal vitamins	experimental lung inflammation	0
sardine	diabetic retinopathies	0
flavorer	headache syndrome	0
carya illinoenses	galactokinase deficiencies	0
food poisonings	cognitive retention disorder	0
anacardium	prediabete	0
solanum	clear cell meningioma	0
baker's yeast	laron type dwarfism i	0
cassia fistulas	galactosemia iii	0
banana	sliding hiatal hernias	0
crunch berries	atypical cluster headache	0
nut bars	fibroid tumors	0
mint tea	chronic headache	0
vaccinium uliginosum	hemolytic-uremic syndrome	0
ready-to-eat meals	foodborne illnesses	0
mastic tree	reduced sensations	0
processed foods	abdominal cramps	0
morning meals	aphthous stomatitides	0
sweet orange	esophageal hernia	0
hemp plant	low back pains	0
fagopyrum tataricum	lou gehrig disease	0
herb	inappropriate gh secretion syndrome (acromegaly)	0
holy basils	colorectal carcinoma	0
undercooked meat	auriculo ventricular dissociation	0
lemon tree	amaurose	0
green onions	gehrig's disease	0
tomato	gastric cancers	0
chai tea	spinal meningioma	0
persea americana	sleeplessness	0
indian laburnum	newborn gynecomastia	0
nonfat meal	asymmetric diabetic proximal motor neuropathy	0
macadamia	high cholesterol levels	0
pummelo tree	fibrositide	0
raphanus sativus	burkitt lymphoma virus	0
flower	intention tremor	0
maize syrup	lymphocytic lymphoma	0
own vitamin	soft tissue sarcomas	0
açai berries	left sided heart failure	0
legume family	diabetic complications	0
common bean plant	germinoblastic sarcomas	0
cured meats	benign essential tremors	0
grapefruit	multiple myelomas	0
antioxidant-rich foods	dysmenorrhea	0
mustard greens	weight loss	0
bilberry	fibrocystic changes of breast	0
dairy product	cryptogenic epilepsy	0
healthiest apple	chronic lymphoblastic leukemias	0
hemp plants	gastro oesophageal reflux	0
plant capsule	anal fissure	0
raspberry	hot flashes	0
saint john's wort	alopecia cicatrisata	0
sweet marjorams	malignant meningiomas	0
california avocado	sliding hiatal hernia	0
dog rose	anhedonia	0
curcuma zedoaria	hereditary galactokinase deficiency	0
coconut water	tubal abortions	0
raw poultry	myeloma-multiple	0
little meat	meningiomatosis	0
java plum trees	age-related bone loss	0
diospyro	hyperventilation syncopes	0
carya	rete testis tumors	0
lamb chops	polymyositis	0
olea	widespread chronic pains	0
whole wheat	communicable disease	0
phaseolus	pancreatitis	0
corn syrup	deglutitional syncopes	0
broccoli	brain neoplasm	0
gum acacia	diffuse lymphocytic lymphoma	0
scallion	male breast neoplasm	0
curcuma longas	guillain-barre syndrome	0
turkey meat	texidor's twinge	0
caper	atherogenesis	0
plant arils	cirrhosis	0
acer saccharums	pulmonary cancer	0
seed	cognitive impairments	0
malabar-nut	autistic disorders	0
bean	endometrial neoplasms	0
raw cranberries	prediabete	0
wheat brans	sneezing	0
cabbage	endometrial carcinomas	0
lunch time	miscarriage	0
myristica fragrans	auditory seizure	0
sesame seeds	intracranial central nervous system disorders	0
cannabis indicas	gestational diabetes	0
parsley	beriberi	0
junk foods	myeloma-multiple	0
egg	benign neoplasms	1
thymus	uterine cancer	0
pepper	fever	0
petroselinum crispum	fibromyalgia-fibromyositis syndromes	0
pea families	bacteria-eating viruses	0
low vitamin	acute coryza	0
flowering shrub	rectum cancer	0
serve	laron type dwarfism i	0
eating broccoli	diabetic mononeuropathy	0
soy beverages	varice	0
sprout	deglutitional syncopes	0
mustard plant	age related memory disorders	0
spinacia oleracea	atrophy	0
chili pepper	celiac disease	0
calendula officinali	heat strokes	0
plant embryo	bovine lymphomas	0
sauerkraut	lymphoplasmacytoid lymphoma	0
national meat	celiac sprue	0
shan yaos	passive tremor	0
coriandrum	splitting pain	0
feather meal	vertex headache	0
natto	dripped virus	0
sunfish	cognitive impairment	0
consumer protection scientific committee on food	early awakening	0
plantago arenaria	cognitive declines	0
calendula	cancer of esophagus	0
sugar substitute	testis cancers	0
phyllanthus emblica	malignant primary brain tumors	0
frier	disrupted in b-cell malignancy	0
canned food	cancer of the testis	0
frozen cranberries	open head injuries	0
pimenta	food hypersensitivity	0
weekly meat	dairy product intolerance	0
plant zygotes	sarcopenia	0
marjoram plant	nonhodgkin lymphoma	0
avenas	human herpesvirus 4	0
mustard seeds	familial tremors	0
maraschino cherry	precordial catch syndrome	0
potassium-rich foods	head pain	0
sesame oil	low-grade b-cell malignancy	0
kava kava	common bile duct calculi	0
dog rose berries	orthostatic headaches	0
algarrobo	mental disorder	0
seafood	oral cancer	0
green beans	appendicitis	0
eat flax	texidor's twinge	0
gooseberry	birth weights	0
chocolate bars	acquired immune deficiency syndrome	0
sea vegetables	strains and sprains	0
piper nigrum	laron type dwarfism i	0
brazil nuts	cacosmia	0
nutrient-dense foods	diverticula	0
added sweeteners	aphthous ulcers	0
morning meal	icterus	0
carbonated beverages	rectal tumor	0
acai berry	myocardial failure	0
white mallow	elevated cholesterols	0
plant-based nutrients	brain cancers	0
eugenia aromatica	massive tremor	0
vicia fabas	tongue cancers	0
gmo soybeans	skin cancers	0
tea hibiscus	neoplasm metastases	0
avocado fruit	acute inflammatory demyelinating polyradiculoneuropathy	0
nutraceutical	prediabetic states	0
healthy snack	parietal region traumas	0
kava kavas	inflammatory disease	0
dessert	episodic cluster headache	0
purine-rich plant	left sided heart failure	0
cuminum cyminums	essential tremors	0
celeriac	non-epileptic convulsions	0
fatty meal	drug hypersensitivity	0
pancake	diffuse small cleaved-cell lymphoma	0
new candy	muscle spasms	0
larder	sprains and strains	0
caryophyllus	multiple myeloma	0
roasted almonds	spongiform encephalopathies	0
melissa	emesis	0
good soybeans	sensory seizure	0
healthiest nuts	cognitive dysfunctions	0
açaí berry	communicable diseases	0
curcuma longa	barretts syndrome	0
anise tea	gastric neoplasm	0
zingiber officinale	neurotic anxiety states	0
nut bar	prostatic hypertrophy	0
fruit-shaped marshmallows	non-hodgkin's lymphoma	0
convenience foods	right sided heart failure	0
blueberry plants	vertebrogenic pain syndrome	0
alcoholic beverages	tonsillar neoplasm	0
cinnamomum cassia	rabies viruses	0
vitamin	substance-induced organic mental disorders	0
lemon	foodborne diseases	0
cinnamomum aromaticum	gehrigs disease	0
ananas	phlebothrombosis	0
frozen spinach	colorectal neoplasms	0
dietary fiber	arthrosis	0
fast foods	marie-struempell disease	0
tuna	ankylosing spondylarthritis	0
high-fructose corn	johne's disease	0
garlic sauce	leukemia virus	0
domestic fowls	penis neoplasms	0
fortify milk	aphthous stomatitis	0
oyster mushrooms	senile osteoporoses	0
garcinia mangostanas	memory disorder	0
carbonated drinks	micturition syncope	0
kidney beans	sudden cardiac death	0
drinking orange	spatial memory disorders	0
no coffee	small cleaved cell lymphoma	0
phyllanthus emblicas	acute monocytic leukemia	0
new york coalition for healthy school food	hepatic cancer	0
whole foods	parkinson's disease	0
solanum tuberosums	arthrosis	0
secale	lower back pains	0
illicium	endometrial neoplasm	0
kawa	ciguatera fish poisonings	0
cocoa plant	age-related memory disorders	0
cycad trees	reduced sensations	0
olive oil	senile tremor	0
anise	age-related macular degenerations	0
component spices	porcine endogenous retroviruses	0
anise seed	sensory seizures	0
mushroom	breast carcinoma	0
include apples	pulmonary disorder	0
grilled meat	benign essential tremor	0
marsh mallows	age related bone loss	0
dasheen	atrial fibrillations	0
citrus bergamia	upper respiratory tract infections	0
domestic fowl	sarcopenia	0
psidium	clear cell meningioma	0
stevia rebaudianas	thyroid carcinomas	0
colorful foods	coronary heart disease	0
black sapote	familial atrial fibrillations	0
hypericum	neoplasm metastasis	0
tachigalia	breast malignant tumors	0
organic plants	drop attacks	0
brain-invasive pork	neurodegenerative diseases	0
cider vinegar	hypospadia	0
coffee	parkinsonism dementia complex of guam amyotrophic lateral sclerosis	0
althaea	salami brusher's disease	0
shiitake mushrooms	barrett's syndrome	0
poppy	texidor twinge	0
cocoa plants	fight cancer	0
petroselinum	intervertebral disc degenerations	0
sun-dried raisin	myocardial ischemias	0
topical ginger	colorectal cancers	0
calendula officinalis	neonatal tremors	0
american meat	prostatic neoplasm	0
euterpe oleracea	esophagus cancer	0
jalapeno	acute confusional migraines	0
blossom	visual seizure	0
brinjal	sliding hiatal hernia	0
hot pepper	prostatic hyperplasia	0
coconut	male breast tumors	0
prunus cerasifera	chronic cluster headache	0
restrict food	multiple myeloma	0
lycium chinense	hepatic failure	0
soybean	gum disease	0
okra	osteoarthrosis deformans	0
chilli pepper	acquired immunodeficiency syndrome	0
sour fruit	diffuse undifferentiated lymphomas	0
poroporo	spinal cord disorders	0
jelly	bacteria-eating virus	0
chewed coca	amyotrophic lateral sclerosis	0
jam	retro-ocular headache	0
intoxicant	gassers syndrome	0
banana plant	small noncleaved cell lymphoma	0
laciniate nightshade	acidosis	0
dark meat	obesity virus	0
capsicum annuum	substance-related disorders	0
soy cheeses	benign neoplasms	1
origanum vulgare	hiccup	0
pretzel	parkinsonian disorders	0
black beans	somatotropin hypersecretion (acromegaly) syndromes	0
herbal teas	cancer of the vagina	0
roundup-ready soybeans	idiopathic polymyositis	0
pea	autosomal recesssive juvenile parkinsonism	0
cucumber	type c oncoviruses	0
chanterelle	carsickness	0
euchresta	bacterial infections	0
not-necessarily-so-healthy foods	insulin-dependent diabetes mellitus	0
plant zygote	cryptogenic epilepsy	0
sugar maple	human cancer	0
uncooked foods	head injuries	0
rheum tanguticum	ovary cancers	0
pease	unilateral headaches	0
sea-food	hysterical blindness	0
pithecolobium	cancer of the testes	0
squashe	galactosemia 3	0
spaghetti	heart diseases	0
brassica nigra	chronic fatigue-fibromyalgia syndrome	0
daucus carota	disseminated sclerosis	0
jambolan plum tree	hemicrania migraines	0
target vitamin	cardiac disease	0
aquatic food	low-grade lymphoma	0
chicken	mad cow disease	0
crataegus monogyna	ekbom psychogenic parasitosis	0
horse beans	retained surgical tools	0
sweetened cereal	horton's syndrome	0
density foods	vitamin deficiency	0
wheat bran	bewilderment	0
corn sugar	mouth cancer	0
citrus limon	fusiform aneurysm	0
healthier foods	familial dementia	0
rubberplant	classic galactosemia	0
maple syrup	gastro-esophageal reflux	0
cinnamon	unilateral headache	0
oreo	autosomal recesssive juvenile parkinsonism	0
chinese rhubarb	infantile botulism	0
coriandrum sativum	acquired immuno deficiency syndrome	0
soda pop	mad cow disease	0
dried food	vaginal cancers	0
rabbit meat	amnesia-memory losses	0
apple tree	familial dementias	0
veal	liver cancer	0
deli meats	renal cancer	0
white rice	mania	0
group foods	et-nanbh	0
zingiber officinales	parasagittal meningioma	0
wild celery	pyrose	0
mustard oil	insulin dependent diabetes mellitus 1	0
cayenne peppers	sick headaches	0
star anise	reduced sensation	0
red rice	colitis	0
chenopodium quinoa	vestibular seizure	0
indian corn	ekbom delusional parasitoses	0
betel nut	deaf-mutism	0
lavender	arrhythmia	0
mother cells	johne disease	0
fennel seeds	tactile amnesia	0
grecian foxglove	wheat hypersensitivity	0
euterpe edulis	spindle-cell carcinoma	0
conventional food	juvenile onset diabetes mellitus	0
mangifera indicas	anal ulcers	0
four nuts	gastroenteritis	0
alfalfa	monocytic leukemia	0
fructose corn	hydrophobia	0
apium graveolens	igf-1 deficiency	0
quinoa	headache syndrome	0
cassia tree	v-cjd (variant-creutzfeldt-jakob disease)	0
canned fruit	limb tremors	0
lens culinari	trochanteric fractures	0
mangosteen	goiter	0
milk thistle	primary gh resistance	0
hashish	prostatitis	0
illicium anisatums	muscular spasm	0
cucumis melo	liver cancer	0
pomelo tree	cancer of testis	0
mustard	colon neoplasm	0
brewed coffee	diffuse undifferentiated lymphomas	0
uncooked food	cognitive decline	0
hop	bipolar depression	0
nuclear power plant	virus infection	0
tisane	sleep-related neurogenic tachypnea	0
pinto bean	cervical migraine syndrome	0
pistachio	hansen's disease	0
flax	airsickness	0
garbanzo	acquired deafness	0
food supplements	infant obesity	0
low-salt diet	fibromyositis-fibromyalgia syndromes	0
arginine-rich foods	thinness	0
plum	malignant tumor of urinary bladder	0
poppy seeds	tongue cancer	0
dairy yogurt	thyroid cancers	0
spinach	head injuries	0
pimpinella anisums	colonic neoplasm	0
baby formula	cancer of the thyroid	0
oregano plants	low backaches	0
fatty foods	non epileptic convulsion	0
woodland strawberry	uterine fibroma	0
frozen broccoli	renal neoplasms	0
almond tree	gingivitide	0
baked potato	penis neoplasms	0
cannabi	macular degeneration	0
mayo	germinoblastic sarcoma	0
candy	radiating pain	0
maguey	cluster headache syndrome	0
processed meat	odontogenic keratocysts multiple basal cell nevi	0
pea family	gastroenteritide	0
beta vulgaris	kidney cancer	0
cantaloupe	chronic fatigue-fibromyalgia syndromes	0
assai palm berries	postural low back pain	0
fagopyrum	communicable diseases	0
tangerine tree	contagious pustular dermatitides	0
coca cola	childhood obesity	0
fruit juices	norovirus	0
ground meat	tactile amnesias	0
vaccinium bracteatum	diabetic mononeuropathies	0
assai palms	schizophrenic disorder	0
common fruits	age-related memory disorder	0
chinese yam	diabetic mononeuropathies	0
cherry plum tree	sliding hiatal hernia	0
vaccinium virgatum	flatulence	0
soy cheese	viral disease	0
healthy snacks	chronic obstructive pulmonary disease	0
carrot	chicken virus	0
foeniculum vulgare	secondary insomnia	0
japanese plums	small noncleaved cell lymphoma	0
calling eggs	premature aging	0
canned foods	lower back pains	0
tea plant	vertiginous seizures	0
frozen fruit	non-hodgkins lymphoma	0
cicer arietinum	high blood pressures	0
oat	cancer of the bone	0
vegetarianism	lung cancers	0
aloe	burning pains	0
endive	tying disease	0
bertholletia excelsa	migraine variant	0
chenopodium quinoas	ph1-negative myeloid leukemias	0
low-fat diet	crohn’s disease	0
carbonated waters	central nervous system intracranial disorders	0
citrus aurantiums	parkinsonism	0
wild bananas	widespread chronic pains	0
almond butter	tumorigenesis	0
goji berry plants	hepatitis	0
anacardium occidentales	migraine disorder	0
barley	basal cell epithelioma	0
cocoa butter	rna tumor viruses	0
replenish nutrients	autosomal dominant parkinsonism	0
dress	progressive disorder	0
soy bean curds	breast carcinomas	1
yoghurt	central nervous system intracranial disorders	0