
almond oil	schizophreniform disorders	0
healthy nuts	cystic breast disease	0
cassia fistulas	prostatic intraepithelial neoplasia	0
organic plants	somatosensory seizure	0
wild celery	atrioventricular dissociations	0
bertholletia	muscle spasm	0
shan yaos	amnesia	0
peppermint	halitose	0
mother cells	guillaine-barre syndrome	0
sweet foods	aphthous stomatitides	0
cocoa plant	periodontal disease	0
breast milk	fibromyalgia fibromyositis syndrome	0
laciniate nightshades	polyp	0
kiwi fruit	fatty liver disease	0
algarrobo	fibrositis	0
white pepper	ischemic heart disease	0
trigonella foenum-graecums	chronic fatigue syndrome	0
plant embryo	foodborne botulism	0
poultry product	rachitide	0
cannabi	familial creutzfeldt-jakob diseases	0
mealtime	liver dysfunction	0
raw cranberries	infantile colic	0
diospyro	craniocerebral injuries	0
chamomile tea	nonalcoholic steatohepatitis	0
greenery	lung disease	0
broad beans	increased cancer	0
rye bread	medical conditions	0
porgy	skin diseases	0
sesame seeds	feline leukemia virus	0
spinacia oleracea	porcine endogenous retroviruses	0
mentha spicata	benign meningiomas	0
rubberplant	kidney stone	0
daucus carota	pulmonary embolisms	0
nicotiana tabacums	acquired immunodeficiency syndrome virus	0
fagopyrum sagittatum	hypersensitivity	0
unfiltered coffee	infant botulisms	0
syzygium sandwicense	menstrual pain	0
cooked broccoli	cancer of the vulva	0
bagel	fibroid uterus	0
fat milk	drug habituation	0
pimenta diocias	amentia	0
canned food	infectious mononucleosis virus	0
rubus fruticosus	somatotropin hypersecretion (acromegaly) syndrome	0
sugar-sweetened beverages	drug hypersensitivities	0
acacia tree	neurotic anxiety state	0
ginger	carcinogenese	0
mushroom	intraepithelial prostatic neoplasias	0
olive	cvas (cerebrovascular accident)	0
wild bananas	symmetric diabetic proximal motor neuropathy	0
raphanus raphanistrum	hemangioblastic meningioma	0
citrus sinensis	coarse tremors	0
indian gooseberry	coarse tremor	0
mackerel	joint pain	0
suggesting apple	bacteria-eating virus	0
acer	pulmonary cancers	0
lemon grasses	germinoblastic sarcomas	0
hamburger	congenital hypothyroidism	0
frying meat	malignant meningioma	0
hemlock	single seizures	0
justicia	lung inflammations	0
fig	hepatocellular cancers	0
grape	diabetic amyotrophy	0
food company	blood cancers	0
nicotiana tabacum	short sleep phenotypes	0
morel	myocardial infarctions	0
find pork	leukovirus	0
blackberry	airsickness	0
component spices	autosomal recessive juvenile parkinson disease 2	0
bread	neurologic degenerative conditions	0
trace element	deafness	0
breakfast cereal	rachitis	0
prettiest fruit	barrett epithelium	0
melissa	undifferentiated carcinoma	0
calling eggs	sudden onset diabetes mellitus	0
allium cepa	generalized headache	0
low fruit	periadenitis mucosa necrotica recurrens	0
thymus vulgari	precordial catch syndrome	0
hawthorn	bone cancer	0
ilex paraguarienses	drop attack	0
pistachio	neurodegenerative disorders	0
fresh basil	saccular aneurysm	0
coco	acute fulminating multiple sclerosis	0
cooked carrots	intraepithelial neoplasm	0
horse nettle	head trauma	0
smoked food	spinal cord degenerative diseases	0
floret	erectile dysfunction	0
coriandrum	unhealthy conditions	0
carya illinoenses	autistic disorder	0
vegetable protein	myocardial ischemias	0
lycium chinense	nephrolith	0
cocoa powders	germinoblastic sarcomas	0
individual candy	gastric neoplasm	0
plantago psyllium	uveitide	0
yerba mate	low-grade lymphomas	0
pistachio nut tree	infantile autism	0
okra	vitamin deficiency	0
breakfast cereals	bronchial asthma	0
potato chips	ekbom psychogenic parasitosis	0
fenugreek seeds	e-b virus	0
raw alfalfa	back pain without radiation	0
raw tomatoes	carcinomatosis	0
dietary protein	fibromyalgia-fibromyositis syndromes	0
cultivated radish	spiral fractures	0
grapefruit	iron deficiency	0
artificial sweeteners	chronic obstructive pulmonary disease	0
soft drink	lung neoplasms	0
apium graveolens var. dulce	non b hepatitis enterically transmitted non a	0
citrus medicas	barrett metaplasia	0
anchovy	vaginal cancers	0
sunflower seeds	adenomatous polyp	0
brassica nigra	artery disease	0
purple rice	prion-induced disorder	0
drink	cancer of pancreas	0
oregano	endocrine breast disease	0
citron trees	cancer of mouth	0
fresh meat	acute confusional migraines	0
barley coffee	cardiogenic syncopes	0
sausage	neurological condition	0
anti-inflammatory foods	thermal hypesthesias	0
plant arils	galactosemia 3s	0
plantago ovata	coronary disease	0
beet greens	bladder cancer	0
soybean proteins	high grade lymphoma	0
melissa officinali	vulvar cancers	0
zucchini	lumbago	0
common fruits	b-cell leukemia	0
scrambled eggs	bovine spongiform encephalopathy	0
solanum tuberosum	uterus cancers	0
last meal	sudden infant death syndrome	0
curcuma	htlv-iii	0
cooking meat	temporary amnesias	0
sticker	cognitive impairment	0
saint johns wort	manic disorders	0
kenaf	brain malignant neoplasms	0
undercooked meat	complete hearing loss	0
pistacia	tonsillar neoplasms	0
energy drink	avian leukosis/sarcoma virus	0
lavandula angustifolia	cancer of tonsil	0
foodstuff	ovarian neoplasms	0
red pepper	horton syndrome	0
yellow vegetables	guam disease	0
agent orange	auto-immune diseases	0
oregano plant	preterm births	0
chenopodium quinoas	fibroid	0
psidium	sleep initiation dysfunction	0
fabaceae	wart viruses	0
chinese yams	car sickness	0
whole grain cereal	airsickness	0
texturized soy proteins	lou-gehrigs disease	0
kombucha teas	cancer of the kidney	0
iceberg lettuce	cretinism	0
steak	deep-vein thromboses	0
almond butter	breast fibrocystic disease	0
sugar maples	minor head injury	0
artificial sweetener	preventable cancers	0
digitalis purpurea	steatohepatitis	0
coriandrum sativums	autosomal recessive juvenile parkinsonism	0
chinese cinnamons	upper respiratory infections	0
pepsi	basal cell epithelioma	0
moose meat	esophagitis	0
texturized vegetable protein	pleomorphic lymphomas	0
lentinus edodes	brains cancer	0
pickled foods	deep-venous thrombosis	0
corylus	confusional state	0
pimiento	somatosensory seizure	0
allium porrum	substance abuses	0
tepary beans	confusion	0
foenumgraecum	senile osteoporoses	0
high fructose maize syrup	cll lymphoplasmacytoid lymphoma	0
entree	crohnâ€™s disease	0
citrus sinenses	eye disease	0
burrito	thyroid cancer	0
hot sauce	common bile duct calculi	0
avocado fruit	craniocerebral injuries	0
anacardium occidentales	transitional meningioma	0
citrus hystrix	continuous tremor	0
squash plants	tonsil cancers	0
gum acacia	chronic daily headache	0
reindeer meat	reticulum-cell sarcoma	0
garden radish	tonsil cancer	0
pineapple	neurocysticercose	0
lunch time	retained surgical needle	0
vegetable oil	burning pains	0
caffeinated coffee	insulin deficiency	0
citrus	auriculo-ventricular dissociations	0
green lentils	virus diseases	0
crataegus monogynas	mixed lymphomas	0
ice cream	cervix cancers	0
taking vitamin	hemangiopericytic meningiomas	0
plantain	barretts esophagus	0
eggnog	scurvy	0
rubus idaeus	deep vein thromboses	0
phaseolus vulgaris	virus infections	0
prunis communis	esophageal reflux	0
radish	preterm births	0
raw poultry	gustatory seizure	0
cocoa plants	breast malignant neoplasms	0
morning meals	diabetes mellitus complications	0
vinegar	orthostatic headaches	0
indian laburnum	human papilloma virus	0
english plantains	chronic lymphocytic leukemias	0
saccharomyces cerevisiae	milk sugar intolerance	0
pimenta diocia	hiatus hernia	0
paprika	polymyositis ossificans	0
drinking water	hyperventilation syncopes	0
scallion	bovine leukemias	0
energy drinks	soft tissue sarcoma	0
gmo soybeans	sneezing	0
baked potato	amnesia	0
amla	reverse cancer	0
plant-based nutrients	cognitive retention disorder	0
food poisoning	intractable headaches	0
citrus x paradisi	inflammatory polyneuropathy acutes	0
colorful foods	bladder cancers	0
solanum melongenas	familial creutzfeldt-jakob disease	0
cashew	substance use disorder	0
american meat	meningiomatosis	0
cuminum cyminum	johnes disease	0
cappari	visceral steatosis	0
coconut milk	memory losses	0
agaricaceae	hiccup	0
citrus bergamias	adenoviridae	0
radicchio	upper respiratory infections	0
colocasia	diffuse well differentiated lymphocytic lymphoma	0
vicia faba	ocular headaches	0
cooked tomatoes	kidney cancers	0
clathrotropis	ovary neoplasm	0
restructured meat	tussive syncopes	0
tea	thyroid cancer	0
eugenia caryophyllata	skin cancers	0
yogurt	infectious mononucleosis viruses	0
tuna fish	weight loss	0
shorten	retained surgical sponges	0
cauliflower	schizophreniform disorder	0
sea-food	chronic cluster headache	0
bertholletia excelsa	myocardial failure	0
navy beans	colitis gravis	0
dairy yogurt	cancer of the vagina	0
citrus aurantiifolias	renal insufficiency	0
almond milk	metabolic acidoses	0
tomato juice	action tremors	0
bell peppers	essential tremor	0
brassica juncea	kidney stones	0
seltzer waters	juvenile-onset diabetes	0
honeybush tea	cancer of the uterine cervix	0
clove	arthritide	0
brazil nut tree	bovine leukoses	0
coriandrum sativum	retained surgical needles	0
solanum lycopersicum	urinary tract infections	0
dietary supplement	colon neoplasms	0
nut	cervical neoplasms	0
big food	johnes disease	0
dioscorea villosa	brain disease	0
carya	fusiform aneurysm	0
powdered sugar	allergy	0
hemp plants	female subfertility	0
virgin olive	autistic disorder	0
roasted almonds	udpglucose 4-epimerase deficiency disease	0
sun-dried raisin	chicken virus	0
almond tree	breast carcinomas	1
milk thistles	diarrhea	0
japanese plums	rabies viruses	0
ready-to-eat meals	human papilloma virus	0
english plantain	hyperpigmentation	0
eating nuts	intraepithelial prostatic neoplasia	0
hemp	breast fibrocystic change	0
drink tea	guam disease	0
plant capsule	epithelioid sarcomas	0
french fries	dehydration	0
ground beef	psammomatous meningioma	0
watercress	kill cancer	0
bolete	deep venous thromboses	0
antioxidant-rich food	contusion	0
norovirus food	jakob-creutzfeldt syndrome	0
myristica fragrans	diabetic autonomic neuropathy	0
black sapote	central obesities	0
anticancer plant	non-hodgkins lymphoma	0
silybum marianum	halitose	0
tree nuts	visual seizure	0
dandelion	angioblastic meningiomas	0
trace mineral	tonic seizure	0
chamomile	ciguatera fish poisoning	0
black rice	cancer of kidney	0
durum wheat	postoperative nausea	0
eragrostus	subwakefullness syndromes	0
lime	mammary cancer	0
solanum melongena	skin neoplasm	0
carduus marianus	copd	0
flower	orthostatic headache	0
animal food	spasm	0
breakfast	gorlin goltz syndrome	0
conventional food	prelingual deafness	0
avocado	reverse cancer	0
club sodas	impaired sensations	0
molasse	clonic seizures	0
processed foods	non-hodgkin lymphoma	0
papaya	infantile colic	0
pinto bean	undifferentiated carcinomas	0
adhatoda	convulsive syncopes	0
junk food	cephalodynia	0
mesquite	cancer of vulva	0
persimmon	galk deficiency	0
pie	colorectal cancer	0
sea vegetables	weight gain	0
lemongrass	infectious diseases	0
pistacia lentiscus	pulmonary disorder	0
sorrel	basal cell nevus syndrome	0
inadequate fruit	sub-fertility	0
hot pepper	fibroid tumor	0
pumpkin seeds	infantile colic	0
white mallows	delusory parasitoses	0
rubus	diabetic asymmetric polyneuropathy	0
amorpha	benign meningiomas	0
weekly meat	type 1 diabetes	0
kiwi fruits	cancer of the vulva	0
stem vegetables	kidney failures	0
sweet marjoram	foreign body	0
origanum vulgare	retained surgical needles	0
pomelo tree	dental diseases	0
dinner time	heart attacks	0
vaccinium corymbosum	colorectal tumors	0
punica granatum	perioral tremor	0
black currant	postoperative vomiting	0
strawberry	syncopal vertigos	0
barberry	pediatric cancers	0
toxic plant	long sleeper syndrome	0
tachigalia	hepatitis	0
trace minerals	vitamin deficiency	0
eating almonds	heart attacks	0
antioxidant vitamin	cancer of the pancreas	0
avena	physical suffering	0
chewing gum	hiatus hernias	0
noncaloric sweetener	lung cancers	0
cherry plum tree	cancer of the skin	0
eggplant	graves disease	0
fennel seeds	impaired sensation	0
apricot	polyradiculoneuritis	0
black raspberries	severe gh insensitivity	0
honey	cancer of vulva	0
lycium	mouth neoplasm	0
fruit and vegetable juices	pulmonary thromboembolisms	0
beef	lung neoplasm	1
aloe vera	uveitide	0
fragaria	breast fibrocystic changes	0
currant	myelogenous leukemia	0
fructose corn	irritable bowel syndrome	0
emblica officinalis	kidney stones	0
garcinia mangostanas	blood cancer	0
cinnamomum verum	cancer of rectum	0
basil	apnea	0
safflower oil	chronic lymphoblastic leukemia	0
roundup-ready soybeans	adolescent obesity	0
tepary bean	cognitive dysfunction	0
areca catechus	develop cancer	0
jalapeno pepper	orthostatic headache	0
nori	prostate neoplasms	0
acer saccharum	cancer of rectum	0
arginine-rich foods	mixed lymphoma	0
ephedras	exudative bronchiolitis	0
woodland strawberries	premature birth	0
marsh mallows	severe congenital microcephalies	0
animal-based foods	bilateral sciatica	0
orange trees	malignancy	1
aÃ§aÃ­ berries	leukemogenic virus	0
rye	premature aging	0
green peas	gustatory seizures	0
allium sativum	multiple myositides	0
orange	non epileptic convulsion	0
eugenia sandwicensis	brain diseases	0
bergamot	sensory seizure	0
apple tree	headache	0
hibiscus cannabinus	limb tremor	0
crataegus	bronchiolitis	0
nut butter	cardiac diseases	0
specific foods	aids virus	0
melissa officinalis	reduced sensation	0
olive oil	coronary disease	1
cannabis	food-borne illnesses	0
human milk	ekbom dermatozoic delusion	0
lipomul	prostatic intraepithelial neoplasms	0
tangerine trees	dermatozoic delusion	0
popular fruits	gorlin syndrome	0
ovary	schizoaffective disorder	0
gui zhi	visual seizure	0
common bean plant	esophagitis	0
mangosteen	stokes adams syncope	0
cucumis melo	thrombose	0
sea bilberry	primary parkinsonism	0
syzygium cumini	classic galactosemia	0
seed	severe mental disorders	0
toronja	atherogenesis	1
consumer protection scientific committee on food	intraventricular meningiomas	0
java plum tree	prostate neoplasm	0
white bread	coronary heart disease	0
soy milk	chronic fatigue fibromyalgia syndrome	0
regular olive	chronic pain	0
pea families	manic-depressive psychoses	0
roughage	rete testis tumor	0
lard	minor head injuries	0
pimpinella anisum	tonic seizure	0
low vitamin	female sterility	0
legume pod	stomach cancer	1
spearmint	galactosemia 2s	0
eating food	tonsil neoplasms	0
french bean plant	sudden cardiac death	0
cynara scolymus	fever	0
delonix	ciguatera fish poisoning	0
oryza sativa	well-differentiated lymphocytic lymphoma	0
sunfish	breast tumor	0
pudding	sleep initiation dysfunction	0
cannabis sativa	lewy body parkinson disease	0
cycad	gastric neoplasm	0
haritaki fruit	utp hexose 1 phosphate uridylyltransferase deficiency disease	0
different seed	pancreatic cancers	0
chicken salad	developed cancer	0
capsicum annuum	disc degradation	0
fryer	osteoarthrosis	0
brassica	ms (multiple sclerosis)	0
dried yeast	pulmonary diseases	0
watermelon	dysfunction	0
thyme	plasma-cell myelomas	0
poroporo	arterial dysfunction	0
soy beverages	severe mental disorder	0
phaseolus	pseudoaphakia	0
maraschino cherry	esophagitide	0
deli meat	hypoxemia	0
sprout	bladder neoplasms	0
cayenne	gale deficiencies	0
mussel	encephalopathy	0
sugary foods	wheat allergies	0
pineapple juice	respiratory tract cancer	0
use sweeteners	joint disease	0
betel nuts	hemolytic uremic syndrome	0
sweet almond	hemolytic uremic syndrome	0
nettle	blood cancer	0
trompillo	udp galactose 4 epimerase deficiency	0
tangerine tree	obesity	0
buttermilk	regional ileitis	0
mango	chronic headaches	0
lunch times	parasagittal meningioma	0
assai palm	prediabetic state	0
common olive tree	reticulum-cell sarcomas	0
walnut	penis neoplasm	0
corn syrup	thrombose	0
emblica officinali	rachitis	0
justicia adhatoda	familial dementia	0
herb	creutzfeldt jakob disease	0
wine	mad cow diseases	0
dragon fruit	benign brain neoplasm	0
seven nutrients	human papillomavirus viruses	0
earl grey tea	involuntary quiver	0
black walnuts	substance abuse	0
bean sprouts	cancer of the bone	0
jalapeno peppers	sleep disorder	0
sugar	heart block	0
citrus-based fruits	tubal abortion	0
sugar maple	guillain-barrÃ© syndrome	0
seltzer water	head injuries	0
rooibos	lens opacities	0
grecian foxglove	toxic megacolon	0
pleurotus ostreatus	short sleeper syndromes	0
food colors	galk deficiency	0
chinese yam	infectious mononucleosis virus	0
real chocolate	anaplastic carcinoma	0
rice milk	necrotizing fasciitis	0
prunus cerasifera	cancer of the lung	0
lunchtime	brain malignant neoplasm	0
baker's yeast	ovary neoplasms	0
thymus vulgaris	presyncope	0
mustard seeds	burn	0
hickory nut	epimerase deficiency galactosemia	0
silken tofu	hepatic failure	0
candy bar	strain	0
jambolan plum tree	hemolytic jaundice	0
aquatic food	gastro-oesophageal reflux	0
prosopi	congestive heart failure	0
turmeric	anoxemia	0
stevia rebaudiana	memory losses	0
ceylon cinnamon	degenerative neurologic disorder	0
usda poultry	involuntary quiver	0
pimenta officinali	hepatocellular cancers	0
crataegus monogyna	adenomatous polyps	0
potassium-rich foods	diabetic autonomic neuropathies	0
indian corn	liver dysfunctions	0
organ	chronic obstructive pulmonary disease	0
gravy	recurrent brain tumors	0
ground meat	adenovirus	0
foxglove	backache	0
humulus lupulus	foodborne illnesses	0
paella	basal cell epithelioma	0
cucumis melos	xanthomatous meningiomas	0
citrus bergamia	benign meningioma	0
beverage	cranial pains	0
split peas	lung cancer	0
cured meats	malignant lymphoma	0
cassia	ebv	0
triticum durum	spatial memory disorders	0
chocolate bars	craniocerebral injury	0
plant-based foods	strains and sprains	0
solanum laciniatum	painful diabetic neuropathy	0
restrict food	cancer-causing herpesvirus	0
fermented foods	fibrocystic breast disease	0
yerba mates	ekbom dermatozoic delusion	0
euterpe precatoria	diffuse undifferentiated lymphoma	0
croaker	female infertility	0
malus domestica	craniocerebral injury	0
sweet basils	hepatitide	0
nut bars	skin cancers	0
grapefruit juice	non b hepatitis enterically transmitted non a	0
illicium anisatums	atrioventricular dissociations	0
ultra-processed food	body weights	0
root	breast malignant tumor	0
elettaria cardamomums	muscular cramps	0
celery	cholera	0
anise	weight reductions	0
java plum trees	block cancer	0
high fructose corn syrup	sudden cardiac arrests	0
stevia rebaudianas	spasm	0
apium graveolens	rectal neoplasm	0
stryphnodendron	malaria	0
fragaria vesca	fibroatheromatous plaques	0
crab apples	nonorganic insomnia	0
no-calorie sweeteners	oral neoplasm	0
uncooked foods	scurvy	0
sparkling water	atypical cluster headaches	0
cocoanut	enzootic bovine leukoses	0
fiddlehead ferns	guillaine-barre syndrome	0
brassica napus	prion-induced disorder	0
bean sprout	intraepithelial neoplasm	0
high-fiber food	nasal cavity cancer	0
fatty meal	abdominal aortic aneurysm	0
cortland	pulmonary cancer	0
garlic	diabetes-related complications	0
berry	chicken virus	0
mentha piperita	mouth cancers	0
sandwich	fibroid uterus	0
dietary plant proteins	tumor virus	0
red peppers	substance use disorder	0
flax	inflammatory bowel disease 1	0
mangiferas	acute stroke	0
seafood	ekbom delusional parasitoses	0
sweetening agents	ekbom dermatozoic delusions	0
margarine	periodontal disease	0
foie gras	corpse	0
soy cheeses	light-headedness	0
soy beverage	acquired immuno deficiency syndrome	0
banana plants	v-cjd (variant-creutzfeldt-jakob disease)	0
health food	melanoma	0
pleurotus	back pain without radiation	0
hibiscus tea	gehrigs disease	0
cycad trees	bacterial infections	0
tomato sauce	porcine endogenous retroviruses	0
celeriac	insulin-dependent diabetes mellitus 1	0
rose berries	neuralgic migraine	0
salad	primary insomnia	0
cucumis sativus	tonsil cancer	0
apple trees	substance-related disorders	0
calendula officinali	rectal cancer	0
four nuts	non-epileptic convulsions	0
low-sodium diet	liver cancer	0
norus	cancer of the vagina	0
sugar substitutes	ischemia	0
triticum turgidum subsp. durum	pediatric cancers	0
cassia tree	intestinal disease	0
silybum marianums	salmonellosis	0
cola nitida	clonic seizure	0
bottled water	cancer of the tonsil	0
organic foods	hansen's disease	0
sardine	vulva neoplasms	0
official vitamin	back aches	0
brinjal	virus diseases	0
curry powder	hysterical amnesias	0
trace elements	bacterial infections	0
density foods	vulvar cancer	0
cacao bean	malignant tumor of urinary bladder	0
fuji apples	headache disorders	0
guibourtia	parkinsons disease	0
kohlrabi	sharp headache	0
chinese rhubarb	brains cancer	0
poultry products	insomnia disorders	0
monosodium glutamate	intractable headaches	0
grilled meat	barrett metaplasia	0
cranberry	ekbom delusional parasitosis	0
rheum	migratory pain	0
eat chocolate	barrett syndrome	0
vaccinium uliginosum	acute autoimmune neuropathies	0
purslane	spinal cord degenerative diseases	0
belladonna	primary malignant brain neoplasms	0
rheum officinale	barretts esophagus	0
curcuma zedoarias	fight cancer	0
handling meat	indigestion	0
soybean	higher cancer	0
infects apples	head injuries	0
andropogon nardus	atherogenesis	0
cocoa powder	newborn gynecomastia	0
candy bars	motion sickness	0
amaranth	varix	0
trigonella	colonic neoplasm	0
ribe	ciguatera	0
coriander	testis cancers	0
pummelo tree	right-sided heart failure	0
kawa	small non cleaved cell lymphoma	0
rubus glaucus	high-grade lymphoma	0
cuminum cyminums	b-cell leukemia	0
milk thistle	infantile botulism	0
neutraceutical	cardiogenic syncopes	0
euterpe	plasmodium infections	0
drinking coffee	back pain with radiation	0
soy beans	proteinuria	0
rise	cancer of kidney	0
roselle	scorbutus	0
olive family	gangrene	0
brewed coffee	gall stones	0
adhatoda vasica	alopecia cicatrisata	0
new candy	psychogenic parasitosis	0
origanum majorana	pill rolling tremor	0
zedoary zedoaria	autistic disorders	0
black currants	acute inflammatory polyneuropathies	0
pecan	malaria	0
shiitake mushroom	fibrositide	0
brain-invasive pork	wart viruses	0
kidney bean	breast carcinomas	0
opium poppies	human papillomavirus virus	0
tarragon	head pains	0
prunus dulcis	retrovirus	0
so-called meat	heartburn	0
beetroot	ciliary neuralgias	0
bell pepper	tactile hypesthesia	0
curcuma longas	parkinsonism-dementia complex of guam amyotrophic lateral sclerosis	0
espresso	ovarian neoplasm	0
apricot trees	rest tremors	0
baby formulas	tongue neoplasm	0
coca	pleomorphic lymphomas	0
nightshade	phage	0
pithecellobium	muscle spasm	0
individual food	macular dystrophy	0
zea mays	resting tremors	0
black walnut	olfactory seizures	0
cabbage	obesity virus	0
cookie	odontogenic keratocysts multiple basal cell nevi	0
acid-binding vegetables	hypoxia	0
added nuts	campylobacter infection	0
overpriced vitamin	disorders of initiating and maintaining sleep	0
kola nuts	neurocysticercosis	0
emphasize plant	neurotic anxiety states	0
vaccinium virgatum	bipolar affective psychoses	0
food additives	norovirus	0
raisin	bilateral deafness	0
cantaloupe	foreign objects	0
gluten-free diet	skin rash	0
daily nut	oral cancers	0
salmonella food	utp hexose 1 phosphate uridylyltransferase deficiency	0
chilli peppers	muscular cramp	0
fake meat	stokes-adams syncope	0
pimenta	stomach ulcers	0
kavas	substance-related disorders	0
grape seeds	crushing skull injuries	0
trigonella foenum graecum	spiral fracture	0
dried apples	oncovirinae	0
anise tea	sclerosis	0
goji berries	endometrial cancer	0
cleistocalyx	breast tumor	0
acaÃ­ berries	arterial fatty streaks	0
different fruits	parkinson disease	0
citrus grandis	acute autoimmune neuropathies	0
cocktail	craniocerebral injury	0
safflower	proliferative bronchiolitis	0
dried foods	parkinson disease	1
cilantro	autosomal dominant. juvenile parkinson disease	0
mayo	bone fractures	0
whole foods	liver dysfunctions	0
seville orange trees	chronic headache	0
halibut	migraine disorders	0
prunus persica	udpglucose hexose 1 phosphate uridylyltransferase deficiency	0
faba bean	ileocolitis	0
pease	bovine lymphosarcomas	0
goiaba	senile osteoporosis	0
cold-steeping tea	persistent tremors	0
curcuma longa	human immunodeficiency virus	0
ganja	retained surgical tool	0
psyllium	huntingtons disease	0
glycine max	cancer of bone	0
jambolan plum trees	nonalcoholic steatohepatitis	0
crabapple	small noncleaved-cell lymphoma	0
teff	oral neoplasms	0
jasmine tea	early-onset parkinsonism	0
turmeric root	menstrual pain	0
cocos nucifera	familial dementia	0
frozen broccoli	cervical neoplasm	0
dangerous plants	intention tremors	0
raphanus sativus	galactosemia 3s	0
maize oil	non epileptic convulsion	0
vitamin	cancer of the vagina	0
bertholletia excelsas	posterior fossa meningioma	0
atropa belladonna	human t-lymphotropic virus type iii	0
citrus reticulatas	muscle sorenesses	0
seville orange tree	vestibular seizures	0
include fennel	nutritional disease	0
amygdalus communis	autosomal dominant. juvenile parkinson disease	0
squash seeds	malignant epithelial neoplasm	0
syzygium jambolanum	cryptogenic epilepsies	0
curry	acute monocytic leukemia	0
alcohol	familial creutzfeldt jakob disease	0
rutabaga	cluster headache	0
romaine	multiple sclerosis	0
bhang	temporary amnesia	0
hordeum vulgare	coronary disease	0
durum wheats	anal fissure	0
pasta	infertility	0
healthier meat	vagina neoplasms	0
pecan trees	perioral tremors	0
medicago sativa	cranial pains	0
cardamon	intraorbital meningiomas	0
jalapeno	brain disease	0
wheat bran	benign meningiomas	0
whole grain	acute stroke	0
chewing gums	human immunodeficiency virus	0
wheat	inflammation	1
cooking oil	cancer of the uterus	0
liquor	transmissible spongiform encephalopathies	0
butter milk	weight reduction	0
rooibo	groundnut hypersensitivity	0
prunus domestica	cancer of the esophagus	0
caramel	appendicitis	0
healthiest vegetable	visual seizures	0
cannabis indicas	galactosemia 2	0
citrus fruit	pustulosis palmaris et plantaris	0
tumeric	juvenile onset diabetes	0
citrus reticulata	early detection of cancer	0
assai palm berries	sprue	0
sweet potatoes	involuntary quivers	0
sunchoke	malignant epithelial tumors	0
flax seed	tonic clonic seizures	0
molasses	mixed-cell lymphomas	0
brewage	lens opacities	0
linum usitatissimum	malignant tumor of breast	1
junk foods	hot flashes	0
fermented cabbage	diverticula	0
healthy snacks	autosomal recessive juvenile parkinsonism	0
pea family	brain diseases	0
bitter orange tree	bladder neoplasm	0
petroselinum crispums	enterocele	0
meal	severe congenital microcephalies	0
eating broccoli	cardiac diseases	0
parsley	gehrigs disease	0
black coffee	sclerosis	0
red meats	wheat hypersensitivity	0
taraxacum	mucous colitis	0
weed	foodborne botulism	0
msg	saccular aneurysm	0
soy bean	udpglucose 4-epimerase deficiency disease	0
food manufacturers	memory losses	0
hibiscus sabdariffa	saturnine tremors	0
box elders	spinal meningioma	0
pithecolobium	enzootic bovine leukosis	0
snack food	diabetes related complications	0
da huang	kidney failures	0
rhubarb	clear cell meningioma	0
raw foods	autosomal dominant juvenile parkinson disease	0
dasheen	steatosis of liver	0
jell-o	pancreatitis	0
aÃ§aÃ­ berry	prostatic hypertrophy	0
salt-free diet	nonalcoholic fatty liver	0
worldwide fruit	microcystic meningioma	0
infant formula	prostate cancer	0
lavender	idiopathic parkinson disease	0
green pepper	poultry viruses	0
fenugreek seed	graveâ€™s disease	0
kava kavas	jakob-creutzfeldt syndrome	0
sugar substitute	myelopathy	0
frying foods	rhabdomyolys	0
phaseolus vulgari	arthralgia	0
healthiest snack	gall stone	0
preserved food	chronic cluster headache	0
monitoring food	deep-venous thrombosis	0
dioscorea batatas	breast neoplasm	0
color	galactosemia iii	0
cider	small non-cleaved-cell lymphoma	0
brew	pituitary dwarfism ii	0
no meat	action tremors	0
actual fruit	atypical diffuse small lymphoid lymphoma	0
alpine strawberries	adenosis of breast	0
triticum aestivum	early onset parkinson disease autosomal recessive	0
chinook salmon	autism	0
cocos nuciferas	small and large cleaved-cell lymphoma	0
soy	human immunodeficiency virus	0
althaea	hysterical amnesias	0
mustard oil	higher cancer	0
ready-to-eat meal	renal calculus	0
mandarin orange tree	cancer of the uterus	0
brewing tea	thyroid diseases	0
herbal teas	myeloid leukemia	0
common plant	right sided heart failure	0
eating eggs	experimental parkinsonism	0
sustenance	joint diseases	0
soy foods	shock	0
ground ginger	pneumonia	0
sauerkraut	cerebral stroke	0
granny smith apples	fibrositide	0
baking chocolate	sciatic neuralgia	0
syrup	infantile autism	0
areca	hepatitis e	0
philadelphia cream cheese	human influenza	0
hydroponic basil	tussive syncopes	0
eugenia cumini	persistent tremors	0
group foods	colorectal neoplasms	0
whole grains	pernicious vomiting of pregnancy	0
narrow leaved plantain	thyroid disease	0
lemon tree	canker sores	0
tea hibiscus	guillaine-barre syndrome	0
mentha spicatas	benign prostatic hyperplasia	0
thymus plant	vaginitis	0
including cloves	primary fibromyalgias	0
dried pomegranate	chronic b-lymphocytic leukemias	0
citrus aurantiifolia	male breast carcinoma	0
texturized vegetable proteins	degenerative arthritis	0
ready soybeans	amnestic state	0
high-fat meal	thrombose	0
citrus aurantium	pharyngitide	0
saffron	subacute spongiform encephalopathies	0
caryophyllus aromaticus	acquired blindness	0
soy bean proteins	schizoaffective disorder	0
shoot	colicky pain	0
morinda	spiral fractures	0
rabbit meat	birth defects	0
leguminosae	transmissible spongiform encephalopathies	0
mustard plant	nonhodgkins lymphoma	0
whiting	muscular cramps	0
opium poppy	urinary bladder neoplasm	0
herr	muscular cramp	0
popcorn	essential tremor	0
animal-based vitamin	drug abuse	0
indian laburnums	cancer of the penis	0
whole grain cereals	pyrose	0
healthiest apple	penile cancers	0
beta vulgaris	acute confusional migraines	0
healthy fruit	steatosis of liver	0
fast foods	new variant creutzfeldt-jakob disease	0
low-calorie diet	postoperative emesis	0
crab apple	pharyngitis	0
family vegetables	diffuse myofascial pain syndrome	0
carica papaya	amnesia-memory losses	0
prunus salicinas	bronchiolitide	0
flax seeds	fibromyalgia	0
mentha x piperita	somatotropin (acromegaly) hypersecretion syndrome	0
pomegranate	overeat	0
lens plant	mouth neoplasm	0
tea leaves	brain benign neoplasms	0
breakfast times	xanthomatous meningiomas	0
syzygium malaccense	histamine cephalgia	0
unhealthy food	social phobias	0
chewing fruit	mucous colitides	0
yeast rice	diabetes mellitus complication	0
endive	joint pain	0
egg	diffuse lymphoma	0
whortleberry	gum disease	0
brown sugar	polyphagia	0
topical ginger	cancer of the bone	0
spinach	cancer-causing viruses	0
club soda	stomatognathic diseases	0
prunus amygdalus	severe congenital microcephalies	0
antioxidant foods	ph1-negative myelogenous leukemias	0
term vegetable	birth defect	0
tofu	food hypersensitivity	0
orange tree	gale deficiencies	0
antioxidant fruits	malignant lymphoma	0
hickory trees	colorectal carcinomas	0
infant formulas	temporal region trauma	0
probiotic	inflammatory demyelinating polyneuropathy	0
holy basils	chronic lymphocytic leukemia	0
alfalfa sprouts	diffuse lymphoma	0
ribes nigrum	campylobacter infections	0
unfertilized eggs	food borne diseases	0
aubergine	guillaine barre syndrome	0
billion eggs	peripheral artery disease	0
isoglucose	occipital region trauma	0
wild yam	pill rolling tremor	0
wild celeries	retroviridae	0
green teas	sub-fertility	0
table salt	chronic insomnia	0
mastic tree	creutzfeldt-jakob disease	0
glycyrrhiza glabra	galactose 1 phosphate uridyltransferase deficiency	0
food allergy	sore throats	0
ketchup	appendicitis	0
carbonated mineral water	chronic b-cell leukemias	0
dressing	lymphatic sarcomas	0
chili pepper	mouth cancer	0
soya milk	penis cancers	0
red rice	migraine headaches	0
favorite meals	inflammatory disorder	0
ilex paraguariensis	disc degenerations	0
cicer	primary brain tumors	0
avoid peanuts	myelomatose	0
holy basil	osteoarthritis	0
cymbopogon nardus	cll lymphoplasmacytoid lymphomas	0
bilberry	deep-vein thrombosis	0
snack foods	parodontosis	0
illicium	mild cognitive impairments	0
cranberry juice	nonalcoholic fatty liver disease	0
nutmeg	beriberi	0
oat	insulin sensitivity	0
colophospermum	orf	0
multivitamin	transmissible spongiform encephalopathies	0
food supplement	seizure disorders	0
soft drinks	craniocerebral injury	0
chinese food	small round structured viruses	0
shellfish	olfactory groove meningioma	0
cinnamon	syndrome	0
raw food	periodontal diseases	0
star anise	superficial head injury	0
carbonated water	postural syncopes	0
thousand foods	psammomatous meningiomas	0
diospyros digyna	pneumonitis	0
tisane	adenoviridae	0
maize	cerebrovascular accidents	0
snack	chronic headache	0
juglan	complete hearing loss	0
food allergies	polyradiculoneuritis	0
ocimum basilicum	proliferative bronchiolitides	0
dairy products	cryptogenic epilepsy	0
amomum cardamomum	cluster headache	0
squid	disorders of initiating and maintaining sleep	0
regular carrots	gingivitis	0
consumed chocolate	rectal cancer	0
raphanus	peripheral arterial disease	0
safflower oils	suppuration	0
healthiest beverages	impotence	0
apium graveolens var. rapaceum	constipation	0
portulaca oleracea	prostatic adenoma	0
vegetarianism	udpglucose 4 epimerase deficiency disease	0
pisum sativum	kidney failures	0
vaccinium bracteatum	abdominal migraines	0
catfish	v-cjd (variant-creutzfeldt-jakob disease)	0
aloe	ph1 negative myeloid leukemia	0
chinese cassia	fibromyalgia-fibromyositis syndromes	0
soy cheese	muscle sorenesses	0
chickpea	pancreatic cancer	0
rose	schizophrenic disorders	0
eugenia jambolana	malignant meningiomas	0
spice turmeric	rabies viruses	0
chard	nonalcoholic fatty liver	0
ranking foods	diabetic asymmetric polyneuropathies	0
black tea	amaurosis	0
milk protein	pulmonary diseases	0
potato	aphthous stomatitides	0
cheese	gastric cancers	0
nuclear power plant	breast carcinoma	0
deep-fried foods	hepatic cancer	0
pyrus	wart viruses	0
goji berry plants	dissociative amnesias	0
plant zygotes	brain malignant neoplasm	0
red lentils	communicable diseases	0
portulaca	creutzfeldt-jakob syndrome	0
saffron crocus	gastric neoplasms	0
rooibos tea	ramsay hunt paralysis syndrome	0
low-salt diet	experimental parkinsonism	0
bitter nightshade	coarse tremor	0
lemon grass	cervix neoplasm	0
preserved foods	human t-lymphotropic virus type iii	0
green beans	bovine leukemia virus	0
fava beans	toxico infectious botulism	0
banana plant	renal calculi	0
woodland strawberry	laron dwarfism	0
vaccinium myrtillus	ekbom delusional parasitoses	0
convenience foods	delusory parasitosis	0
dried food	hemangioblastic meningioma	0
retail poultry	intraepithelial neoplasm	0
areca nuts	epithelioid sarcomas	0
crunch berries	oncogenic viruses	0
irritable bowel kiwi fruit	necrotizing fasciitis	0
oregano plants	symptom clusters	0
shiitake mushrooms	leiomyoma	0
vital nutrients	penis cancer	0
purple grape	deficiency diseases	0
mustard greens	hip fractures	0
marihuana	syncopal vertigo	0
food companies	huntingtons disease	0
willow tree	uveitis	0
sugar water	primary growth hormone resistance	0
lycopersicon esculentum	liver steatosis	0
myristica fragran	diffuse well-differentiated lymphocytic lymphoma	0
afzelia	chronic illness	1
cacao	basal cell carcinoma	0
sushi	colon neoplasms	0
cayenne pepper	meningiomatose	0
dark meat	small cleaved cell lymphoma	0
black teas	huntingtonâ€™s disease	0
dried cranberries	substance abuses	0
oolong tea	physical anhedonia	0
cinnamomum cassia	tongue neoplasms	0
grouper	atheroma	0
collard green	near-death experience	1
euterpe oleracea	neuritic plaque	0
betel nut	disrupted in b-cell malignancy	0
squash plant	muscle pain	0
salmonella-infected eggs	urinary bladder diseases	0
pomegranate fruit	brief reactive psychosis	0
venison	progressive disorder	0
lemon	pregnancy induced diabetes	0
domestic fowls	back pains	0
bitter nightshades	myocardial infarct	0
flavorer	intraepithelial prostatic neoplasias	0
digitalis	heart disease	0
antioxidant food	coma	0
fruit juices	thyroid adenoma	0
dietary plant protein	low-grade b-cell malignancy	0
soda pops	hemicrania migraines	0
nut butters	tubal abortion	0
white mallow	atrioventricular dissociation	0
carica	malignant melanoma	0
assai palm berry	acquired immunodeficiency syndromes	0
narrow-leaved plantain	reticuloendotheliosis virus	0
sea food	pancreatic cancers	0
chile pepper	fighting cancer	0
artificial butter	cancer of the breast	0
citrus hystrices	aphthous stomatitis	0
pumpkin	tubal abortion	0
dinner	bovine lymphosarcomas	0
mastic trees	hepatitide	0
soy food	postoperative nausea and vomiting	0
broth	chronic daily headache	0
curcuma zedoaria	bone fractures	0
kawa kawa	chest pains	0
largest meal	pustulosis palmaris et plantaris	0
sweeten	ileocolitis	0
fennel	human herpesvirus 4	0
wheat brans	hepatitis e	0
natto	lassitude	0
cocoa butter	malignant lymphomas	0
green grapes	anticancer	0
shiitake	low back pains	0
petroselinum crispum	chronic obstructive pulmonary disease	0
big apples	syncopal episode	0
mandarin orange trees	myeloid leukemia	0
carica papayas	acquired immuno-deficiency syndrome	0
fava bean	situational syncopes	0
barley	eye disease	0
sweet marjorams	throbbing headache	0
capparis	testis neoplasms	0
hashish	macular degeneration	0
citrus fruits	syncopal episode	0
sesame	neurodegenerative disorders	0
citrus paradisi	pancreatic neoplasm	0
gooseberry	cancer of the vulva	0
hypericum perforatum	recrudescence	0
foeniculum vulgare	cancer of vagina	0
boiled eggs	parkinsonism dementia complex of guam amyotrophic lateral sclerosis	0
frozen cranberries	rebound insomnia	0
whale meat	cellulite	0
carbonated drink	liver diseases	0
amomum cardamomums	intraorbital meningiomas	0
faba beans	breast fibrocystic changes	0
saint johnswort	memory loss	0
mirobalanus embilicas	nonhodgkins lymphoma	0
portulaca oleracae	periorbital headache	0
decrease meat	substance abuse	0
healthiest foods	bacteriophage	0
saint john's wort	gallbladder disease	0
pinto beans	prostatitis	0
hickory tree	pediatric cancers	0
fast food	reticulum cell sarcoma	0
psidium guajavas	coma	0
international nut	epileptic seizures	0
plum trees	galactosemia 2s	0
garcinia mangostana	light headedness	0
dessert	tongue cancer	0
flesh foods	cancer of breast	0
coconut	tumor	0
bad foods	glaucoma	0
lemon verbena	eye diseases	0
hop	experimental parkinsonism	0
no noni	sick headache	0
aspalathus	gallbladder diseases	0
banana	virus infection	0
powdered ginger	foreign objects	0
origanum onites	osteoarthrose	0
dinner times	bacteria-eating virus	0
milk chocolate	diabetic neuralgias	0
plantago arenaria	enzootic bovine leukoses	0
romaine lettuce	intractable headache	0
dietary supplements	monocular blindness	0
sell meat	spasm	0
illicium verums	cardiogenic syncopes	0
brussels sprouts	nbcc	0
chamomile oil	renal cancers	0
purple cabbage	male breast neoplasms	0
drink milk	spindle-cell carcinomas	0
pretzel	short sleep phenotype	0
pimpinella	gall bladder diseases	0
ocimum tenuiflorum	ketosis-prone diabetes mellitus	0
abelmoschus	tumor	0
food and drug administration	animal viruses	0
applesauce	urinary bladder cancer	0
intoxicant	human t cell leukemia virus type iii	0
cooked meats	senile paranoid dementias	0
broccoli raab	orthostasis	0
coconut oil	diabetic complication	0
aspalathus linearis	malignant brain neoplasm	0
dried apple	psychosis	0
ocimum sanctum	spinal cord degenerative diseases	0
vaccinium macrocarpon	neurologic degenerative disease	0
crowberry	hyperphagia	0
horse bean	brain tumors	0
leek	treat cancer	0
high-fructose corn	soft tissue sarcoma	0
thymus plants	manic states	0
persea americanas	b cell chronic lymphocytic leukemia	0
vegetable juice	mixed lymphomas	0
jelly	urticaria	0
organic milk	epstein barr virus	0
triticum spelta	spiral fracture	0
healthy food	papillary meningiomas	0
kava	parkinson disease	0
placenta	prostatic intraepithelial neoplasms	0
kangaroo meat	sprue	0
salsa	occipital traumas	0
golden raisins	ovary cancers	0
ice creams	subtrochanteric fractures	0
japanese plum	flatus	0
calendula officinalis	nonalcoholic fatty livers	0
good soybeans	epstein-barr virus	0
macadamia	fibroatheromatous plaques	0
psidium guajava	diabetic neuralgias	0
illicium verum	subacute spongiform encephalopathy	0
cherry	intermittent tremor	0
plantago seed	experimental parkinsonism	0
saint john wort	cognitive dysfunctions	0
healthiest beverage	headache disorder	0
dioscorea opposita	cot deaths	0
chipotle	johne disease	0
eupatorium rebaudianums	acute autoimmune neuropathy	0
happy meal	galactosemia iiis	0
corn sugar	diabetic complication	0
exotic fruit	laron type dwarfism i	0
stevia	food hypersensitivity	0
processed food	action tremors	0
diospyros digynas	cardiovascular stroke	0
actual licorice	sneezing	0
dietary fats	spiral fracture	0
filtered coffee	human papilloma virus	0
wild yams	muscle pains	0
uncooked food	schizophreniform disorder	0
cereal grains	tactile amnesia	0
white wine	malignant neoplasm of breast	0
fagopyrum	polyradiculoneuropathy	0
fenugreek	impotence	0
lamb chops	contagious pustular dermatitis	0
callerya	lymphoplasmacytoid lymphoma	0
portulaca oleraceas	bacterial vaginosis	0
cannabis indica	burkitt lymphoma virus	0
red meat	mouth and tooth diseases	0
ocimum basilicums	gluten enteropathies	0
chinese cassias	neoplasm metastases	0
bibhitaki fruit	breast tumors	0
plaice	broken bone	0
blueberry	iron overload	0
true nut	kidney cancers	0
extracted fruit	carcinogenese	0
bean	prostatic intraepithelial neoplasm	0
foeniculum vulgares	chronic headaches	0
euterpe oleracea mart.s	paroxysmal atrial fibrillation	0
goji berry plant	diabetes related complications	0
cod	fibrocystic mastopathy	0
kava kava	pruritis	0
sour fruit	chronic airflow obstructions	0
salami	sleep-related neurogenic tachypnea	0
pistachio nut trees	germinoblastoma	0
solanum	food-borne disease	0
thymus	parkinsonian disorders	0
poppy seeds	exanthem	0
phyllanthus emblica	galactosemia 2	0
cereal	insomnia	0
meal times	infant botulism	0
concord grapes	pill rolling tremors	0
hickory nuts	muscle cramp	0
domestic fowl	galactose epimerase deficiency	0
nut bar	kidney calculus	0
punicaceae	papillary meningiomas	0
oreo	cancer of the colon	0
grecian foxgloves	diabetic polyneuropathies	0
yolk	colitide	0
vaccinium bracteatums	diverticulum	0
golden delicious apples	prion protein disease	0
coconut water	high blood pressure	0
vitis vinifera	pulmonary neoplasm	0
contaminated meat	communicable diseases	0
eugenia jambos	torsion fracture	0
dried blueberries	common bile duct gallstones	0
blossom	primary malignant brain tumors	0
narrow-leaved plantains	clear cell meningioma	0
licorice root	gastroenteritis	0
artichoke	syncopal vertigos	0
apple	ekbom delusory parasitosis	0
bacon	zoonotic infectious disease	0
cream cheese	lightheadedness	0
alfalfa	tumorigenese	0
white meat	respiratory tract infection	0
zea	chronic b-cell leukemias	0
cumin	splitting pain	0
sesamum	faint	0
frosting	kanner syndrome	0
apple juice	involuntary quivers	0
meal time	neurodegenerative diseases	0
caper	extreme hearing loss	0
poisonous plants	iron overload	0
garbanzo	abdominal aortic aneurysm	0
solanum laciniatums	adenosis of breast	0
asparagus	oral cancer	0
spicy food	olfactory groove meningioma	0
sockeye salmon	stroke	0
monkfish	galt deficiency	0
fungus	meningiomatosis	0
andean blackberry	ekbom dermatozoic delusion	0
beer	non-alcoholic fatty liver disease	0
soy yogurt	psammomatous meningioma	0
corn oils	cardiovascular diseases	0
erythroxylon	malignant neoplasm of breast	0
almond trees	v-cjd (variant-creutzfeldt-jakob disease)	0
pickled vegetables	sciatic neuralgias	0
orange juice	uterine cancer	0
juiced broccoli	brain conditions	0
andira	painful menstruations	0
pimpinella anisums	creutzfeldt-jakob syndrome	0
poultry meat	peripheral artery disease	0
new york coalition for healthy school food	cardiac disease	0
lucerne	new variant creutzfeldt-jakob disease	0
avenas	cancer of pancreas	0
chinese cinnamon	non-epileptic convulsions	0
coca cola	male breast enlargement	0
black pepper	action tremor	0
mirobalanus embilica	pulmonary neoplasms	0
cardamom	penile cancers	0
citrus maxima	limb cramp	0
maguey	pruritus	0
horsebean	mental deterioration	0
pecan tree	iron overload	0
anti-inflammatory plant	colon cancers	0
aÃ§ai berries	endocrine breast disease	0
vitamin pills	postoperative vomiting	0
diabetic diet	fibrosis	0
texturized soy protein	severe congenital microcephalies	0
flaked coconut	mottled enamels	0
arugula	breast fibrocystic disease	0
baby spinach	disc degeneration	0
syzygium aromaticum	delusory parasitoses	0
warm milk	bovine spongiform encephalopathy	0
mastictree	prostatic intraepithelial neoplasias	0
beet	feline leukemia virus	0
osmanthus	episodic cluster headache	0
fortify milk	insulin resistance	0
carbonated beverage	carcinomatose	0
added sweeteners	cancer of kidney	0
teosinte	generalized seizure	0
chocolate	peripheral artery diseases	0
adding blueberries	polyradiculoneuritide	0
horsemeat	single seizure	0
secale cereale	cancer of ovary	0
sweet orange	mucous colitis	0
sweet basil	bladder diseases	0
cinnamomum zeylanicum	thyroid diseases	0
fries	occipital region trauma	0
cassia fistula	nerve tremors	0
processed meat	pneumonitide	0
herbal tea	uterine neoplasm	0
cruciferous vegetable	chronic lymphatic leukemia	0
tuna	deep-vein thromboses	0
boiled broccoli	chronic b-lymphocytic leukemia	0
coleslaw	sprue	0
chicken meat	muscle pain	0
linum usitatissimums	breast tumors	1
fagopyrum tataricum	hemangioblastic meningiomas	0
own vitamin	drop attack	0
mother cell	philadelphia negative myeloid leukemia	0
low-fat diet	liver neoplasm	0
guava	substance-related disorders	0
lentil	chronic infectious mononucleosis-like syndrome	0
acer negundo	autoimmune condition	0
fruit-shaped marshmallows	gastroesophageal reflux disease	0
split pea	atrial fibrillation	0
pomegranate seeds	a-v dissociations	0
white tea	food-borne illnesses	0
confection	et-nanbh	0
food coloring	continuous tremor	0
beta vulgari	drug abuse	0
cocoa	skin cancer	0
vaccinium ashei	feminization	0
syzygium	myelopathy	0
exotic fruits	semirhythmic tremor	0
pummelo trees	gastro-oesophageal reflux	0
deep-fry foods	autoimmune disorders	0
lactuca sativa	oncovirus	0
red delicious apples	parasagittal meningiomas	0
lemon balms	uterine fibromas	0
oatmeal	exanthem	1
cultivated oat	chronic fatigue disorders	0
plantago	hypercholesterolemia	0
granny smith	genital warts	0
national pork	proteinuria	0
ceratonia	premature births	0
rosehip	leukemogenic virus	0
whole wheat	muscular cramps	0
malus	myalgia	0
chia seeds	brain vascular accidents	0
black beans	bses (bovine spongiform encephalopathy)	0
english walnut	small-cell lymphoma	0
olea	human papilloma viruses	0
poultry	irritable bowel syndrome	0
fagopyrum esculentum	papillary meningiomas	0
osmanthus tea	venereal warts	0
raspberry	colorectal tumor	0
carthamus tinctorius	sleep initiation dysfunctions	0
dried apricots	myocardial infarctions	0
triticum turgidum	marsh fever	0
breakfast time	sneezing	0
cuminum	tumor	0
quinoa	ulcerative colitis	0
berberi	urinary bladder cancer	0
organ meats	jaundice	0
phyllanthus emblicas	manic disorder	0
phytonutrient-rich food	dyschezia	0
yam	left-sided heart failure	0
nettle tea	hay fever	0
organic food	gallstone	0
eating fruits	low back pain	0
veggie	bse (bovine spongiform encephalopathy)	0
bamboo shoots	hot flashes	0
cucurbita	disk degradation	0
plant kingdom	epileptic seizure	0
alfalfa sprout	uterine neoplasms	0
dog rose berries	respiratory tract infections	0
study lavender	testicular neoplasms	0
dress	bipolar disorders	0
bok choy	episodic cluster headache	0
chile peppers	common cancers	0
euterpe edulis	premature births	0
carrot	dementia with amyotrophic lateral sclerosis	0
aÃ§ai berry	coronary disease	0
peach trees	retained surgical instrument	0
collard greens	gall stones	0
licorice	beriberi	0
calendula	membranous cataract	0
spice saffron	cancer-causing herpesvirus	0
juglans nigra	chronic fatigue syndromes	0
lens plants	amentia	0
cranberry sauce	groundnut hypersensitivity	0
olive trees	mixed-cell lymphomas	0
solanum dulcamara	spondylarthritis ankylopoietica	0
arachis hypogaea	central nervous system degenerative diseases	0
machaerium	chronic b-lymphocytic leukemias	0
grape juice	long sleeper syndrome	0
oxen meat	malignant primary brain neoplasms	0
berberis	tonic clonic seizures	0
dairy eggs	foreign objects	0
pumpkin pie	retroviridae	0
iv vitamin	massive tremors	0
ephedra	non b hepatitis epidemic non a	0
glucose fructose syrup	manic depressive psychosis	0
phaseolus acutifolius	migraine disorder	0
swordfish	deficiency diseases	0
swiss chard	insulin dependent diabetes mellitus	0
carrot juice	childhood onset obesity	0
morning meal	clonic seizures	0
high-fructose maize syrup	diverticulum	0
dietary fat	schizophrenic disorder	0
maize oils	allergic diseases	0
citrus aurantiums	bovine leukemia	0
cola	graves disease	0
mangifera	mastalgia	0
oyster mushroom	senile tremor	0
soymilk	colonic cancer	0
bread mold	familial dementias	0
golden glow	exanthem	0
neu5gc-rich food	skin rash	0
national meat	sick headache	0
pepper	benign brain neoplasm	0
baby formula	marsh fever	0
kola nut	subwakefullness syndrome	0
glycyrrhiza	zoonotic disease	0
betel	marie struempell disease	0
dietary sugars	saccular aneurysm	0
hypericum perforatums	lou-gehrigs disease	0
green peppers	ph1 negative myeloid leukemia	0
pistil	spondylarthritis ankylopoietica	0
black sapotes	milk sugar intolerance	0
millet	subwakefullness syndrome	0
nonus	orthostatic headaches	0
kiwi	early awakening	0
abelmoschus esculentus	basal cell epithelioma	0
holy basil tea	familial diffuse gastric cancer	0
anacardium	norwalk-like viruses	0
proteus mirabilis	menstrual pain	0
treat	mouth cancers	0
carbonated mineral waters	intervertebral disc degeneration	0
trigonella foenum-graecum	cellulite	0
frequent meals	arrhythmia	0
celery root	chromosome 6 linked autosomal recessive parkinsonism	0
sweetener	testicular cancers	0
cow's milk	severe mental disorder	0
foeniculum	varicose veins	0
coffee	primary malignant brain neoplasms	0
sea bilberries	mild neurocognitive disorder	0
flavoring	small lymphocytic lymphomas	0
deli meats	macular dystrophies	0
drinking tea	numbness	0
no coffee	galactosemia iii	0
sour orange tree	bone fracture	0
skim milk	leucocythemia	0
store licorice	atherosclerotic plaque	0
tobacco	neurodegenerative disorders	0
red yeast rice	spiral fractures	0
carbonated waters	intermittent tremor	0
malabar-nut	constrictive bronchiolitides	0
dietary sucrose	mouth cancer	0
morinda citrifolias	laron syndrome	0
red onions	amyloidose	0
pomelo trees	syndrome	1
taro	cervix cancers	0
healthiest nuts	delusional parasitoses	0
hordeum	water stress	0
acer negundos	back pains	0
marshmallow	spiral fracture	0
golden delicious	female sub-fertility	0
triticum vulgare	rabies	0
sweetening agent	muscular cramps	0
flowering shrub	sub-fertility	0
higher vegetable	intraepithelial carcinoma	0
jerusalem artichokes	social anhedonia	0
butternut squash	macular degeneration	0
elettaria	mental disorders	0
frozen spinach	bone neoplasm	0
zinger tea	diffuse mixed cell lymphoma	0
chili	head injury	0
mangifera indicas	respiratory tract infection	0
cured meat	mouth neoplasm	0
little saffron	angiomatous meningiomas	0
citrus medica	painful diabetic neuropathies	0
soy sauce	hypoascorbemia	0
healthy snack	tonsillar neoplasms	0
lycium barbarum	water-borne hepatitis	0
bt corn	lactose malabsorption	0
leaf lettuce	rachitis	0
dioscorea	cancer of ovary	0
eupatorium rebaudianum	reduced sensation	0
collard	endometriosis	0
dripping	osteoarthrosis	0
pork	food-borne illnesses	0
secale	brain vascular accident	0
toxic plants	auto-immune diseases	0
fried foods	nbcc	0
ale	retained surgical sponges	0
poenumgraecum	crohn's enteritis	0
tea plant	age related bone loss	0
english walnuts	cerebrovascular accidents	0
lima beans	saturnine tremors	0
curried tofu	chronic fatigue disorders	0
peach tree	female sub fertility	0
peach	peripheral arterial diseases	0
alcoholic beverage	pill rolling tremor	0
almond	polyp	0
edible grains	inflammatory bowel disease 1	0
cucumber	semirhythmic tremor	0
chanterelle	mixed lymphocytic-histiocytic lymphomas	0
cayenne peppers	leukemogenic virus	0
emphasizes vegetables	brain disorder	0
crocus	disk degradations	0
rheum tanguticum	inflammatory bowel diseases	0
lemon trees	mouth neoplasm	0
hypericum	syncopal vertigos	0
stuff	eczematous dermatitis	0
veal	dermatosis	0
acai berries	jakob creutzfeldt syndrome	0
eugenia aromatica	thyroid disease	0
turnip	brain cancer	0
kawa kawas	chronic b-cell leukemias	0
ultra-processed foods	drug allergy	0
plant zygote	peanut allergies	0
leafy vegetables	flatulence	0
legume pods	chronic obstructive lung disease	1
alpine strawberry	fibromyalgia	0
caryophyllus	galactosemia iii	0
sweetened cereal	testis neoplasms	0
contamination meat	malignant epithelial tumors	0
corn oil	diverticulitide	0
maple syrup	pulmonary disorder	0
soy proteins	laron dwarfism	0
lens culinari	insomnia disorders	0
smoked foods	pancreas neoplasm	0
wort	posterior fossa meningiomas	0
jelly beans	myocardial infarctions	0
cicer arietinum	cancer-causing herpesvirus	0
tomato	protein deficiencies	0
rosa	temporal region traumas	0
prebiotic	pharyngitide	0
cupcake	aortic aneurysms	0
recommend tea	tactile hypesthesias	0
zedoary zedoarias	texidor's twinge	0
celebration meal	ulcerative colitis	0
solanum dulcamaras	hemicrania migraine	0
bran flakes	autosomal recessive familial parkinson disease	0
corn	hiatus hernia	0
wisconsin milk	multiple myositis	0
apricot tree	dwarfism	0
artificially-flavored corn	male breast neoplasms	0
alcoholic beverages	nonhodgkins lymphoma	0
chewed coca	gastro-oesophageal reflux	0
rosemary	substance induced organic mental disorders	0
reason food	cancer of the lung	0
drug administration united states food	human t-cell lymphotropic virus type iii	0
vicia fabas	postural syncopes	0
peppermint oil	salmonellosis	0
persea americana	cluster headache syndromes	0
healthier foods	inflammatory polyneuropathy acutes	0
citron tree	chest pain	0
eat flax	mesothelioma	0
mint	udp-galactose-4-epimerase deficiency diseases	0
rowanberry	deglutitional syncopes	0
crave chocolate	cat leukemia virus	0
white potatoes	senile paranoid dementias	0
wild radish	ebv	0
atropa belladonnas	human papilloma viruses	0
fresh fruits	pulmonary thromboembolisms	0
cassia trees	male sub fertility	0
lemon balm tea	elevated cholesterol	0
walnut oil	experimental parkinson disease	0
tulsi tea	congenital abnormality	0
pear	abdominal migraine	0
olea europaea	bladder neoplasm	0
nutritional yeast	viral diseases	0
sour orange trees	cardiac death	0
raw broccoli	central obesities	0
kidney beans	diabetic retinopathy	0
solanum tuberosums	dental diseases	0
dietary fibers	periadenitis mucosa necrotica recurrens	0
sweet almonds	soft tissue sarcoma	0
elephant garlic	cryptogenic epilepsies	0
anise seed	dementia with amyotrophic lateral sclerosis	0
marjoram plants	muscle cramp	0
new vitamin	abdominal pain	0
althea officinalis	tactile hypesthesia	0
commercial milk	endometrial neoplasm	0
nuclear power plants	pancreas cancer	0
milkshake	premature aging	0
hot peppers	tonsil neoplasm	0
poisonous plant	cancer of skin	0
healthy foods	convulsive seizures	0
ficus	virus infection	0
health nuts	endometrial cancer	0
spaghetti	central nervous system intracranial disorders	0
theobroma cacao	esophageal hernias	0
garlic sauce	pediatric cancers	0
chicken	fighting cancer	0
maize syrup	idiopathic polymyositides	0
elettaria cardamomum	syncopal episodes	0
prenatal vitamins	type i diabetes mellitus	0
know nuts	dna injury	0
squashe	juvenile parkinsonism	0
natural vitamin	cognitive retention disorder	0
piper methysticums	atherosclerosis	0
pistacia vera	syndrome	1
dietary fiber	udp-galactose-4-epimerase deficiency disease	0
sweet pepper	jakob-creutzfeldt disease	0
star anises	subacute spongiform encephalopathies	0
capsicum	breast cystic diseases	0
hummus	dermatozoic delusions	0
marsh mallow	philadelphia negative myeloid leukemia	0
lavandula	protein deficiencies	0
oolong	pituitary dwarfism ii	0
pea	parkinsons disease	0
tv dinners	mammary cancer	0
guacamole	memory deficit	0
common foxglove	tussive syncope	0
purple potatoes	senile plaque	0
offal	pancreatic neoplasm	0
nicotiana	non b hepatitis epidemic non a	0
camomile	mouth cancers	0
replenish nutrients	micturition syncope	0
food supplementations	acute inflammatory polyneuropathy	0
convenience food	diabetes-related complication	0
dark chocolate	sleep disorder	0
common olive trees	mental deteriorations	0
antioxidant-rich foods	herpesvirus	0
vegetable juices	diabetic polyneuropathy	0
arachis	cervical cancer	0
sea vegetable	rectum neoplasm	0
hibiscus	acromegaly	0
mustard plants	micturition syncopes	0
eating meat	vulvar neoplasm	0
red wine	rectum neoplasm	0
chilli pepper	terminal ileitis	0
organic meat	gehrigs disease	0
low meat	fights cancer	0
maple	variant creutzfeldt jakob disease	0
experience food	periorbital headaches	0
plantago indica	intermediate grade lymphoma	0
mangifera indica	smell disorder	0
vitis	uterine cervical cancer	0
linseed	parkinson disease 2	0
cola acuminata	painful menstruation	0
chenopodium quinoa	disk degeneration	0
sesame oil	drug allergy	0
sesame oils	anthrax	0
citrullus	impaired sensations	0
common bean plants	rectal neoplasm	0
jam	benign intracranial hypertension	0
supper	faint	0
whipped cream	mouth cancers	0
high-phytate foods	cancer of kidney	0
majorana hortensis	parkinson disease	0
soup	anthrax	0
pimenta officinalis	classic galactosemias	0
century plants	female pattern baldness	0
tap water	ankylosing spondylarthritides	0
incorporate cloves	acute strokes	0
eragrostis	mastalgia	0
retail meat	non hodgkin lymphoma	0
poppy	tonsil cancer	0
anacardium occidentale	sciatic neuralgias	0
sweetleaf	fetal iodine deficiency disorder	0
baby carrots	drug use disorders	0
cinnamomum trees	rhabdomyolys	0
pancake	polyradiculoneuropathy	0
brussel sprout	cardiogenic syncopes	0
poppy seed	regional ileitides	0
papaver	heatstroke	0
cooked meat	diffuse lymphomas	0
bellis	cephalgia syndrome	0
cultivated oats	gorlin goltz syndrome	0
olive tree	peripheral autoimmune demyelinating disease	0
canned foods	hepatic failure	0
wolfberry	pancreatic cancers	0
mustard	faint	0
amlas	cervix neoplasms	0
dioscorea polystachya	central obesity	0
raw garlic	confusion	0
zingiber officinales	lymphosarcoma	0
mashed potatoes	stroke	0
flaxseed	lymphocytic lymphomas	0
processed meats	pharyngitis	0
food additive	delusional parasitosis	0
red tea	pulmonary inflammation	0
canned fruit	utp-hexose-1-phosphate uridylyltransferase deficiency disease	0
sparkling waters	vagina cancers	0
feather meal	bechterew disease	0
green tea	autoimmune disease	0
cassia cinnamon	lymphadenopathy-associated viruses	0
include flaxseed	irritable bowel syndromes	0
specific nuts	basal cell epitheliomas	0
pine nuts	sphenoid wing meningiomas	0
lemon balm	severe congenital microcephaly	0
serve	burn	0
dog rose	bladder tumors	0
chocolate pudding	primary gh resistance	0
sweet peppers	cancer of the mouth	0
fed beef	bechterew disease	0
morinda citrifolia	pseudocoma	0
ginger ale	inflammatory disease	0
potable water	dissociative amnesia	0
soda water	galactokinase deficiency disease	0
origanum	broken bone	0
drinking orange	acute inflammatory polyneuropathy	0
incorporates cloves	single seizures	0
glucose-fructose syrup	bladder tumor	0
dairy product	cardiac dysrhythmia	0
peanut	female sub-fertility	0
raw meat	gnathostomiasis	0
red cabbage	exudative bronchiolitides	0
decaffeinated tea	hysterical blindness	0
piper nigrum	parkinson disease 2	0
plantago lanceolata	reticulum-cell sarcoma	0
mentha	deep venous thromboses	0
oyster mushrooms	peripheral autoimmune demyelinating disease	0
daily fruit	parkinsonism dementia complex of guam amyotrophic lateral sclerosis	0
linum	memory disorders	0
acer saccharums	acute inflammatory polyradiculoneuropathy	0
plum tree	central obesities	0
assai palms	iron overload	0
suggesting fruit	bipolar affective psychosis	0
andean blackberries	wart	0
soy bean curds	cognitive decline	1
peanut butter	schizophreniform disorders	0
rice	diabetic amyotrophy	0
cherry plum trees	sexual dysfunction	0
chamomile oils	acidosis	0
soda waters	tubal abortion	0
dietary supplementations	graveâ€™s disease	0
liquorice	sliding esophageal hernia	0
areca catechu	ekbom dermatozoic delusion	0
cruciferous foods	spatial memory disorders	0
macadamia nuts	rabies viruses	0
steamer	small and large cleaved-cell lymphoma	0
ananas	male pattern alopecia	0
olive oils	acquired immune deficiency syndrome virus	0
juglans regia	arrhythmia	0
cider vinegar	norovirus	0
marijuana	influenza	0
ready prepared foods	liver injury	0
rose hips	idiopathic proctocolitis	0
turkey meat	prostatic intraepithelial neoplasms	0
oats	bovine lymphosarcoma	0
piper methysticum	philadelphia negative myeloid leukemia	0
edible grain	tonic seizure	0
aspartame	persistent atrial fibrillations	0
prunus armeniaca	treat cancer	0
include apples	schizophreniform disorders	0
prunus salicina	pneumonitis	0
miso	sleeplessness	0
nutrient-dense foods	manic depressive psychosis	0
blueberry plant	morning sickness	0
arecas	food-borne illnesses	0
chlorella	dental fluoroses	0
avena sativa	cancer of liver	0
punica granatums	hypospadia	0
malabar nut	male breast neoplasms	0
soy bean curd	skin disease	0
cicer arietinums	back pain	0
hemp plant	male impotence	0
breast milks	mink encephalopathy virus	0
red delicious	breast diseases	0
dietary proteins	pruritus	0
chai tea	crushing skull injury	0
cinnamomum aromaticum	mixed-cell lymphomas	0
vaccinium angustifolium	pyrexia	0
empty calorie foods	utp hexose 1 phosphate uridylyltransferase deficiency	0
petroselinum	fine tremor	0
prosopis	hereditary galactokinase deficiency	0
nitrate-rich vegetables	male impotence	0
cymbopogon	hepatic failure	0
persea	postoperative nausea	0
dinnertime	familial guillain-barre syndrome	0
horsenettle	aura	0
fruit juice	pancreatic cancers	0
food poisonings	cancer of kidney	0
yoghurt	malignant melanoma	0
flounder	pruritis	0
longevity legumes	neoplasm metastases	0
processing meat	posterior fossa meningioma	0
chestnut	primary brain neoplasms	0
buckwheat	type 1 diabetes mellitus	0
kombucha tea	cancer of uterus	0
fresh ginger	pulmonary disorder	0
cannabis sativas	respiratory tract infection	0
table sugar	copd	0
kale	blood cancer	0
carbonated drinks	cancer viruses	0
ready-prepared foods	dna injury	0
refined olive	cephalalgia	0
nutraceutical	heart blocks	0
plum	inflammatory disorder	0
agave	cancer of the skin	0
allspice	fine tremors	0
althaea officinalis	long sleeper syndrome	0
dried fruit	galactose-1-phosphate uridylyltransferase deficiency	0
decaf	myalgic encephalomyelitis	0
musa	rhabdomyolys	0
squash	intractable headache	0
citrus limon	effort syncope	0
flavourer	epilepsy	0
soy protein	olfaction disorder	0
milk proteins	small noncleaved-cell lymphoma	0
muffin	diverticulitide	0
lens culinaris	aura	0
candy	oral cancer	0
carya illinoensis	small cleaved-cell lymphoma	0
hazelnut	essential tremor	0
vaccinium macrocarpons	premature aging	0
marjoram	zoonosis	0
food pyramid	abdominal pains	0
target vitamin	penile neoplasms	0
carbonated beverages	penile neoplasms	0
eden foods	sinusitide	0
digitalis lanata	chromosome 6-linked autosomal recessive parkinsonism	0
onion	benign brain neoplasm	0
dried peas	muscle tenderness	0
horse beans	higher cancer	0
gala apples	benign brain neoplasms	0
taraxacum officinale	apnea	0
dried fruits	paraesophageal hiatal hernias	0
oryza	mechanical low back pain	0
biometal	kidney insufficiency	0
food supplements	pancreas neoplasm	0
diabetic diets	aids virus	0
flammulina velutipes	craniocerebral injury	0
brazil nuts	galactose-1-phosphate uridyltransferase deficiency	0
pureed apples	pattern baldness	0
wheatgrass	carcinomatosis	0
unrefined plant	crohnâ€™s disease	0
common foxgloves	heart decompensation	0
plant embryos	ekbom delusory parasitosis	0
frier	exudative bronchiolitis	0
fatty foods	muscular cramps	0
purine-rich plant	lumbago	0
copaifera	pseudocoma	0
sour cream	intervertebral disk degeneration	0
ready-prepared food	occipital region traumas	0
ground flax	thyroid adenoma	0
butter	menstrual disorders	0
specific cheeses	non-hodgkin lymphoma	0
green onions	necrotizing fascitides	0
laciniate nightshade	persistent tremors	0
so-called vegetable	subfertility	0
white rice	human immunodeficiency viruses	0
humulus	renal cancers	0
bitter orange trees	urticaria	0
larder	familial dementia	0
measuring food	stomach ulcer	0
noni fruit	male impotence	0
porphyra	colon cancer	0
filbert	familial creutzfeldt-jakob disease	0
drinking milk	intermediate grade lymphoma	0
processed apples	breast tumor	0
rheum rhaponticum	cat leukemia viruses	0
goji berry	classic galactosemias	0
not-necessarily-so-healthy foods	stokes adams syncope	0
raisin bran	pseudocoma	0
baptisia	occipital region trauma	0
eugenia malaccensis	osteoarthrose	0
cereal grain	cancer viruses	0
laudable legume	lymphosarcoma	0
fat foods	colorectal neoplasms	0
spore	intracranial cns disorders	0
acai berry	vulva cancer	0
octopus	malignant epithelial tumors	0
citronella	spongiform encephalopathies	0
french bean plants	convulsive seizures	0
legume family	malignant melanoma	0
shan yao	retained surgical instrument	0
zingiber officinale	atrial fibrillations	0
vegetable proteins	a-v dissociations	0
soda pop	low backaches	0
little meat	saturnine tremors	0
macadamia nut	vulvar cancers	0
euchresta	post-traumatic osteoporoses	0
plant capsules	gall bladder diseases	0
papaver somniferum	tumor viruses	0
indian gooseberries	heartburn	0
dried plums	brain malignant neoplasms	0
triticum	kidney failure	0
handling food	pneumonitis	0
kaffir lime	visual seizures	0
horse nettles	near-death experience	0
chervil	non hodgkin lymphoma	0
vodka	necrotizing fasciitis	0
syzygium jambos	elevated cholesterol	0
gluten	brain neoplasm	0
nutriceutical	respiratory tract cancer	0
blueberry plants	kill cancer	0
crocus sativus	heart attacks	0
century plant	fibrositide	0
frozen fruit	spasm	0
california avocado	global amnesia	0
lettuce	zoonotic diseases	0
flammulina	ovarian cancer	0
snail meat	vulvar neoplasms	0
marjoram plant	drop attack	0
mint tea	testicular neoplasm	0
nonfat meal	nonalcoholic fatty livers	0
broccoli	bilateral sciaticas	0
mock meats	vestibular seizure	0
milk	b cell leukemia	0
healthiest fruits	cataract	0
big meals	chronic lymphoblastic leukemia	0
contaminated foods	zoonotic disease	0
anana	granulomatous colitis	0
plant aril	amyotrophic lateral sclerosis	0
dietary soybean proteins	involuntary quiver	0
snacktime	chronic daily headache	0
citrus grandi	premenstrual tension	0
pizza	fatigue	0
chili peppers	avitaminose	0
tempeh	mouth cancers	0
illicium anisatum	regional enteritis	0
concord grape	ketosis prone diabetes mellitus	0
carob	persistent atrial fibrillation	0
brown rice	acne vulgaris	0