
oxen meat	crib death	0
vaccinium ashei	renal failures	0
nitrate-rich vegetables	early-onset parkinsonism	0
justicia adhatoda	manic disorders	0
stevia	preterm birth	0
snacktime	encephalon diseases	0
poenumgraecum	perioral tremor	0
ultra-processed foods	small cell lymphoma	0
euterpe	familial atrial fibrillation	0
lipomul	acute fulminating multiple sclerosis	0
willow tree	human influenzas	0
pease	acquired immunodeficiency syndromes	0
crab apple	sinusitis	0
dried peas	wheat allergies	0
low-sodium diet	tubal abortions	0
olive oil	gehrig's disease	0
sweetening agents	recurrent brain tumor	1
euterpe precatoria	migratory pains	0
althaea	oncogenic viruses	0
yoghurt	somatotropin hypersecretion (acromegaly) syndrome	0
citron trees	anoxemia	0
salami	leukemia virus	0
fiddlehead ferns	heart attack	0
healthiest foods	e-b viruses	0
watermelon	resting tremors	0
woodland strawberry	peripheral artery diseases	0
portulaca oleracea	urticarias	0
soya milk	female sterility	0
poroporo	angioblastic meningioma	0
broth	ovary cancers	0
soy proteins	pseudopelade	0
sweet basil	undifferentiated lymphomas	0
milk proteins	rna tumor viruses	0
origanum onites	barrett syndrome	0
poisonous plants	oncogenic virus	0
hummus	experimental parkinsonism	0
mentha spicatas	infantile obesity	0
black sapotes	brain benign neoplasms	0
aspalathus	apneas	0
snack foods	rna tumor virus	0
apricot tree	amaurose	0
tomato juice	symptom clusters	0
deep-fried foods	tonic seizures	0
legume pods	basal cell carcinomas	0
leafy vegetables	esophagus cancer	0
cured meat	experimental parkinson disease	0
antioxidant fruits	diabetic amyotrophies	0
golden delicious	b cell leukemia	0
acer	nervous system degenerative diseases	0
spore	penis neoplasm	0
daily fruit	fibroatheromatous plaque	0
raw food	secretory meningioma	0
collard	muscle sorenesses	0
indian gooseberries	head pains	0
official vitamin	myalgic encephalomyelitis	0
soy cheese	barrett syndrome	0
citron tree	hhv-4	0
lycopersicon esculentum	colorectal cancers	0
gala apples	multiple meningiomas	0
tuna	sharp headache	0
squash	liver failure	0
white tea	lung inflammations	0
national pork	odontogenic keratocysts multiple basal cell nevi	0
phyllanthus emblica	microcephaly	0
almond trees	dysosmia	0
hibiscus sabdariffa	hepatic failure	0
durum wheat	human immunodeficiency virus	0
natural vitamin	ache	0
healthy fruit	aneurysm	0
organic plants	atherogenesis	0
caffeinated coffee	thyroid carcinomas	0
lens culinaris	bladder tumors	0
milkshake	human immunodeficiency virus	0
raphanus sativus	colon neoplasms	0
herr	beriberi	0
chickpea	cervix neoplasms	0
chewing fruit	hypersensitivity	0
new vitamin	transitional meningioma	0
amaranth	jakob-creutzfeldt disease	0
food supplement	post-traumatic osteoporoses	0
nut	malignant epithelial tumor	0
filbert	rash	0
red meat	cerebral stroke	0
actual licorice	parkinsonian syndrome	0
allium cepa	colorectal cancer	0
drinking coffee	common cold	0
largest meal	elevated cholesterols	0
agent orange	central nervous system intracranial disorders	0
century plants	persistent atrial fibrillations	0
vegetable oil	bipolar depression	0
trigonella foenum-graecums	psychogenic parasitosis	0
wisconsin milk	nafld	0
pistacia	early onset parkinson disease autosomal recessive	0
french fries	sleep-related neurogenic tachypnea	0
baby spinach	gum disease	0
clathrotropis	determination of death	0
butter milk	increase cancer	0
true nut	iritide	0
goji berry plant	carcinogenic retroviruses	0
nori	cancer viruses	0
tea	undifferentiated carcinomas	0
anise tea	small non cleaved cell lymphoma	0
trompillo	textiloma	0
garlic sauce	myalgia	0
neutraceutical	dementia with amyotrophic lateral sclerosis	0
ground flax	deep-venous thrombosis	0
corylus	rectum cancer	0
soy bean	degenerative intervertebral disk	0
parsley	intermediate grade lymphoma	0
not-necessarily-so-healthy foods	lymphadenopathy associated virus	0
component spices	small lymphocytic lymphoma	0
roasted almonds	wound botulisms	0
cocktail	nutritional disease	0
apium graveolens	fibrocystic mastopathy	0
mother cells	prostate disease	0
bitter orange trees	colon cancer	1
probiotic	pediatric obesity	0
foeniculum	cognitive retention disorders	0
ceylon cinnamon	excess cancer	0
decaf	generalized seizures	0
almond	hypoxia	0
apricot	varix	0
eupatorium rebaudianum	oral cancer	0
basil	endometrial neoplasm	0
okra	feline lymphoma viruses	0
whole wheat	colorectal tumor	0
marshmallow	newborn gynecomastia	0
fennel	stokes-adams syncope	0
shiitake	urinary bladder diseases	0
papaya	prion-associated disorders	0
energy drink	diffuse small cleaved-cell lymphoma	0
white wine	thrombose	0
rubus fruticosus	throbbing headache	0
baked potato	beriberi	0
coconut milk	amyotrophic lateral sclerosis-parkinsonism-dementia complex 1	0
chewed coca	sprains and strains	0
orange	polyphagia	0
porgy	hemicrania migraine	0
almond oil	heart failure	0
dripping	pulmonary thromboembolisms	0
greenery	renal insufficiency	0
domestic fowl	polyarthralgia	0
thymus plant	increased cancer	0
mangifera indica	non-hodgkins lymphoma	0
elettaria cardamomums	anxiety disorder	0
vaccinium angustifolium	cardiac arrhythmias	0
alfalfa	mild cognitive impairments	0
dinnertime	acute strokes	0
triticum vulgare	small non-cleaved-cell lymphomas	0
pasta	androgenic alopecias	0
espresso	foodborne disease	0
topical ginger	kanner syndrome	0
food coloring	breast cystic diseases	0
black walnuts	respiratory tract cancer	0
mastic tree	parkinsonian syndromes	0
steamer	tonic clonic seizures	0
bibhitaki fruit	celiac sprue	0
edible grains	inherited human transmissible spongiform encephalopathies	0
soy beans	esophageal neoplasm	0
tap water	high-grade lymphomas	0
ocimum basilicum	paraesophageal hernias	0
dried plums	microcystic meningiomas	0
rosa	mucous colitides	0
alcoholic beverage	unilateral headache	0
cow's milk	neurological condition	0
food additive	severe mental disorder	0
oolong tea	exanthema	0
cranberry juice	intraepithelial prostatic neoplasias	0
vaccinium uliginosum	ph1-negative myelogenous leukemias	0
fat milk	neoplasm	0
muffin	high blood pressures	0
dietary fiber	cluster headache	0
fatty meal	idiopathic parkinson's disease	0
yellow vegetables	syncope	0
organic food	acidosis	0
cupcake	acute coryza	0
ocimum sanctum	parasagittal meningiomas	0
soda water	artery disease	0
kenaf	ekbom delusional parasitoses	0
ale	chronic lymphocytic leukemia	0
grape	vulvar cancers	0
adhatoda vasica	renal insufficiencies	0
margarine	mptp induced experimental parkinsonism	0
olea	cancer of esophagus	0
kavas	human herpesvirus 4	0
fagopyrum esculentum	vagina cancer	0
kombucha tea	uterus cancers	0
cinnamomum aromaticum	lymphatic sarcomas	0
spice saffron	human t-cell lymphotropic virus type iii	0
drink tea	endometriose	0
romaine	type i diabetes mellitus	0
density foods	back pain with radiation	0
aquatic food	fighting cancer	0
cola nitida	hypospadia	0
cocos nuciferas	nephrolith	0
include apples	thermal hypesthesias	0
feather meal	syncopal vertigo	0
black pepper	papillomaviridae	0
fungus	ovary cancers	0
nettle	ekbom delusory parasitoses	0
wild yams	spondylitis ankylopoietica	0
carrot	udpglucose hexose 1 phosphate uridylyltransferase deficiency	0
color	senile plaques	0
fabaceae	benign prostatic hyperplasia	0
neu5gc-rich food	infectious mononucleosis viruses	0
milk	virus disease	1
licorice	ankylosing spondylarthritis	0
avena	polyarthritide	0
soda waters	sudden cardiac arrest	0
seville orange tree	recurrence	0
raisin	deep-venous thromboses	0
vaccinium macrocarpon	complete hearing loss	0
indian gooseberry	tongue neoplasms	0
anacardium	oncovirus	0
table salt	postural syncope	0
acai berries	polyarthralgia	0
pear	campylobacter infections	0
food allergies	esophageal neoplasms	0
national meat	copd	0
fruit and vegetable juices	cancer of tonsil	0
brewage	spinal cord degenerative diseases	0
plant arils	lou gehrig's disease	0
psyllium	foodborne illnesses	0
bell pepper	postoperative nausea	0
dried fruit	acute inflammatory polyneuropathy	0
aubergine	aphthae	0
tangerine trees	intracranial meningiomas	0
foeniculum vulgare	congenital abnormalities	0
ice creams	esophagus neoplasm	0
haritaki fruit	zoonotic infections	0
chocolate bars	flatus	0
marjoram	tonic-clonic seizure	0
chinese cassias	neonatal tremor	0
eating eggs	cancer of the penis	0
cooked meat	bovine spongiform encephalitis	0
zinger tea	abdominal obesity	0
rheum rhaponticum	motion sickness	0
hickory nut	amyloid deposit	0
handling meat	rachitide	0
high fructose maize syrup	allergy	0
meal	heart failure	0
table sugar	endometrioma	0
uncooked foods	frontal region trauma	0
berberis	chronic airflow obstructions	0
adhatoda	small non-cleaved-cell lymphoma	0
vaccinium bracteatums	common bile duct gallstones	0
chili	liver dysfunction	0
herb	diverticula	0
dessert	erectile dysfunction	0
areca catechu	muscle tremor	0
adding blueberries	salmonella infections	0
plantago lanceolata	atherosclerotic plaque	0
regular carrots	determination of death	0
sun-dried raisin	lung neoplasms	0
cinnamomum cassia	secondary fibromyalgias	0
syzygium jambos	fibroid	0
rye	colitis gravis	0
capparis	gall bladder disease	0
legume pod	sliding hiatal hernia	0
coconut water	uterine cervical cancer	0
nut butters	chronic fatigue-fibromyalgia syndrome	0
dietary supplementations	ovary neoplasms	0
gum acacia	seizure disorders	0
sugar substitute	spondylitis ankylopoietica	0
punicaceae	subwakefullness syndrome	0
dried food	canker sores	0
eugenia sandwicensis	tumorigenesis	0
serve	malignant melanoma	0
nicotiana tabacums	chronic cluster headache	0
powdered sugar	thyroid neoplasm	0
acer negundo	cataract	0
pomelo tree	primary parkinsonism	0
green beans	sudden infant death	0
unfiltered coffee	skin neoplasm	0
carbonated beverages	polymyositis ossificans	0
eden foods	inflammatory bowel diseases	0
larder	female pattern baldness	0
cocoanut	physical anhedonia	0
thymus vulgari	spindle-cell carcinoma	0
plant aril	male pattern alopecia	0
black walnut	diffuse lymphoma	0
brassica juncea	texidor's twinge	0
sea vegetable	parkinsonism-dementia complex of guam amyotrophic lateral sclerosis	0
porphyra	respiratory tract infections	0
nonfat meal	ankylosing spondylitis	0
lard	human t cell leukemia virus type iii	0
theobroma cacao	lyme borreliosis	0
maple syrup	fibrositide	0
calendula officinalis	colon neoplasm	0
cabbage	postpartum sterility	0
prunus persica	short sleep phenotype	0
olive	colorectal tumor	0
purple rice	inflammatory demyelinating polyneuropathy	0
pistil	national cancer	0
coriandrum sativums	experimental parkinson diseases	0
new york coalition for healthy school food	burkitt herpesvirus	0
taro	monocytic leukemia	0
amygdalus communis	cancer of the penis	0
sweet potatoes	congenital defects	0
lemon grasses	t virus	0
eating meat	growth hormone receptor deficiency	0
kohlrabi	occipital region traumas	0
dinner times	mixed cell lymphoma	0
so-called meat	bilateral headaches	0
aloe	toxico infectious botulism	0
find pork	sensory seizures	0
tepary bean	tussive syncope	0
vodka	acute autoimmune neuropathies	0
plantago psyllium	cephalodynia	0
brazil nuts	nonalcoholic steatohepatitis	0
bell peppers	mastitis	0
seltzer water	reverse cancer	0
whole foods	intervertebral disk degenerations	0
blackberry	dental plaque	0
family vegetables	virus infection	0
avocado	undifferentiated carcinoma	0
fed beef	premenstrual syndrome	0
english plantains	myelopathy	0
holy basil tea	diarrhea	0
marsh mallows	ekbom dermatozoic delusions	0
intoxicant	mastodynia	0
asparagus	aids viruses	0
dried foods	multiple myeloma	0
food supplementations	deep-vein thrombosis	0
sesame seeds	familial juvenile parkinsonism	0
brussel sprout	primary parkinsonism	0
kiwi fruits	sunburn	0
junk foods	retained surgical tools	0
frozen broccoli	periodontal diseases	0
rutabaga	blood cancers	0
hibiscus cannabinus	parkinsonian diseases	0
bellis	micturition syncopes	0
common fruits	drug addiction	0
eugenia jambos	iodine deficiency	0
liquor	acute inflammatory demyelinating polyneuropathy	0
citrus aurantiums	mottled enamel	0
pistachio nut trees	cholera	0
sweet pepper	feminization	0
foodstuff	headache syndrome	0
trigonella foenum graecum	lichen ruber planus	0
overpriced vitamin	crushing skull injury	0
citrus reticulata	barretts esophagus	0
carrot juice	human herpesvirus 4 (gamma)	0
myristica fragrans	hyperthermia	0
meal times	dental diseases	0
artichoke	multiple myositis	0
stevia rebaudiana	diffuse undifferentiated lymphomas	0
big meals	adenoviridae	0
chenopodium quinoa	aortic aneurysms	0
lycium	post-traumatic osteoporosis	0
chamomile oils	transitional meningiomas	0
durum wheats	lymphoblastic leukemia	0
whole grain cereal	gorlin syndrome	0
pistacia vera	idiopathic intracranial hypertension	0
collard green	back pain without radiation	0
mother cell	hair loss	0
coconut	iritis	0
decrease meat	herpesvirus	0
petroselinum crispums	auricular fibrillation	0
raphanus	blindness	0
persea americanas	contusion	0
common plant	lymphadenopathy-associated viruses	0
dietary sugars	left sided heart failure	0
uncooked food	reticulosarcoma	0
fruit juices	bovine leukosis	0
zea	malignant epithelial neoplasm	0
teosinte	persistent tremor	0
lemon balm	sprain	0
prunis communis	fibrose	0
kiwi	hyperphagia	0
shiitake mushroom	premenstrual tension	0
cassia cinnamon	uterine leiomyoma	0
frequent meals	arthrosis	0
blueberry plant	senile plaques	0
convenience foods	rectal neoplasms	0
aloe vera	parkinsonian syndrome	0
fries	burkitt's lymphoma virus	0
food companies	galactosemia 2s	0
red cabbage	serious disease	0
antioxidant-rich food	prediabetic state	0
american meat	basal cell epithelioma	0
horsenettle	inhibit cancer	0
soy foods	condylomata acuminata	0
club sodas	drug hypersensitivity	0
prunus cerasifera	utp hexose 1 phosphate uridylyltransferase deficiency	0
catfish	creutzfeldt-jakob disease	0
recommend tea	atrial fibrillation	0
ceratonia	avian leukosis/sarcoma virus	0
weed	postoperative nausea	0
yeast rice	acute fulminating multiple sclerosis	0
assai palm	gastro-esophageal reflux	0
drinking orange	galk deficiencies	0
green grapes	regional enteritis	0
white pepper	udpglucose hexose 1 phosphate uridylyltransferase deficiency	0
poultry product	rete testis tumor	0
infant formulas	saturnine tremors	0
meal time	wheat hypersensitivities	0
dietary supplement	faint	0
vegetarianism	open head injury	0
plant capsules	paludism	0
use sweeteners	birth defect	0
amomum cardamomums	hyperventilation syncope	0
sweetleaf	mammalgia	0
turnip	growth hormone receptor defect	0
banana plant	steatohepatitis	0
rubus idaeus	parkinsonian disorders	0
portulaca	necrotizing fasciitis	0
cannabis indicas	forehead trauma	0
oregano plants	fibroatheromatous plaques	0
coconut oil	anxiety neuroses	0
raw alfalfa	muscle disease	0
narrow-leaved plantain	amnesia memory loss	0
miso	retained surgical item	0
junk food	cholera	0
oyster mushrooms	vertex headache	0
saccharomyces cerevisiae	gastroenteritide	0
beef	uterine cervical cancers	1
almond milk	breast cystic disease	0
allium porrum	social anxiety disorders	0
celebration meal	renal cancers	0
edible grain	skin neoplasm	0
hydroponic basil	drop attack	0
specific cheeses	posterior fossa meningioma	0
swordfish	mixed small and large cell lymphoma	0
cannabis sativa	common colds	0
chlorella	familial creutzfeldt-jakob disease	0
rheum	perioral tremors	0
silybum marianum	bacterial infection	0
ribe	dehydration	0
roundup-ready soybeans	retained surgical instrument	0
flaxseed	craniocerebral traumas	0
fuji apples	muscle tremor	0
licorice root	hysterical amnesia	0
silken tofu	splitting pains	0
lavandula	subfertility	0
mint	short sleep phenotypes	0
breakfast cereals	monocytic leukemia	0
cooking oil	fibromyositis fibromyalgia syndrome	0
chicken salad	galactose 1 phosphate uridylyltransferase deficiency	0
potable water	allergy	0
cayenne	mental disorders	0
pimenta diocia	thrombose	0
cannabis indica	hemangioblastic meningioma	0
elephant garlic	crohn's enteritis	0
fenugreek seed	hiv	0
laciniate nightshades	lou gehrig disease	0
lemon	macular degeneration	0
calling eggs	radiating pains	0
diospyro	inherited human transmissible spongiform encephalopathies	0
dried apples	kidney failure	0
cumin	hypovolemic shock	0
halibut	alcoholism	0
retail poultry	human mammary carcinomas	0
citrus	thyroid adenomas	0
prosopi	textiloma	0
dog rose	lightheadedness	0
vegetable juice	uterine fibroid	0
cinnamomum verum	preterm birth	0
bread	texidor twinge	0
blueberry	non-hodgkins lymphoma	0
bamboo shoots	familial guillain-barre syndrome	0
punica granatum	type c oncoviruses	0
maize oil	situational syncopes	0
white mallow	epimerase deficiency galactosemias	0
jalapeno	breast neoplasms	0
plant embryos	anxiety disorders	0
flax	neurodegenerative disease	0
squash seeds	male impotence	0
mentha x piperita	udp-galactose-4-epimerase deficiency diseases	0
red yeast rice	chicken viruses	0
cultivated radish	ciguatera fish poisonings	0
emblica officinalis	cluster headache	0
cranberry sauce	joint pains	0
anti-inflammatory foods	uterine neoplasm	0
digitalis purpurea	acquired immuno-deficiency syndromes	0
petroselinum crispum	tonsillar neoplasms	0
eating food	gastroesophageal reflux	0
seven nutrients	nonalcoholic steatohepatitides	0
oreo	blood clot	0
black rice	primary brain neoplasm	0
gui zhi	chromosome 6-linked autosomal recessive parkinsonism	0
seville orange trees	coarse tremor	0
supper	muscle pains	0
hemp plant	insulin-dependent diabetes mellitus	0
beetroot	sleep-related neurogenic tachypnea	0
linum usitatissimums	diabetes mellitus complication	0
flounder	inhibit cancer	0
arecas	diabetic neuralgia	0
ready-to-eat meals	involuntary quiver	0
low fruit	bacterial vaginitis	0
digitalis lanata	tactile amnesias	0
mirobalanus embilicas	sarcopenia	0
cucurbita	cerebral stroke	0
crabapple	sleep-related neurogenic tachypnea	0
applesauce	liver injury	0
black teas	auditory seizures	0
bertholletia excelsa	broken bones	0
carica papaya	body weights	0
bilberry	carcinogenesis	0
sparkling waters	necrotizing fasciitides	0
sea-food	macular dystrophies	0
boiled broccoli	weight gain	0
tempeh	micturition syncopes	0
deli meats	salami brusher's disease	0
cultivated oat	fibrositide	0
processed meats	vaginal discharge	0
zea mays	bowel disease	0
hot sauce	melanoma	0
hemp	spindle-cell carcinomas	0
maguey	autosomal dominant parkinsonism	0
fat foods	acute infectious polyneuritis	0
red delicious apples	low back pain	0
citrus fruits	memory deficits	0
sparkling water	pulmonary thromboembolism	0
citrus bergamia	nerve tremors	0
prunus armeniaca	parkinsonian diseases	0
contaminated meat	lymphocytic lymphoma	0
molasses	acquired immune deficiency syndrome	0
apple juice	parodontosis	0
skim milk	prostatic intraepithelial neoplasms	0
dandelion	polyradiculoneuritis	0
low vitamin	sick headaches	0
proteus mirabilis	cancer of bladder	0
curcuma longas	common bile duct biliary calculi	0
fermented cabbage	fibrosis	0
origanum	sudden cardiac arrest	0
flaked coconut	neoplasm metastases	0
solanum tuberosums	male breast carcinoma	0
salsa	abdominal aortic aneurysm	0
healthiest snack	liver dysfunctions	0
lunch times	intraepithelial prostatic neoplasia	0
nicotiana	galactokinase deficiency	0
betel	auditory seizures	0
bran flakes	drug dependence	0
artificial sweetener	recurrent brain tumor	1
sugar water	lung neoplasm	0
holy basils	diabetic amyotrophies	0
pomelo trees	myalgic encephalomyelitis	0
citrullus	brief reactive psychoses	0
fagopyrum sagittatum	cat leukemia virus	0
low-fat diet	fighting cancer	0
pecan tree	disorders of initiating and maintaining sleep	0
fresh ginger	chronic infectious mononucleosis like syndrome	0
currant	utp hexose 1 phosphate uridylyltransferase deficiency disease	0
fast foods	small noncleaved-cell lymphomas	0
turmeric root	different cancer	0
grouper	uterine fibroid	0
cocoa	rebound insomnia	0
persea americana	tying disease	0
burrito	thyroid adenomas	0
eating almonds	stokes-adams syncopes	0
assai palm berries	renal cancer	0
cilantro	diabetic complication	0
legume family	primary brain neoplasms	0
prettiest fruit	seizure	0
rooibos tea	ischemia	0
jalapeno pepper	apoplexy	0
medicago sativa	small non-cleaved-cell lymphomas	0
kola nuts	primary brain neoplasm	0
raisin bran	malignant epithelial neoplasm	0
antioxidant vitamin	reverse cancer	0
common foxglove	early awakening	0
ultra-processed food	vulva cancer	0
favorite meals	craniocerebral injuries	0
thymus	high-grade lymphoma	1
green peppers	chronic cluster headache	0
reason food	aids viruses	0
cassia fistula	pituitary dwarfism ii	0
plantago	t virus	0
white mallows	myocardial ischemias	0
flax seeds	artery disease	0
zedoary zedoarias	dementia praecox	0
pinto bean	micturition syncopes	0
carbonated water	colonic inertia	0
japanese plum	diabetic polyneuropathies	0
high-fructose corn	disc degradations	0
tea leaves	male breast cancer	0
yolk	stokes-adams syncope	0
cooking meat	monocytic leukemia	0
carbonated waters	infant obesity	0
prenatal vitamins	fibrous meningioma	0
jerusalem artichokes	drug habituation	0
pecan trees	cll lymphoplasmacytoid lymphoma	0
juiced broccoli	proteinuria	0
weekly meat	muscle tenderness	0
silybum marianums	deep vein thromboses	0
coco	neurologic degenerative disease	0
split peas	sudden infant death	0
yerba mates	copd	0
curried tofu	hypoesthesia	0
thymus plants	carcinogenic retroviruses	0
emblica officinali	skin cancers	0
cruciferous vegetable	brain cancers	0
wild celery	penile neoplasm	0
rise	arterial fatty streaks	0
narrow leaved plantain	periodontal disease	0
broccoli	national cancer	0
mint tea	myalgia	0
frozen cranberries	senile osteoporoses	0
plant zygotes	benign prostatic hyperplasia	0
crowberry	cervix neoplasm	0
wolfberry	blood cancers	0
ilex paraguarienses	craniocerebral traumas	0
animal-based foods	cerebrovascular accidents	0
kidney bean	continuous tremors	0
dietary fibers	intractable headaches	0
individual food	creutzfeldt jakob disease	0
organic meat	kidney cancers	0
althaea officinalis	pustular psoriasis of palms and soles	0
cannabi	graves disease	0
psidium guajavas	tonsillar cancers	0
high-fructose maize syrup	diarrhea	0
black currant	shock	0
chinese yams	urticaria	0
drinking milk	exanthema	0
mayo	burn	0
berry	barrett's esophagus	0
pumpkin seeds	hypertension	0
high-fiber food	cancer of lung	0
sour fruit	spiral fractures	0
taraxacum	pseudotumor cerebri	0
curcuma	lichen planus	0
pummelo tree	cognitive dysfunction	0
carya illinoenses	infertility	0
artificial sweeteners	sliding hiatal hernias	0
cassia	polyphagia	0
melissa officinalis	bronchial asthma	0
human milk	cancer of tongue	0
spinacia oleracea	galk deficiencies	0
brewed coffee	gustatory seizures	0
marsh mallow	esophageal hernia	0
areca nuts	primary fibromyalgia	0
dietary plant protein	psychophysiological insomnia	0
monitoring food	cognitive retention disorder	0
cuminum	strains and sprains	0
solanum laciniatum	necrotizing fasciitides	0
citrus x paradisi	age related memory disorders	0
healthiest beverage	cancer of the colon	0
solanum melongena	muscle spasms	0
dragon fruit	cancer of the tonsil	0
white potatoes	temporary amnesia	0
piper methysticums	syncopal episodes	0
melissa	occipital traumas	0
dietary protein	visceral obesity	0
sweet almonds	prelingual deafness	0
sweetened cereal	persistent atrial fibrillations	0
apple trees	heat strokes	0
cherry plum tree	parkinsonism-dementia complex of guam amyotrophic lateral sclerosis	0
dried apple	upper respiratory infection	0
lunch time	recurrent low back pain	0
seltzer waters	substance use disorder	0
barley coffee	memory losses	0
anti-inflammatory plant	bovine lymphosarcoma	0
drinking tea	elevated cholesterol	0
citrus fruit	basal cell carcinomas	0
plantago ovata	bronchial asthma	0
prunus salicinas	lichen ruber planus	0
collard greens	varicose vein	0
consumer protection scientific committee on food	rectal cancers	0
tangerine tree	cancer of uterus	0
different seed	human papillomavirus virus	0
molasse	ekbom delusional parasitoses	0
monkfish	psychosis	0
stuff	gnathostomiase	0
food additives	lung inflammation	0
canned food	spasm	0
cymbopogon nardus	spondyloarthritis ankylopoietica	0
empty calorie foods	auto-immune disease	0
secale cereale	inflammatory polyneuropathy acute	0
endive	udp galactose 4 epimerase deficiency disease	0
chinook salmon	et-nanbh	0
chili pepper	lower back pains	0
portulaca oleraceas	pancreas neoplasms	0
worldwide fruit	adenoviridae	0
antioxidant-rich foods	apnea	0
vitamin	lobar pneumonia	0
zingiber officinales	perforated appendicitis	0
antioxidant food	bladder neoplasm	0
cocoa powders	marie struempell disease	0
indian laburnum	sexual dysfunction	0
health nuts	human herpesvirus 4	0
arachis hypogaea	anaplastic carcinoma	0
digitalis	convulsive syncope	0
hibiscus tea	sleep related neurogenic tachypnea	0
no noni	ekbom dermatozoic delusions	0
canned foods	disorder	0
drug administration united states food	infantile botulism	0
althea officinalis	cancer of the prostate	0
corn oil	viral diseases	0
chenopodium quinoas	vaginal discharges	0
hordeum	marie struempell disease	0
vegetable protein	open head injuries	0
soy bean curd	tumor of rete testis	0
turkey meat	cancer of the penis	0
lemon verbena	diabetes mellitus complications	0
artificial butter	tonic seizures	0
diabetic diet	hypolactasia	0
sausage	preinvasive carcinoma	0
lemon grass	sleep initiation dysfunctions	0
oats	involuntary quiver	0
mango	lymphadenopathy-associated virus	0
preserved foods	tremor	0
anise seed	cancer of rectum	0
cacao	atheroma	0
raw broccoli	esophageal cancers	0
pineapple juice	low grade lymphoma	0
citrus bergamias	disc degradation	0
ready-to-eat meal	gerd	0
safflower oil	endometrial carcinomas	0
citrus reticulatas	involuntary quivers	0
syzygium jambolanum	arthritis	0
guava	retained surgical instrument	0
anacardium occidentale	impotence	0
triticum	tremor	0
exotic fruits	neuralgic migraines	0
dark meat	drug addiction	0
syrup	peanut allergies	0
gluten	coronary heart diseases	0
orange tree	lung inflammation	0
preserved food	muscle disease	0
sticker	limb tremor	0
fryer	basal cell carcinomas	0
cappari	fusiform aneurysms	0
frozen spinach	pulmonary embolism	0
antioxidant foods	motor seizure	0
triticum durum	peanut allergies	0
common olive trees	liver dysfunction	0
glucose fructose syrup	malignant neoplasm of breast	0
hickory trees	plasma cell myelomas	0
euchresta	renal neoplasm	0
seed	arthritide	0
kangaroo meat	ankylosing spondylarthritides	0
leguminosae	legal blindness	0
cherry	migraine disorder	0
hashish	spatial memory disorder	0
soybean proteins	psychotic disorders	0
carbonated beverage	sudden onset diabetes mellitus	0
ocimum basilicums	muscle cramps	0
eragrostis	ulcer	0
soy cheeses	fibrous meningiomas	0
erythroxylon	meningiomatose	0
fava beans	social phobia	0
dioscorea polystachya	generalized headaches	0
chocolate	ponv	0
da huang	small cell lymphoma	0
apium graveolens var. dulce	age-related macular degenerations	0
mastictree	amnestic states	0
mandarin orange trees	lung neoplasm	0
faba beans	malignant primary brain tumors	0
deli meat	lens opacity	0
plant kingdom	nonspecific vaginitis	0
cassia trees	high-grade lymphoma	0
atropa belladonnas	small round structured viruses	0
fresh meat	acute inflammatory polyradiculoneuropathies	0
ground beef	basal cell carcinoma	0
frosting	disk degradations	0
turmeric	viral diseases	0
eugenia caryophyllata	ciliary body spasms	0
spinach	gerd	0
agave	bilateral headache	0
phaseolus vulgari	blood cancers	0
plant embryo	oral neoplasms	0
cookie	senile osteoporosis	0
plum tree	testis neoplasms	0
mustard	udp galactose 4 epimerase deficiency disease	0
nonus	sudden cardiac death	0
afzelia	neurological condition	0
high-fat meal	cancer of penis	0
alcohol	ocular headaches	0
kawa kawas	mental disorder	0
poppy seeds	salmonella infections	0
scallion	seasickness	0
ginger	auditory seizures	0
areca	crushing pains	0
bread mold	penis cancers	0
processed meat	headache disorder	0
prunus dulcis	acute monocytic leukemias	0
salad	cognitive retention disorder	0
coca cola	preinvasive carcinoma	0
pimenta officinali	virus infections	0
soy milk	bowel diseases	0
leaf lettuce	bacteria-eating virus	0
trace mineral	thrombus	0
decaffeinated tea	renal insufficiency	0
rosemary	bovine leukosis	0
shan yaos	creutzfeldt jacob disease	0
extracted fruit	somatotropin hypersecretion syndrome (acromegaly)	0
higher vegetable	urinary tract infection	0
syzygium cumini	blood clots	0
candy	apnea	0
yerba mate	carcinogenesis	0
allium sativum	abdominal pains	0
healthiest fruits	crushing pains	0
red lentils	clear cell meningiomas	0
measuring food	small non-cleaved-cell lymphoma	0
soy yogurt	angiomatous meningioma	0
star anise	memory disorders	0
dairy product	amnestic states	0
cereal grains	acute cerebrovascular accident	1
broad beans	skin rash	0
pumpkin pie	cancer of the esophagus	0
mangifera indicas	galactose-1-phosphate uridyl-transferase deficiency disease	0
jell-o	viral infections	0
fragaria vesca	huntington’s disease	0
black sapote	deaf mutism	0
pomegranate seeds	well differentiated lymphocytic lymphoma	0
mustard plant	acquired immuno deficiency syndrome	0
oyster mushroom	breast dysplasia	0
golden delicious apples	long sleeper syndromes	0
dangerous plants	post-traumatic osteoporosis	0
arugula	barrett esophagus	0
nuclear power plants	zoonosis	0
mangifera	cephalgia syndromes	0
toxic plant	faint	0
sweet peppers	thyroid disease	0
kawa kawa	apoplexy	0
arachis	bovine leukosis	0
humulus	diabetic complication	0
sugar-sweetened beverages	sprains and strains	0
thymus vulgaris	soft tissue sarcomas	0
natto	kidney disease	0
squid	human cancer	0
fermented foods	type i diabetes mellitus	0
confection	lewy body parkinson disease	0
multivitamin	burkitts lymphoma virus	0
unfertilized eggs	hemolytic uremic syndrome	0
poultry products	bse (bovine spongiform encephalopathy)	0
salmonella-infected eggs	prostatic intraepithelial neoplasia	0
pork	lens opacity	0
experience food	lung neoplasm	0
pomegranate fruit	gallbladder diseases	0
refined olive	acute strokes	0
potassium-rich foods	lens opacity	0
incorporate cloves	manic-depressive psychosis	0
ephedra	mixed small and large cell lymphoma	0
last meal	painful menstruation	0
vicia fabas	penis cancer	0
carica	fibrocystic breast disease	0
petroselinum	johne disease	0
fructose corn	uterine fibromas	0
watercress	nerve tremors	0
oryza sativa	global amnesia	0
sandwich	neurocysticercose	0
acer saccharums	todd's paralysis	0
red peppers	adenomatous polyps	0
flammulina	cluster headache syndromes	0
granny smith apples	mptp-induced experimental parkinsonism	0
rhubarb	primary malignant brain tumors	0
handling food	syncopal vertigo	0
dog rose berries	infection	0
foenumgraecum	uterus cancers	0
malabar-nut	esophagus cancers	0
whole grain cereals	benign brain neoplasm	0
food poisoning	diabetes related complications	0
juglans regia	iron deficiency	0
veggie	hypoascorbemia	0
big food	amnesia memory loss	0
sprout	periodontal diseases	0
organic milk	gastric acid reflux	0
carbonated drink	short sleep phenotype	0
biometal	common cancers	0
hawthorn	sub-fertility	0
brewing tea	rectum cancers	0
sweet almond	kanner syndrome	0
allspice	sudden cardiac death	0
sweet marjorams	chronic lymphoblastic leukemia	0
iv vitamin	intraepithelial prostatic neoplasias	0
exotic fruit	temporary amnesias	0
vaccinium corymbosum	ketosis-prone diabetes mellitus	0
glucose-fructose syrup	variant creutzfeldt-jakob disease	0
callerya	barrett's syndrome	0
sardine	acne vulgaris	0
macadamia nuts	age related macular degeneration	0
bergamot	hypospadia	0
dietary fats	suppuration	0
kava	intracranial cns disorders	0
chai tea	eczematous dermatitides	0
citrus aurantium	fibromyalgia-fibromyositis syndrome	0
sunflower seeds	peripheral arterial disease	0
rooibos	autoimmune disease	0
fagopyrum	genital warts	0
irritable bowel kiwi fruit	growth hormone insensitivity syndrome	0
colophospermum	familial creutzfeldt jakob disease	0
mustard seeds	familial guillain-barre syndrome	0
plantago arenaria	central obesities	0
carduus marianus	chronic pain	0
assai palm berry	hirsutism	0
maize syrup	confusional state	0
plant zygote	spinal cord disorder	0
brussels sprouts	crushing skull injuries	0
chamomile	migraine disorder	0
purple cabbage	oral cancers	0
diospyros digyna	creutzfeldt jakob syndrome	0
coffee	tonsillar cancer	0
citrus grandis	bronchiolitis	0
chinese cassia	germinoblastoma	0
chamomile oil	acute confusional migraine	0
açaí berries	lou gehrig disease	0
mushroom	hemorrhoid	0
lemon tree	appendicitis	0
chicken	gut dysfunction	0
mustard plants	myocardial infarct	0
sesame	muscular spasms	0
bitter nightshade	toxico-infectious botulism	0
citrus medica	cancer of stomach	0
food manufacturers	nonhodgkin's lymphoma	0
solanum tuberosum	mastalgia	0
raspberry	joint diseases	0
new candy	liver dysfunction	0
sugar maple	olfactory groove meningioma	0
colocasia	udpglucose 4-epimerase deficiency disease	0
rose	post ictal confusion	0
pithecolobium	vertex headache	0
ficus	familial creutzfeldt-jakob disease	0
rheum officinale	open head injuries	0
moose meat	breast pains	0
fresh fruits	fibrous meningiomas	0
sunfish	male breast carcinoma	0
cacao bean	small round-structured viruses	0
coleslaw	tubal abortion	0
chilli peppers	wheat hypersensitivities	0
sour cream	leukemogenic virus	0
sour orange tree	passive tremors	0
brinjal	colon neoplasm	0
chocolate pudding	sudden-onset diabetes mellitus	0
justicia	breast cystic diseases	0
nut bar	diabetic complications	0
chili peppers	crohn's enteritis	0
common bean plant	a-v dissociation	0
gmo soybeans	strain	0
chestnut	age related macular degeneration	0
pistacia lentiscus	heat strokes	0
pyrus	cluster headache	0
octopus	non-alcoholic fatty liver disease	0
hordeum vulgare	venereal wart	0
buttermilk	low back aches	0
beet greens	udp-galactose-4-epimerase deficiency disease	0
smoked foods	galactosemia iiis	0
mangiferas	sudden infant death	0
plum	glaucoma	0
common bean plants	renal cancers	0
popcorn	fibromyalgia-fibromyositis syndromes	0
saint john's wort	renal insufficiencies	0
kale	breast fibrocystic changes	0
zingiber officinale	postviral fatigue syndrome	0
wild bananas	chronic obstructive lung disease	0
food pyramid	basal cell epithelioma	0
vicia faba	type c oncoviruses	0
pancake	venereal wart	0
chinese rhubarb	vaginal discharge	0
citrus medicas	senile osteoporoses	0
crataegus monogyna	somatotropin (acromegaly) hypersecretion syndrome	0
triticum turgidum subsp. durum	amyotrophic lateral sclerosis motor neuron disease	0
rice milk	colorectal cancer	0
pecan	tonic seizures	0
curry	acute monoblastic leukemia	0
coca	osteoarthrose	0
syzygium	philadelphia-negative myeloid leukemias	0
andira	gehrigs disease	0
orange juice	myocardial failure	0
radish	inappropriate growth hormone secretion syndrome (acromegaly)	0
bean	parkinson disease	0
marihuana	diabetic neuralgia	0
breast milks	creutzfeldt-jakob syndrome	0
healthy snack	small lymphocytic lymphoma	0
açaí berry	benign intracranial hypertension	0
baby formulas	diffuse undifferentiated lymphomas	0
plum trees	atherogenesis	0
olive tree	inflammatory disease	0
oatmeal	post traumatic osteoporosis	0
cinnamon	arrythmia	0
artificially-flavored corn	breast adenosis	0
glycyrrhiza glabra	faint	0
sustenance	utp hexose 1 phosphate uridylyltransferase deficiency	0
black coffee	benign neoplasm	0
potato	back aches	0
green teas	convulsive seizures	0
white rice	degenerative neurologic diseases	0
bean sprout	effort syncope	0
soy bean proteins	retained surgical needle	0
dietary soybean proteins	penile neoplasm	0
apricot trees	amentia	0
curry powder	renal cancer	0
dried blueberries	cancer of the liver	0
mealtime	disc degradation	0
sugar	intraorbital meningioma	0
garden radish	wheat allergies	0
thyme	acute stroke	0
beverage	neonatal tremor	0
organ meats	blood clot	0
camomile	anoxemia	0
cashew	tying disease	0
tea hibiscus	dehydration	0
sugar maples	lassitude	0
rose berries	nervous system degenerative diseases	0
malus	fighting cancer	0
soymilk	low grade lymphoma	0
bean sprouts	prion induced disorder	0
healthy foods	chronic lymphocytic leukemia	0
healthy food	hepatic cancers	0
spice turmeric	effort syncope	0
pureed apples	gnathostoma infection	0
brown rice	small cleaved cell lymphoma	0
grilled meat	bone neoplasm	0
mussel	stomach neoplasms	0
frying meat	myelogenous leukemia	0
colorful foods	sharp headaches	0
dioscorea opposita	adenomatous polyps	0
pisum sativum	acquired immunodeficiency syndromes	0
macadamia	encephalon diseases	0
sea bilberries	galt deficiency	0
frozen fruit	myeloid leukemia	0
nutritional yeast	transmissible dementias	0
solanum laciniatums	liver steatosis	0
noncaloric sweetener	colitide	0
acacia tree	jakob-creutzfeldt disease	0
cereal grain	bipolar depression	0
linum	craniocerebral injury	0
frier	infarction	0
isoglucose	celiac disease	0
low-calorie diet	lactose intolerance	0
healthiest apple	faint	0
lucerne	lichen rubra planus	0
clove	muscle soreness	0
solanum melongenas	retained surgical items	0
box elders	salmonellosis	0
pineapple	malignant meningiomas	0
tv dinners	fibromyalgia fibromyositis syndrome	0
opium poppy	kidney failures	0
flower	deafness	0
algarrobo	unilateral headaches	0
carbonated drinks	poisoning	0
cheese	hansens disease	0
ground ginger	muscle disease	0
diabetic diets	pill rolling tremors	0
euterpe edulis	colic	0
rubus glaucus	lewy body parkinson's disease	0
infant formula	abdominal obesity	0
saint johnswort	cervical neoplasm	0
bottled water	periorbital headaches	0
veal	legal blindness	0
sweeten	retained surgical item	0
cereal	cancer of pancreas	1
nut butter	cancer of the penis	0
sweet orange	hypolactasia	0
origanum majorana	myalgia	0
lemon balm tea	atrioventricular dissociation	0
persea	renal neoplasms	0
little saffron	dehydration	0
illicium anisatum	cardiovascular stroke	0
vegetable juices	pharyngitis	0
musa	colon cancers	0
added sweeteners	salmonellosis	0
infects apples	metastasis	0
green lentils	primary brain neoplasms	0
quinoa	eye disease	0
red onions	muscular cramp	0
corn syrup	adenomatous polyps	0
chia seeds	lung inflammation	0
brassica nigra	periorbital headaches	0
raw foods	polyarthralgia	0
tofu	fibromyositis-fibromyalgia syndromes	0
grapefruit juice	apneas	0
dietary proteins	arthropathy	0
coriandrum sativum	tumorigenesis	0
red rice	regional enteritis	0
incorporates cloves	thyroid diseases	0
red wine	cervical neoplasm	0
norus	infant obesity	0
rye bread	transitional meningiomas	0
zucchini	nasal cavity cancer	0
little meat	mouth cancers	0
roughage	penile neoplasms	0
tarragon	malignant epithelial tumor	0
soy beverage	skin cancers	0
placenta	bowel diseases	0
vinegar	small non-cleaved-cell lymphomas	0
sesamum	insulin dependent diabetes mellitus	0
virgin olive	scurvy	0
syzygium sandwicense	elevated cholesterol	0
chervil	joint disease	0
good soybeans	joint diseases	0
malabar nut	diffuse mixed cell lymphoma	0
curcuma zedoarias	amyotrophic lateral sclerosis motor neuron disease	0
corn sugar	congenital defect	0
toronja	low grade lymphoma	0
solanum	chronic cystic mastitis	0
celeriac	open head injuries	0
cooked broccoli	metabolic acidoses	0
food poisonings	presyncope	0
pimenta	acquired immunodeficiency syndrome virus	0
poultry meat	crohn disease	0
eugenia cumini	cranial pains	0
capsicum annuum	postoperative nausea	0
piper nigrum	guillain-barre syndrome	0
ocimum tenuiflorum	sterility	0
guibourtia	heart disease	0
replenish nutrients	substance dependence	0
chinese food	experimental parkinson disease	0
juglans nigra	painful diabetic neuropathies	0
plant-based nutrients	atheroma	0
mashed potatoes	cancer of tongue	0
pistachio nut tree	sick headache	0
wheat bran	neurocysticercosis	0
cicer	head pain	0
tomato	endometrial cancers	0
peach trees	pancreatic neoplasms	0
illicium	oral disease	0
wild radish	familial creutzfeldt jakob disease	0
vaccinium bracteatum	angioblastic meningioma	0
maize	age related osteoporosis	0
spicy food	mastitis	0
acaí berries	secretory meningioma	0
bertholletia	fibromyositis-fibromyalgia syndromes	0
boiled eggs	abdominal pains	0
alpine strawberry	avitaminosis	0
fortify milk	hormonal dysfunction	0
teff	lung inflammations	0
added nuts	sterility	0
copaifera	postviral fatigue syndromes	0
barley	undifferentiated lymphomas	0
poisonous plant	hiatal hernia	0
oryza	fatty liver disease	0
no coffee	degenerative disease	0
olea europaea	stokes-adams syncope	0
sweetening agent	long sleeper syndromes	0
nutmeg	male impotence	0
green pepper	single seizure	0
pithecellobium	static tremor	0
breakfast time	endometrium cancers	0
holy basil	substance use disorders	0
lemon balms	prostatic intraepithelial neoplasms	0
foxglove	cancer of the vagina	0
anticancer plant	spontaneous abortion	0
hemp plants	pancreatitis	0
horse nettle	muscular cramps	0
rooibo	cervix cancers	0
cinnamomum trees	diabetic retinopathies	0
eating nuts	epimerase deficiency galactosemias	0
club soda	brief reactive psychosis	0
hickory nuts	bilateral sciaticas	0
cooked meats	familial parkinson disease	0
avenas	acquired immunologic deficiency syndrome	0
ready-prepared food	cardiovascular stroke	0
saffron	vagina neoplasm	0
drink	high-grade lymphoma	0
raw meat	horton syndrome	0
saint johns wort	acne vulgaris	0
french bean plant	todd paralysis	0
crataegus monogynas	sprains and strains	0
mentha spicata	malignant epithelial neoplasms	0
green peas	limb tremors	0
curcuma zedoaria	unilateral headache	0
spaghetti	nervous system degenerative diseases	0
horsebean	familial tremors	0
mandarin orange tree	cancer of colon	1
piper methysticum	germinoblastic sarcoma	0
wild yam	deep venous thrombosis	0
ananas	skin neoplasms	0
ranking foods	diabetic mononeuropathy simplex	0
cycad trees	deep venous thromboses	0
delonix	recurrent low back pain	0
mentha	parasagittal meningiomas	0
narrow-leaved plantains	pill rolling tremor	0
avocado fruit	ekbom delusory parasitosis	0
laudable legume	bilateral sciatica	0
ganja	acne vulgaris	0
cocoa plant	congenital abnormality	0
citronella	diabetic mononeuropathies	0
banana	retained surgical item	0
wine	determination of death	0
coriander	backache	0
vitis vinifera	chronic b-lymphocytic leukemia	0
apium graveolens var. rapaceum	cancer of stomach	0
treat	landry guillain barre syndrome	0
eggplant	philadelphia-negative myeloid leukemias	0
salmonella food	peanut allergy	0
mock meats	mixed lymphocytic histiocytic lymphoma	0
tachigalia	auditory seizures	0
squash plant	guam form amyotrophic lateral sclerosis	0
eupatorium rebaudianums	e-b virus	0
no meat	neonatal tremor	0
sauerkraut	somatotropin (acromegaly) hypersecretion syndrome	0
citrus maxima	necrotizing fasciitis	0
flavorer	cerebrovascular apoplexy	0
hamburger	creutzfeldt-jakob disease	0
nicotiana tabacum	viral diseases	0
deep-fry foods	phlebothrombose	0
citrus aurantiifolia	extreme hearing loss	0
cocoa butter	primary brain neoplasm	0
earl grey tea	aids virus	0
alfalfa sprout	common bile duct biliary calculi	0
pimpinella anisum	post traumatic osteoporosis	0
star anises	secondary insomnia	0
andropogon nardus	gynecomastia	0
cicer arietinum	cancer of the mouth	0
include flaxseed	autosomal recessive parkinsonism	0
whale meat	insomnia	0
eating fruits	gastroenteritide	0
cherry plum trees	galactose epimerase deficiency	0
illicium anisatums	basal cell epithelioma	0
horse nettles	wheat hypersensitivity	0
soy protein	diverticulitide	0
cooked carrots	colonic neoplasms	0
texturized vegetable protein	memory deficit	0
bitter nightshades	burkitt's lymphoma virus	0
punica granatums	premature births	0
paella	polyradiculoneuropathy	0
rosehip	chronic diseases	0
horse bean	lassitude	0
dried cranberries	tonsillar neoplasms	0
celery root	epileptic seizures	0
animal-based vitamin	crohn disease	0
shan yao	ciliary neuralgia	0
fruit juice	manic disorders	0
romaine lettuce	necrotizing fascitis	0
pretzel	nafld	0
buckwheat	decreased cancer	0
cortland	dizziness	0
goji berry	congenital defect	0
crab apples	small round-structured viruses	0
hemlock	cerebrovascular apoplexy	0
papaver	western diseases	0
snail meat	hyperventilation syncopes	0
glycyrrhiza	crohn's enteritis	0
jalapeno peppers	vaginitis	0
citrus limon	hepatic cancer	0
anchovy	gossypiboma	0
berberi	hypesthesia	0
dioscorea batatas	bechterew's disease	0
amla	juvenile-onset diabetes	0
morinda citrifolia	foodborne diseases	0
belladonna	frontal region trauma	0
sockeye salmon	barrett metaplasia	0
eugenia malaccensis	autoimmune condition	0
cassia tree	prostatic intraepithelial neoplasias	0
dress	royal free disease	0
pinto beans	cretinism	0
low meat	mad cow diseases	0
vaccinium virgatum	non epileptic convulsion	0
plaice	disk degenerations	0
floret	spasm	0
butter	childhood onset obesity	0
vaccinium myrtillus	crushing skull injuries	0
pleurotus	osteoarthrose	0
tea plant	pattern baldness	0
sell meat	generalized headache	0
soft drinks	common cold	0
soda pops	rectal neoplasm	0
citrus sinensis	contagious pustular dermatitides	0
calendula officinali	diverticulitis	0
dairy eggs	mental deterioration	0
energy drinks	reactive confusion	0
eugenia jambolana	cramp	0
shiitake mushrooms	feline lymphoma viruses	0
fragaria	non-hodgkins lymphoma	0
eat chocolate	forehead traumas	0
citrus grandi	severe mental disorders	0
chinese cinnamons	acute monocytic leukemia	0
soy beverages	herpesvirus	0
assai palms	cervical migraine syndrome	0
amorpha	v-cjd (variant-creutzfeldt-jakob disease)	0
ice cream	exanthema	0
sea vegetables	kidney failures	0
lentinus edodes	epithelioid sarcoma	0
soup	salmonella infection	0
pudding	chronic fatigue syndrome	0
syzygium aromaticum	ekbom delusional parasitoses	0
pimenta officinalis	gluten-sensitive enteropathies	0
cantaloupe	lou gehrig disease	0
fennel seeds	premature births	0
fried foods	motor seizure	0
glycine max	symptom clusters	0
carbonated mineral waters	hepatitide	0
portulaca oleracae	cancer of the lung	0
granny smith	alcoholism	0
corn	pleomorphic lymphomas	0
linseed	colicky pains	0
anana	arthritide	0
kidney beans	cataract	0
cinnamomum zeylanicum	pulmonary thromboembolisms	0
ground meat	angiomatous meningiomas	0
illicium verums	weight loss	0
restructured meat	birth defects	0
apple tree	udp galactose 4 epimerase deficiency disease	0
aspartame	nonhodgkin's lymphoma	0
lens culinari	mouth and tooth diseases	0
papaver somniferum	amnesia	0
flavoring	intervertebral disk degeneration	0
arginine-rich foods	myelomatosis	0
conventional food	alopecia cicatrisata	0
food company	amyloid deposit	0
acid-binding vegetables	sudden cardiac death	0
stevia rebaudianas	small and large cleaved-cell lymphoma	0
healthiest beverages	plasma-cell myelomas	0
nut bars	crohn disease	0
dinner time	pancreatic cancer	0
century plant	nonorganic insomnia	0
cucumis melos	muscle cramp	0
dark chocolate	resting tremor	0
monosodium glutamate	chronic b-cell leukemia	0
majorana hortensis	chronic fatigue-fibromyalgia syndrome	0
texturized soy protein	hepatitide	0
high-phytate foods	galactosemia iiis	0
mackerel	stroke	0
split pea	neoplasia	0
pie	small lymphocytic lymphoma	0
store licorice	uterine cancers	0
pickled vegetables	premenstrual syndrome	0
green tea	nasal cavity cancer	0
citrus aurantiifolias	endotoxemia	0
ready prepared foods	breast fibrocystic change	0
raw cranberries	postoperative nausea	0
kiwi fruit	allergic reaction	0
beet	overeat	0
dairy products	mixed lymphocytic-histiocytic lymphoma	0
maraschino cherry	age-related maculopathies	0
cuminum cyminum	tumor	0
vaccinium macrocarpons	tor-driven diseases	0
millet	insulin dependent diabetes mellitus	0
emphasize plant	cancer of the endometrium	0
include fennel	coarse tremors	0
baking chocolate	diabetes mellitus complication	0
andean blackberry	pattern baldness	0
snack	neuralgic migraines	0
chewing gums	visual seizures	0
pickled foods	small lymphocytic lymphomas	0
golden glow	retro ocular headache	0
filtered coffee	breast malignant neoplasm	0
vitamin pills	heart block	0
horse beans	fibromyalgia fibromyositis syndrome	0
lactuca sativa	ache	0
poultry	cerebral convexity meningioma	0
mirobalanus embilica	fibrous meningiomas	0
drinking water	neurocysticercosis	0
dried yeast	zoonotic infectious disease	0
dressing	insomnia disorder	0
healthy nuts	cat leukemia virus	0
kawa	peripheral artery diseases	0
areca catechus	dermatozoic delusion	0
noni fruit	monocular blindness	0
processed apples	secondary fibromyalgia	0
grape juice	vulva cancers	0
swiss chard	body weight	0
woodland strawberries	hyperventilation syncopes	0
tisane	colon neoplasm	0
carbonated mineral water	familial dementias	0
hop	atrioventricular dissociations	0
english plantain	delusional parasitoses	0
so-called vegetable	cholera	0
frying foods	undifferentiated carcinoma	0
crocus	chicken viruses	0
cod	chromosome 6-linked autosomal recessive parkinsonism	0
malus domestica	bacterial vaginitis	0
honey	galactose 1 phosphate uridyltransferase deficiency	0
caramel	bse (bovine spongiform encephalopathy)	0
oolong	broken bones	0
brew	sneeze	0
specific foods	involutional osteoporosis	0
avoid peanuts	strains and sprains	0
milk protein	pill rolling tremor	0
cruciferous foods	insulin dependent diabetes mellitus	0
morning meal	upper respiratory infection	0
oregano	arthralgia	0
suggesting apple	extreme hearing loss	0
caper	global amnesias	0
carya	human mammary neoplasms	0
roselle	human mammary neoplasm	0
crave chocolate	stomatognathic diseases	0
beer	renal cancer	0
goiaba	wound botulism	0
rabbit meat	transient blindness	0
healthiest vegetable	gynecomastia	0
eating broccoli	aortic aneurysms	0
solanum dulcamaras	gangrene	0
macadamia nut	virus infection	0
animal food	low-grade lymphomas	0
root	uterine cervical cancer	0
bad foods	acute monoblastic leukemia	0
ketchup	vertex headache	0
flesh foods	olfactory seizures	0
pepper	deep vein thromboses	0
smoked food	cancer of the prostate	0
black beans	testicular neoplasm	0
nettle tea	crushing pains	0
popular fruits	fibromyalgia fibromyositis syndrome	0
seafood	bilateral headaches	0
fenugreek	esophageal neoplasm	0
real chocolate	marie-struempell disease	0
abelmoschus	limb tremor	0
poppy	disc degradations	0
cranberry	cognitive decline	0
tepary beans	hemorrhage	0
raphanus raphanistrum	neurodegenerative disorders	0
rowanberry	uterine cervical neoplasm	0
horsemeat	muscle tremor	0
whortleberry	post-traumatic osteoporoses	0
pumpkin	cat leukemia virus	0
cannabis	testicular tumors	0
nuclear power plant	secretory meningiomas	0
four nuts	neurodegenerative disease	0
pimpinella anisums	fetal iodine deficiency disorder	0
celery	basal cell nevus syndrome	0
rice	nontropical sprue	0
drink milk	carcinomatose	0
dietary fat	rachitis	0
jelly	tor-driven diseases	0
target vitamin	paraosmia	0
convenience food	cancer of prostate	0
powdered ginger	mental deteriorations	0
brassica napus	oral neoplasm	0
mangosteen	limb tremor	0
brain-invasive pork	crohn's enteritis	0
baby carrots	weight losses	0
vegetable proteins	progressive disorder	0
usda poultry	cancer of the testes	0
ready soybeans	anxiety neuroses	0
green onions	crushing pain	0
indian laburnums	renal calculi	0
dried fruits	ovary cancers	0
plant-based foods	chicken viruses	0
maple	renal neoplasm	0
prosopis	social phobia	0
milk chocolate	anoxia	0
unrefined plant	ischemic heart diseases	0
black raspberries	deep venous thromboses	0
pimenta diocias	auditory seizures	0
peach	retained surgical items	0
lavandula angustifolia	human herpesvirus 4 (gamma)	0
food colors	neonatal tremors	0
sweet foods	feline leukemia virus	0
indian corn	prostatic intraepithelial neoplasms	0
bacon	non hodgkin lymphoma	0
undercooked meat	sea sickness	0
healthy snacks	barrett esophagus	0
hypericum	age-related maculopathies	0
venison	human immunodeficiency viruses	0
laciniate nightshade	bechterew disease	0
hot peppers	lymphosarcoma	0
alfalfa sprouts	short sleeper syndromes	0
wheat	leucocythaemia	0
lens plants	seizure	0
lycium barbarum	renal calculus	0
garbanzo	persistent atrial fibrillations	0
eugenia aromatica	cancer of vulva	0
mesquite	amnesia-memory loss	0
peppermint oil	spinal meningiomas	0
juglan	testis neoplasms	0
olive trees	basal cell carcinomas	0
oregano plant	hereditary galactokinase deficiencies	0
cynara scolymus	esophageal cancers	0
oat	headache disorder	0
betel nut	udp galactose 4 epimerase deficiency	0
peanut	deficiency diseases	0
dietary supplements	chronic b-lymphocytic leukemias	0
emphasizes vegetables	numbness	0
stem vegetables	gastro-esophageal reflux	0
crunch berries	cancer of the uterus	0
sugar substitutes	rest tremor	0
lemon trees	colon cancer	1
osmanthus tea	atrioventricular dissociations	0
corn oils	intracranial cns disorders	0
cleistocalyx	breast fibrocystic changes	0
ginger ale	allergic reaction	0
vital nutrients	study cancer	0
açai berries	prostate cancer	0
mustard greens	food-borne illnesses	0
norovirus food	vulvar neoplasm	0
radicchio	colon neoplasm	0
trigonella foenum-graecum	obesity in adolescence	0
amlas	pancreas cancers	0
elettaria	fatigue	0
fig	malignancy	0
actual fruit	infant obesity	0
know nuts	tonsillar neoplasms	0
daily nut	parkinsonian diseases	0
soy bean curds	hair loss	0
rheum tanguticum	psoriase	0
fava bean	cardiac dysrhythmia	0
java plum tree	peripheral artery disease	0
ilex paraguariensis	somatotropin (acromegaly) hypersecretion syndromes	0
squash plants	bilateral sciaticas	0
broccoli raab	disk degeneration	0
food and drug administration	bewilderment	0
breakfast cereal	renal calculus	0
red meats	foodborne botulism	0
trace minerals	small-cell lymphomas	0
cymbopogon	osteoarthrosis	0
cucumber	arthropathy	0
dietary sucrose	intractable headaches	0
morinda citrifolias	mild cognitive impairments	0
safflower oils	widespread chronic pain	0
citrus hystrix	ekbom psychogenic parasitoses	0
barberry	prostatic intraepithelial neoplasia	0
elettaria cardamomum	plasma cell myeloma	0
solanum lycopersicum	cancer of lung	0
grape seeds	vaginal neoplasm	0
english walnut	primary brain neoplasms	0
plantago seed	cancer of vagina	0
japanese plums	severe congenital microcephalies	0
plantain	myocardial ischemias	0
gooseberry	diffuse mixed-cell lymphoma	0
foie gras	chicken virus	0
citrus hystrices	delusional parasitoses	0
wheat brans	classic galactosemia	0
dairy yogurt	carcinogenesis	0
bagel	cephalgia syndromes	0
egg	prostatic cancer	1
gluten-free diet	alcoholism	0
peanut butter	heartburn	0
cucumis sativus	gerd	0
liquorice	head injury	0
bertholletia excelsas	colorectal cancers	0
concord grapes	subwakefullness syndromes	0
blueberry plants	cataract	0
eat flax	muscle soreness	0
hickory tree	tonsil cancer	0
english walnuts	blindness	0
purple grape	increased cancer	0
pea families	brain tumor	0
cocos nucifera	adenomatous polyps	0
garcinia mangostanas	gastric neoplasm	0
crataegus	familial creutzfeldt-jakob diseases	0
cycad	central nervous system degenerative diseases	0
crocus sativus	cephalalgia	0
saint john wort	granulomatous enteritis	0
rubberplant	fine tremors	0
flowering shrub	stomach neoplasm	0
lima beans	high cholesterol levels	0
food allergy	dna injuries	0
breakfast	toxico-infectious botulism	0
nightshade	cephalodynia	0
wort	drug dependence	0
acer negundos	senile tremors	0
taraxacum officinale	lymphoplasmacytoid lymphoma	0
eggnog	malignant neoplasm of breast	0
caryophyllus aromaticus	non epileptic convulsion	0
cured meats	mixed lymphomas	0
thousand foods	crohns disease	0
dioscorea	bovine leukemia virus	0
morning meals	birth defect	0
taking vitamin	liver failure	0
french bean plants	iron deficiency	0
golden raisins	peripheral demyelinating autoimmune disease	0
eragrostus	gastro oesophageal reflux	0
soda pop	dermatozoic delusion	0
health food	gorlin-goltz syndrome	0
açai berry	oxygen deficiencies	0
brazil nut tree	chronic lymphoblastic leukemia	0
almond butter	prostate cancers	0
red pepper	intraepithelial prostatic neoplasia	0
raw garlic	visceral steatosis	0
canned fruit	chronic fatigue disorders	0
euterpe oleracea	galactose epimerase deficiency	0
healthiest nuts	neuralgic migraines	0
fagopyrum tataricum	diabetic asymmetric polyneuropathy	0
curcuma longa	age related maculopathies	0
processed food	parkinson's disease	0
tulsi tea	neurologic degenerative conditions	0
cultivated oats	gnathostomiasis	0
healthier meat	infant botulisms	0
tobacco	fibrose	0
international nut	joint pains	0
marjoram plants	back pain with radiation	0
tumeric	terminal cancer	0
gravy	fatty liver disease	0
myristica fragran	psammomatous meningiomas	0
yogurt	experimental parkinsonism	0
jambolan plum tree	zoonotic disease	0
poppy seed	endometrial carcinoma	0
spearmint	dyslipidemia	0
melissa officinali	respiratory tract infection	0
ovary	psychotic disorders	0
trace elements	temporal region traumas	0
citrus-based fruits	acidose	0
java plum trees	hypoxemia	0
sesame oil	tonsillar neoplasms	0
red tea	zoonotic infectious disease	0
walnut	sneeze	0
navy beans	uterus neoplasm	0
agaricaceae	pneumonia	0
triticum aestivum	galactose-1-phosphate uridyltransferase deficiency	0
jasmine tea	hemolytic jaundices	0
fresh basil	cervix cancer	0
fatty foods	craniocerebral trauma	0
white bread	lou gehrig's disease	0
vitis	mixed-cell lymphomas	0
shellfish	malignant tumor of urinary bladder	0
dasheen	parodontosis	0
linum usitatissimum	hypertension	0
flavourer	e-b viruses	0
consumed chocolate	diffuse mixed cell lymphoma	0
california avocado	semirhythmic tremor	0
brassica	salmonella infection	0
nutriceutical	varix	0
milk thistle	short sleeper syndrome	0
butternut squash	renal neoplasm	0
common foxgloves	crohn's disease	0
sweet basils	birth defects	0
msg	sleep-related neurogenic tachypneas	0
cider vinegar	gnathostomiasis	0
chile pepper	deep venous thromboses	0
acer saccharum	atherosclerosis	0
domestic fowls	migraine variant	0
grecian foxglove	paraesophageal hiatal hernias	0
acai berry	copd	0
texturized vegetable proteins	udp-galactose-4-epimerase deficiency	0
kola nut	eye diseases	0
wild celeries	bone fractures	0
alcoholic beverages	male sterility	0
herbal tea	body weights	0
grapefruit	retained surgical instruments	0
secale	brain cysticercosis	0
organic foods	b cell leukemia	0
reindeer meat	focal seizure	0
capsicum	pancreatic neoplasm	0
andean blackberries	bovine leukosis	0
big apples	tonsillar cancers	0
alpine strawberries	chronic daily headaches	0
potato chips	testis neoplasm	0
toxic plants	radiating pains	0
candy bar	neurologic degenerative condition	0
chile peppers	senile paranoid dementia	0
morel	diabetes-related complication	0
pimiento	bipolar disorders	0
garcinia mangostana	v cjd (variant creutzfeldt jakob disease)	0
psidium guajava	low grade lymphoma	0
ribes nigrum	vaginal neoplasm	0
phaseolus acutifolius	diabetic asymmetric polyneuropathies	0
psidium	kidney failures	0
onion	physical anhedonia	0
milk thistles	exudative bronchiolitis	0
dried apricots	back pains	0
kava kavas	prostate neoplasms	0
sea bilberry	splitting pains	0
inadequate fruit	gastric neoplasms	0
purslane	neurocysticercosis	0
bitter orange tree	acute monocytic leukemia	0
caryophyllus	virus	0
salt-free diet	porcine endogenous retroviruses	0
steak	diffuse lymphoma	0
cocoa plants	kidney neoplasm	0
trigonella	psychosis	0
paprika	breast fibrocystic change	0
abelmoschus esculentus	craniocerebral traumas	0
pleurotus ostreatus	parkinsonian syndrome	0
whole grain	hypoascorbemia	0
high fructose corn syrup	neurodegenerative diseases	0
pummelo trees	urinary bladder disease	0
safflower	post-traumatic osteoporoses	0
beta vulgari	involuntary quiver	0
chicken meat	human influenza	0
cream cheese	burkitt herpesvirus	0
bok choy	preinvasive carcinoma	0
cardamom	acquired immuno-deficiency syndromes	0
bt corn	als (amyotrophic lateral sclerosis)	0
phyllanthus emblicas	hereditary galactokinase deficiency	0
zedoary zedoaria	acquired immune deficiency syndrome	0
persimmon	perioral tremors	0
red delicious	a-v dissociations	0
raw tomatoes	uterine leiomyoma	0
strawberry	liver dysfunctions	0
grecian foxgloves	t viruses	0
restrict food	human t cell lymphotropic virus type iii	0
jam	human t-lymphotropic virus type iii	0
cider	male breast neoplasm	0
processing meat	early detection of cancer	0
scrambled eggs	familial tremors	0
group foods	breast malignant tumors	0
saffron crocus	brain cysticercosis	0
sugary foods	acute cerebrovascular accidents	0
lime	oral cancer	0
carob	guillain-barre syndrome	0
carthamus tinctorius	inflammatory demyelinating polyneuropathy	0
term vegetable	diabetes complications	0
sweet marjoram	bladder tumors	0
shorten	diverticulitis	0
hibiscus	esophageal hernias	0
diospyros digynas	lou-gehrigs disease	0
wheatgrass	degenerative arthritis	0
baker's yeast	oncogenic viruses	0
lycium chinense	chronic lymphocytic leukemias	0
rose hips	ciliary neuralgia	0
shoot	miscarriage	0
peppermint	cot death	0
atropa belladonna	nevoid basal cell carcinoma syndrome	0
blossom	nonhodgkin lymphoma	0
concord grape	cardiovascular diseases	0
cassia fistulas	somatotropin hypersecretion syndrome (acromegaly)	0
pea	diabetes complications	0
squashe	autistic disorders	0
goji berry plants	vertebrogenic pain syndromes	0
pizza	retro-ocular headaches	0
cocoa powder	pus	0
dietary plant proteins	cancer of the uterus	0
sweetener	cough	0
trace element	drug abuse	0
nutraceutical	bruise	0
iceberg lettuce	basal cell carcinoma	0
breast milk	cancer of pancreas	0
offal	ankylosing spondylarthritides	0
cold-steeping tea	intractable headaches	0
fake meat	foreign bodies	0
black tea	congenital defects	0
suggesting fruit	bipolar affective psychosis	0
hypericum perforatum	cancer of the liver	0
beta vulgaris	ciguatera fish poisonings	0
candy bars	epimerase deficiency galactosemias	0
dioscorea villosa	atypical diffuse small lymphoid lymphoma	0
carica papayas	heart disease	0
tuna fish	posterior fossa meningioma	0
cola acuminata	biliary calculi	0
guacamole	multiple head injury	0
sunchoke	spindle cell carcinoma	0
cauliflower	dysfunction	0
goji berries	confusional states	0
specific nuts	primary brain tumor	0
flammulina velutipes	somatosensory seizures	0
banana plants	food borne diseases	0
marjoram plant	microlissencephaly	0
low-salt diet	single seizure	0
fruit-shaped marshmallows	tonic clonic seizures	0
croaker	multiple myelomas	0
sour orange trees	cardiovascular diseases	0
soybean	uterine cervical neoplasm	0
pea family	multiple sclerosis	0
black currants	premenstrual tension	0
herbal teas	pyrose	0
jambolan plum trees	disseminated sclerosis	0
study lavender	central nervous system degenerative diseases	0
syzygium malaccense	benign prostatic hyperplasia	0
phaseolus vulgaris	bechterews disease	0
solanum dulcamara	darkness tremor	0
phytonutrient-rich food	condylomata acuminata	0
retail meat	brain disorders	0
machaerium	retinitis	0
yam	salami brusher's disease	0
processed foods	leucocythaemia	0
cooked tomatoes	postpartum sterility	0
leek	apoplexy	0
organ	peanut hypersensitivity	0
own vitamin	water-borne hepatitis	0
regular olive	pancreas neoplasm	0
dinner	peanut allergies	0
individual candy	mammary cancer	0
aspalathus linearis	oncogenesis	0
chinese yam	multiple myositides	0
garlic	diabetic neuropathies	0
cicer arietinums	carotid sinus syncopes	0
tree nuts	chronic fatigue syndromes	0
soft drink	breast carcinomas	0
hazelnut	virus diseases	0
cayenne pepper	acquired immunodeficiency syndrome virus	0
betel nuts	childhood onset obesity	0
maize oils	voice box cancer	0
whiting	chronic fatigue-fibromyalgia syndromes	0
jelly beans	type i diabetes mellitus	0
different fruits	gastric cancer	0
kombucha teas	hereditary essential tremor	0
almond tree	chicken viruses	0
lettuce	brain vascular accident	0
cayenne peppers	hereditary galactokinase deficiency	0
lentil	pancreas cancers	1
unhealthy food	malignant brain neoplasms	0
chipotle	low grade lymphoma	0
plantago indica	testis cancer	0
mentha piperita	cancer of bone	0
honeybush tea	pyorrhea alveolaris	0
cola	age-related memory disorder	0
opium poppies	fibroid	0
triticum turgidum	bladder tumor	0
prebiotic	mottled enamel	0
sea food	mottled enamel	0
triticum spelta	exudative bronchiolitides	0
faba bean	high grade lymphoma	0
chewing gum	galactosemia 2	0
kaffir lime	abdominal obesity	0
soy	hepatic cancers	0
prunus amygdalus	parkinsonian syndromes	0
peach tree	physical anhedonias	0
flax seed	cardiac failure	0
dried pomegranate	broken bone	0
rubus	impaired sensations	0
baptisia	ph1 negative myelogenous leukemia	0
lemongrass	memory deficits	0
fenugreek seeds	idiopathic parkinson's disease	0
walnut oil	somatotropin hypersecretion syndrome (acromegaly)	0
lavender	variant creutzfeldt jakob disease	0
lunchtime	male sexual impotence	0
food supplements	anal fissure	0
osmanthus	blood clots	0
hypericum perforatums	peripheral artery diseases	0
purple potatoes	sub-fertility	0
origanum vulgare	wheat allergies	0
pomegranate	sudden infant death syndrome	0
sesame oils	painful diabetic neuropathy	0
illicium verum	eye diseases	0
including cloves	proliferative bronchiolitis	0
raw poultry	colonic inertia	0
commercial milk	intestinal disease	0
breakfast times	bacteria-eating virus	0
ephedras	atrial fibrillations	0
morinda	pancreatic cancers	0
ready-prepared foods	amyloidose	0
pimpinella	insulin dependent diabetes mellitus 1	0
philadelphia cream cheese	anxiety disorders	0
lamb chops	colorectal carcinoma	0
happy meal	carcinoma	0
longevity legumes	cancer of the colon	0
plant capsule	prostatic neoplasm	1
cardamon	semantic memory disorders	0
white meat	plasmodium infections	0
prunus domestica	breast tumor	0
pistachio	central obesities	0
chard	lung neoplasm	0
kava kava	gustatory seizure	0
amomum cardamomum	fighting cancer	0
texturized soy proteins	atheromatous plaques	0
bolete	hip fractures	0
carya illinoensis	galactosemia 3	0
euterpe oleracea mart.s	amnesia memory loss	0
phaseolus	cellulite	0
whole grains	breast dysplasia	0
humulus lupulus	hypertension	0
olive family	somatosensory seizures	0
healthier foods	manic states	0
soy food	lymphatic sarcomas	0
tomato sauce	cluster headache syndrome	0
foeniculum vulgares	gnathostoma infections	0
citrus paradisi	aneurysm	0
warm milk	carcinoma of endometrium	0
sorrel	bladder tumor	0
pepsi	ankylosing spondylarthritides	0
olive oils	diabetic asymmetric polyneuropathies	0
pine nuts	landry-guillain-barre syndrome	0
snack food	hyperventilation syncopes	0
daucus carota	convulsion	0
avena sativa	vertebrogenic pain syndromes	0
marijuana	growth hormone receptor defect	0
apple	body weights	1
nutrient-dense foods	testicular cancers	0
baby formula	cattle leukemia virus	0
chinese cinnamon	uterus cancers	0
calendula	monoblastic leukemia	0
chamomile tea	endometrium carcinoma	0
lens plant	germinoblastic sarcoma	0
no-calorie sweeteners	disk degeneration	0
coriandrum	brain cancers	0
billion eggs	parkinson’s disease	0
bhang	schizophrenia	0
mastic trees	ph1-negative myelogenous leukemias	0
entree	degenerative diseases	0
cannabis sativas	temporal region traumas	0
soy sauce	hemorrhoid	0
cuminum cyminums	early-onset parkinsonism	0
anacardium occidentales	vulvar cancers	0
cucumis melo	diffuse undifferentiated lymphoma	0
mustard oil	bacterial vaginitides	0
prunus salicina	amyotrophic lateral sclerosis parkinsonism dementia complex 1	0
whipped cream	non epileptic convulsion	0
sushi	hernia	0
chilli pepper	menstrual pain	0
chanterelle	testicular cancer	0
fast food	intervertebral disk degeneration	0
brown sugar	cva (cerebrovascular accident)	0
common olive tree	anal fissure	0
purine-rich plant	skin cancer	0
orange trees	tumor virus	0
citrus sinenses	jacksonian seizure	0
anise	senile tremor	0
contamination meat	muscular spasms	0
contaminated foods	steatohepatitide	0
hot pepper	parkinsonian syndromes	0
stryphnodendron	rectum neoplasm	0