
saffron crocus	degenerative disease	0
white bread	influenza in humans	0
allium sativum	kahler disease	0
soy milk	leukemogenic viruses	0
cassia	mixed cell lymphoma	0
linum usitatissimum	diffuse undifferentiated lymphomas	0
garcinia mangostana	comatose	0
sugar substitute	chronic b-cell leukemia	0
burrito	palmoplantaris pustulosis	0
floret	postural low back pain	0
norovirus food	pseudotumor cerebri	0
musa	vaginal neoplasm	0
eugenia jambos	breast disease	0
aspartame	anal ulcers	0
honey	disc degradations	0
medicago sativa	parasagittal meningioma	0
happy meal	hiatal hernias	0
plantago psyllium	creutzfeldt-jakob syndrome	0
meal	palsy	0
grecian foxgloves	amyloidosis	0
turnip	adolescent obesity	0
justicia adhatoda	fissure in ano	0
guava	atrioventricular dissociations	0
hummus	syncopal vertigo	0
cheese	breast adenosis	0
digitalis lanata	mixed lymphocytic-histiocytic lymphoma	0
inadequate fruit	polyarthritis	0
cannabis indicas	chicken viruses	0
garden radish	uterine cervical neoplasm	0
big apples	acute confusional migraine	0
cuminum cyminum	fibroatheromatous plaques	0
willow tree	macular degeneration	0
eupatorium rebaudianum	intracranial neoplasms	0
triticum spelta	endometrium carcinoma	0
legume pods	parasagittal meningioma	0
raw broccoli	diabetic amyotrophies	0
foie gras	regional ileitis	0
rubus fruticosus	paludism	0
cherry plum tree	relapse	0
myristica fragrans	sensory seizures	0
macadamia	gnathostomiasis	0
triticum aestivum	degenerative intervertebral discs	0
sparkling waters	neurodegenerative disorders	0
juiced broccoli	dermatozoic delusion	0
pea families	venereal warts	0
reindeer meat	circulatory collapse	0
garbanzo	human t-lymphotropic virus type iii	0
broth	macular dystrophy	0
bertholletia	gastric cancers	0
lunch times	orthostatic headaches	0
root	carcinogenic retroviruses	0
juglans regia	endotoxemia	0
eugenia sandwicensis	landry guillain barre syndrome	0
vegetarianism	rectal tumor	0
cannabi	high grade lymphoma	0
flavorer	tonic-clonic seizure	0
hot peppers	pyrexia	0
fructose corn	hypercapnia	0
mealtime	malignant epithelial tumors	0
elettaria cardamomum	rickets	0
coriandrum	ovarian neoplasms	0
banana plants	near-death experience	0
carob	parkinson's disease	0
daily nut	aids viruses	0
lemon verbena	cancer of the tongue	0
dietary supplements	weight gains	0
family vegetables	spinal cord disorder	0
carbonated waters	acute strokes	0
persimmon	creutzfeldt jacob disease	0
split pea	orthostatic headaches	0
specific foods	lymphoma	0
mesquite	birth weights	0
not-necessarily-so-healthy foods	muscle tenderness	0
yolk	near-death experience	0
purple potatoes	sleep initiation dysfunctions	0
white tea	gum disease	0
hemlock	uterus neoplasms	0
citrus aurantiifolia	infarction	0
carthamus tinctorius	infant botulism	0
citrus	bechterew's disease	0
brussels sprouts	small non-cleaved-cell lymphomas	0
orange tree	persistent tremor	0
eugenia cumini	somatotropin hypersecretion syndromes (acromegaly)	0
foeniculum	non hodgkin lymphoma	0
drinking coffee	parkinsonism	0
oregano	ciliary body spasm	0
mangiferas	epithelial cancers	0
dioscorea opposita	breast tumors	0
canned food	autoimmune disease	0
bilberry	zoonotic infectious diseases	0
plant aril	creutzfeldt-jakob syndrome	0
dietary fats	liver diseases	0
big food	influenza in human	0
molasse	cancer of the testes	0
citrus-based fruits	cancer of the thyroid	0
grouper	juvenile onset diabetes mellitus	0
toxic plants	juvenile parkinsonism	0
drink milk	testis cancer	0
sweetening agents	kill cancer	0
kava kava	dizzyness	0
pea family	dental disease	0
poultry product	food-borne disease	0
milk chocolate	ph1-negative myelogenous leukemias	0
papaya	pruritis	0
brussel sprout	cow disease	0
brewage	dairy product intolerance	0
salsa	angioblastic meningioma	0
dried foods	sliding hiatal hernia	0
syzygium jambolanum	wheat allergies	0
butter	a-v dissociations	0
oolong	gastroesophageal reflux disease	0
japanese plums	ovarian cancers	0
euterpe	norwalk like viruses	0
chili peppers	dizzyness	0
sunfish	ekbom delusional parasitosis	0
cola nitida	small lymphocytic lymphomas	0
human milk	human influenza	0
fat foods	atopic diseases	0
zinger tea	mptp induced experimental parkinsonism	0
nicotiana tabacum	dairy product intolerance	0
agave	non-hodgkin's lymphoma	0
chewed coca	liver neoplasm	0
quinoa	degenerative intervertebral discs	0
cocktail	diabetes-related complications	0
real chocolate	wheat hypersensitivities	0
kava	bovine leukemia virus	0
mashed potatoes	hyperventilation syncope	0
brassica juncea	lymphadenopathy associated virus	0
foxglove	prostatitis	0
animal-based vitamin	seizure	0
table salt	vertex headache	0
banana	hypertension	0
syzygium sandwicense	schilling type myeloid leukemia	0
morel	congestive heart failure	0
undercooked meat	prion-associated disorders	0
sweetening agent	perforated appendicitis	0
vicia faba	pyorrhea alveolaris	0
wine	uterine cervical cancers	0
walnut oil	influenza in human	0
chocolate bars	hair losses	0
carbonated mineral water	chronic b-lymphocytic leukemia	0
collard greens	secondary insomnia	0
punica granatums	cognitive declines	0
digitalis purpurea	autoimmune disease	0
gravy	retro-ocular headaches	0
cider vinegar	ciguatera poisoning	0
stevia rebaudianas	atrial fibrillation	0
bean sprout	laron syndrome	0
food company	short sleep phenotype	0
apple	acquired immunologic deficiency syndrome	0
zingiber officinales	galactosemia	0
marsh mallows	micturition syncopes	0
dripping	cough	0
poisonous plant	ekbom psychogenic parasitoses	0
smoked food	bleed	0
olea europaea	familial creutzfeldt-jakob diseases	0
cardamon	male impotence	0
assai palm berry	acne	0
dioscorea villosa	bowel disease	0
saint johnswort	small non-cleaved-cell lymphoma	0
beet	degenerative diseases	0
allium cepa	neurologic degenerative disease	0
soymilk	transmissible spongiform encephalopathies	0
syzygium	diabetic polyneuropathies	0
citrus hystrix	testicular cancers	0
pyrus	premature aging	0
origanum vulgare	endometrial neoplasm	0
wisconsin milk	myocardial infarctions	0
legume pod	infectious mononucleosis virus	0
english walnut	hepatitis	0
margarine	chronic disease	0
include apples	cat leukemia viruses	0
lens plant	amnestic state	0
soy yogurt	bipolar affective psychoses	0
morinda	disk degradations	0
java plum trees	bipolar depression	0
chamomile oil	retained surgical item	0
cooking oil	vaginal discharges	0
foodstuff	pyrose	0
acer saccharums	voice box cancer	0
onion	cva (cerebrovascular accident)	0
find pork	gorlin goltz syndrome	0
frequent meals	autosomal recessive juvenile parkinsonism	0
healthiest beverage	mild neurocognitive disorders	0
collard	common cancers	0
nightshade	cjd (creutzfeldt-jakob disease)	0
food poisoning	preterm births	0
psyllium	psychogenic parasitoses	0
mentha	long sleeper syndromes	0
mustard	fibrocystic mastopathy	0
shellfish	gorlin goltz syndrome	0
uncooked foods	dementia praecox	0
rheum officinale	endometrium carcinomas	0
iv vitamin	primary parkinsonism	0
poppy seed	mental disorders	0
favorite meals	retained surgical sponges	0
tomato	gastroesophageal reflux	0
sweet peppers	weight reductions	1
solanum dulcamara	rna tumor virus	0
miso	spondyloarthritis ankylopoietica	0
brew	nerve tremors	0
organic foods	diffuse lymphoma	0
shiitake mushroom	craniocerebral trauma	0
eden foods	blindness	0
eat chocolate	pancreatic cancers	0
zedoary zedoarias	back aches	0
sugar substitutes	non alcoholic fatty liver disease	0
dried fruit	small round structured viruses	0
vaccinium macrocarpons	cattle leukemia virus	0
pickled foods	congenital hypothyroidism	0
canned foods	essential tremors	0
pomegranate	galt deficiency	0
mentha piperita	copd	0
jam	virus disease	0
feather meal	massive tremor	0
prunus amygdalus	colitis	0
term vegetable	tick bite	0
texturized vegetable protein	benign essential tremors	0
drink tea	infectious disease	0
philadelphia cream cheese	spindle-cell carcinoma	0
althea officinalis	sleep wake disorders	0
eating broccoli	emphysema	0
tv dinners	virus infections	0
cultivated oats	pustulosis palmaris et plantaris	0
ocimum basilicums	cryptogenic epilepsy	0
daucus carota	fibrocystic mastopathy	0
eating food	heart decompensation	0
antioxidant foods	early infantile autism	0
ilex paraguariensis	barrett's esophagus	0
component spices	diffuse lymphoma	0
pumpkin seeds	dermatozoic delusions	0
sweeten	respiratory tract cancer	0
dried blueberries	atrophy	0
lycium chinense	drop attack	0
teosinte	vertex headaches	0
sauerkraut	substance abuse	0
whiting	prostatic cancers	0
trigonella foenum graecum	orf	0
cruciferous foods	manic-depressive psychoses	0
cocoa powders	syncopal vertigo	0
swiss chard	botulism	0
cinnamon	vulvar neoplasms	0
milk thistle	pseudopelade	0
plant kingdom	endothelial dysfunction	0
carbonated drinks	human papilloma virus	0
regular olive	periadenitis mucosa necrotica recurrens	0
antioxidant vitamin	rectal cancer	0
cayenne peppers	idiopathic parkinson disease	0
avena	dermatozoic delusions	0
serve	apnea	0
morinda citrifolias	fibromyositis fibromyalgia syndrome	0
red rice	fibrous meningiomas	0
fenugreek seed	disrupted in b-cell malignancy	0
earl grey tea	malignancy	0
brown rice	als (amyotrophic lateral sclerosis)	0
no noni	aids viruses	0
pea	diabetic autonomic neuropathies	0
marsh mallow	persistent atrial fibrillations	0
diabetic diet	autism	0
celery root	decreased cancer	0
osmanthus tea	cancer of the brain	0
nut butter	vertiginous seizure	0
horse nettles	breast carcinoma	0
syzygium jambos	degenerative neurologic disorder	0
french bean plant	esophagus cancer	0
natural vitamin	small cleaved-cell lymphoma	0
citrus sinenses	primary fibromyalgia	0
chamomile tea	gastric ulcers	0
ultra-processed foods	arthropathy	0
euterpe oleracea	left-sided heart failure	0
low vitamin	royal free disease	0
include flaxseed	bacteriophage	0
low fruit	retroviridae	0
nonus	udpglucose 4 epimerase deficiency disease	0
alpine strawberries	textiloma	0
processed foods	syncopal episodes	0
roundup-ready soybeans	dairy product intolerance	0
avenas	zoonotic infectious disease	0
mother cell	hypoxia	0
organic food	aortic aneurysm	0
plantain	cadaver	0
multivitamin	gnathostomiasis	0
raspberry	autosomal dominant parkinsonism	0
dangerous plants	udpglucose hexose-1-phosphate uridylyltransferase deficiency	0
spinach	amyotrophic lateral sclerosis parkinsonism dementia complex 1	0
yerba mate	crohns disease	0
candy bar	kill cancer	0
saccharomyces cerevisiae	condylomata acuminata	0
dioscorea batatas	head pain	0
wild yams	sharp headache	0
flammulina velutipes	contagious ecthyma	0
octopus	generalized spasms	0
sweet basils	arthrosis	0
vitamin	experimental parkinson disease	0
longevity legumes	diabetes complication	0
anticancer plant	tonsillar neoplasms	0
ginger	pattern baldness	0
ketchup	malignant brain neoplasm	0
prunis communis	contagious ecthyma	0
chinese yams	endometrioma	0
eating eggs	prostate neoplasms	0
citrus medica	primary malignant brain tumors	0
millet	high-grade lymphoma	0
ready prepared foods	hepatic failure	0
prunus persica	deep vein thromboses	0
eugenia jambolana	infectious mononucleosis viruses	0
acer saccharum	retro ocular headache	0
leek	foreign body	0
coco	vagina neoplasm	0
walnut	inflammatory polyneuropathy acute	0
black currants	cough	0
fresh meat	cerebral convexity meningiomas	0
no-calorie sweeteners	udp-galactose-4-epimerase deficiency	0
food pyramid	spinal cord diseases	0
group foods	diarrhea	0
corn	pulmonary thromboembolism	0
artificial butter	parasagittal meningiomas	0
safflower oils	bovine leukosis	0
food allergies	craniocerebral injury	0
jell-o	perioral tremor	0
eating nuts	autistic disorder	0
mother cells	uterus cancers	0
tepary beans	mammary cancers	0
turkey meat	aortic aneurysms	0
plant-based foods	autosomal dominant parkinsonism	0
celery	mottled enamels	0
copaifera	e-b viruses	0
afzelia	atherosclerosis	0
lemon trees	gastroenteritis	0
phaseolus acutifolius	jakob creutzfeldt disease	0
nutrient-dense foods	fibromyalgia-fibromyositis syndrome	0
organic meat	human papillomavirus virus	0
alpine strawberry	endometrial cancers	0
arachis	ocular headaches	0
offal	osteoarthritide	0
algarrobo	intestinal disease	0
daily fruit	breast fibrocystic disease	0
cereal grains	drop attack	0
fortify milk	gale deficiencies	0
pimpinella anisums	plasmodium infections	0
curcuma longas	human mammary neoplasm	0
breast milks	premenstrual tensions	0
club sodas	venous thrombosis	0
msg	pancreas neoplasms	0
rheum	sphenoid wing meningioma	0
milk thistles	cervix cancers	0
four nuts	hepatocellular cancers	0
eugenia aromatica	prion-associated disorders	0
wheat brans	periodontal disease	1
sweet almond	cluster headaches	0
faba beans	kidney neoplasm	0
piper nigrum	tubal abortion	0
woodland strawberry	terminal cancer	0
coriandrum sativums	experimental parkinson diseases	0
low-fat diet	periodontal disease	0
squash plants	tremor	0
almond tree	uterine cancer	0
olive oils	diabetic complications	0
cleistocalyx	dementia with amyotrophic lateral sclerosis	0
plum	fibromyalgia-fibromyositis syndrome	0
deep-fry foods	parkinson’s disease	0
foeniculum vulgares	germinoblastic sarcomas	0
largest meal	diabetes-related complications	0
lime	uterine neoplasms	0
aubergine	chronic lymphocytic leukemia	0
lentil	migraine headache	0
glycyrrhiza	diabetic polyneuropathy	0
cicer	microcystic meningioma	0
capsicum annuum	male sterility	0
calendula	strains and sprains	0
chickpea	strains and sprains	0
american meat	mucous colitides	0
laudable legume	age related maculopathy	0
healthy nuts	steatosis of liver	0
restructured meat	e-b viruses	0
fast foods	aphthous stomatitides	0
cooked broccoli	reduced sensation	0
boiled eggs	meningotheliomatous meningioma	0
zea mays	sciatic neuralgias	0
indian corn	hair loss	0
low-salt diet	upper respiratory infections	0
soda pop	penis cancers	0
horsebean	angioblastic meningiomas	0
handling food	postoperative emeses	0
lemon	degenerative intervertebral discs	0
cinnamomum cassia	lens opacities	0
marjoram	mixed lymphocytic-histiocytic lymphoma	0
beet greens	cognitive declines	0
gooseberry	non hodgkin's lymphoma	0
fruit juices	hemicrania	0
linum	lens opacities	0
sweet orange	lobar pneumonia	0
citrus reticulatas	gastric cancer	0
maple	lobar pneumonias	0
new vitamin	renal insufficiencies	0
yellow vegetables	secondary insomnia	0
maguey	ph1-negative myelogenous leukemias	0
fast food	cysticercose	0
concord grape	wart viruses	0
worldwide fruit	neurodegenerative disorders	0
golden delicious apples	atherosclerotic plaques	0
mussel	coronary heart diseases	0
ceratonia	strains and sprains	0
grape seeds	paraesophageal hernia	0
pecan	coronary diseases	0
mustard plants	parkinson’s disease	0
peanut	virus diseases	0
nut bars	hysterical amnesias	0
chile peppers	viral infections	0
agent orange	sleep wake disorders	0
liquor	ankylosing spondylitis	0
ground flax	spiral fractures	0
horsemeat	mouth cancer	0
animal-based foods	chicken embryo lethal orphan virus	0
goji berry plants	kidney diseases	0
california avocado	paraesophageal hernia	0
coconut water	venereal warts	0
consumed chocolate	atrioventricular dissociations	0
olive	chronic fatigue disorder	0
osmanthus	fusiform aneurysm	0
new candy	involuntary quiver	0
pummelo trees	myalgia	0
domestic fowl	uterine cervical neoplasms	0
exotic fruits	sleep-related neurogenic tachypnea	0
soy foods	passive tremors	0
strawberry	inflammatory bowel disease 1	0
prosopis	subtrochanteric fractures	0
mustard seeds	leukemogenic virus	0
monitoring food	ovarian cancer	0
raisin bran	high-grade lymphomas	0
taraxacum	saturnine tremors	0
stevia	nontropical sprue	0
topical ginger	degenerative arthritis	0
biometal	bone fracture	0
domestic fowls	prostatic hypertrophy	0
cooked meat	foreign bodies	0
citrus aurantiifolias	passive tremors	0
crocus	endometrioma	0
cicer arietinum	e b virus	0
lemon grasses	somatotropin (acromegaly) hypersecretion syndrome	0
pistil	convulsive seizure	0
gala apples	amyotrophic lateral sclerosis-parkinsonism-dementia complex 1	0
common bean plants	prostatic neoplasms	0
maraschino cherry	physical anhedonias	0
cola	penis neoplasm	0
sour fruit	sprains and strains	0
green tea	headache syndromes	0
spaghetti	gastro oesophageal reflux	0
kola nut	infectious mononucleosis viruses	0
plum tree	cranial pain	0
bell pepper	schizophreniform disorder	0
assai palm berries	gastric neoplasm	0
so-called vegetable	groundnut hypersensitivity	0
coca cola	bechterews disease	0
chile pepper	colitide	0
romaine	tussive syncope	0
ice cream	mixed lymphocytic histiocytic lymphoma	0
beer	auto-immune disease	0
juglans nigra	ekbom delusional parasitosis	0
fresh basil	amyotrophic lateral sclerosis parkinsonism dementia complex 1	0
apple tree	undifferentiated carcinomas	0
arugula	gluten enteropathies	0
frosting	physical anhedonia	0
specific cheeses	sudden cardiac arrest	0
beta vulgari	oncogenesis	0
maple syrup	burkitt lymphoma virus	0
vicia fabas	gynecomastia	0
plant arils	varicose vein	0
solanum tuberosum	drug hypersensitivities	0
mushroom	iron deficiency	0
coconut milk	anoxemia	0
triticum turgidum	fibromyoma	0
shiitake mushrooms	hemorrhage	0
century plant	pill rolling tremor	0
tree nuts	breast disease	0
plant capsule	social anxiety disorder	0
individual food	severe mental disorder	0
hemp	animal viruses	0
flaked coconut	autistic disorders	0
sweet marjorams	gastro-esophageal reflux	0
crataegus monogynas	paratuberculose	0
box elders	respiratory tract cancer	0
lycium	hiccough	0
scallion	esophageal hernias	0
emblica officinalis	primary growth hormone resistance	0
mirobalanus embilicas	diffuse myofascial pain syndrome	0
dog rose berries	chronic lymphoblastic leukemia	0
candy	a-v dissociation	0
pimenta diocia	norwalk-like viruses	0
texturized soy protein	olfaction disorders	0
hibiscus tea	philadelphia-negative myeloid leukemias	0
rooibos tea	convulsive syncope	0
frozen cranberries	gustatory seizures	0
potato chips	lou-gehrigs disease	0
dinner	small round structured viruses	0
seltzer water	deaf mutism	0
alfalfa sprouts	esophagus neoplasm	0
cinnamomum trees	subtrochanteric fractures	0
jambolan plum tree	proliferative bronchiolitides	0
chewing gum	brain malignant neoplasms	0
pineapple	intracranial neoplasms	0
popular fruits	central nervous system intracranial disorders	0
broccoli raab	low back ache	0
pumpkin pie	neurotic anxiety states	0
mastictree	avian leukosis/sarcoma virus	0
lemon tree	ankylosing spondylarthritides	0
cassia fistulas	esophagitis	0
origanum onites	ovarian cancers	0
tobacco	leucocythaemia	0
abelmoschus	bilateral headache	0
caryophyllus aromaticus	juvenile-onset diabetes	0
lemon balm tea	lung cancer	0
white meat	breast neoplasms	0
preserved food	menstrual pains	0
ovary	migraine headaches	0
almond oil	cervical migraine syndrome	0
dietary fat	gehrigs disease	0
zedoary zedoaria	malignant meningioma	0
saint john wort	persistent atrial fibrillation	0
phyllanthus emblicas	membranous cataract	0
corn oils	psoriase	0
cassia trees	gasser's syndrome	0
crab apple	type i diabetes mellitus	0
acer negundos	rickets	0
oyster mushrooms	continuous tremors	0
narrow leaved plantain	gingivitis	0
portulaca oleraceas	histamine cephalgia	0
soy bean curds	venous thromboses	0
salt-free diet	micturition syncopes	0
egg	bechterews disease	0
chicken	autosomal recessive juvenile parkinsonism	0
salmonella-infected eggs	deaf mutism	0
lavandula angustifolia	lightheadedness	0
citrus limon	benign intracranial hypertension	0
overpriced vitamin	chronic lymphatic leukemia	0
orange juice	fibrose	0
pimpinella anisum	periorbital headaches	0
pimenta diocias	norovirus	0
capparis	lymphosarcoma	0
lemongrass	painful diabetic neuropathy	0
trace minerals	crushing pains	0
cassia cinnamon	endometrial carcinomas	0
bertholletia excelsas	temporal region traumas	0
triticum durum	spatial memory disorders	0
olive tree	microcystic meningioma	0
caper	udp galactose 4 epimerase deficiency	0
illicium	seasickness	0
eggplant	primary fibromyalgias	0
chilli peppers	brain disease	0
candy bars	dyspepsia	0
almond trees	acquired immunodeficiency syndrome	0
tea plant	anhedonia	0
haritaki fruit	diabetic complications	0
cucurbita	salami brusher's disease	0
health food	neurocysticercosis	0
drinking milk	gassers syndrome	0
hypericum perforatums	peripheral demyelinating autoimmune disease	0
dioscorea	low back aches	0
ocimum tenuiflorum	osteoarthrosis	0
porphyra	protein deficiency	0
ocimum basilicum	liver diseases	0
curried tofu	diabetic retinopathy	0
phyllanthus emblica	pulmonary embolisms	0
euchresta	classic galactosemias	0
fries	post-ictal confusion	0
leafy vegetables	rheumatoid spondylitis	0
pie	huntingtons disease	0
plantago indica	short sleeper syndromes	0
flaxseed	benign prostatic hyperplasia	0
healthiest fruits	nafld	0
petroselinum	zoonotic diseases	0
purple grape	proliferative bronchiolitides	0
portulaca oleracae	acute autoimmune neuropathies	0
catfish	primary brain neoplasms	0
hickory nuts	prostatic neoplasms	0
organ	johne disease	0
kola nuts	meningotheliomatous meningiomas	0
açaí berry	cot death	0
sparkling water	lichen rubra planus	0
flax seeds	meningiomatosis	0
rowanberry	pregnancy pernicious vomiting	0
green grapes	ph1-negative myeloid leukemia	0
curcuma	pancreatic cancers	0
laciniate nightshades	sleep-related neurogenic tachypneas	0
ephedras	alzheimer’s disease	0
grapefruit juice	ocular headaches	0
turmeric root	e b virus	0
pistacia vera	lichen rubra planus	0
vital nutrients	neurologic degenerative diseases	0
infects apples	marie-struempell disease	0
drinking water	splitting pain	0
chlorella	multiple myeloma	0
apium graveolens var. rapaceum	feline leukemia virus	0
wheatgrass	age related maculopathy	0
adhatoda vasica	texidor twinge	0
mustard oil	ankylosing spondyloarthritis	0
breakfast time	burn	1
soy proteins	higher cancer	0
humulus lupulus	carotid sinus syncope	0
pecan tree	autosomal dominant juvenile parkinson disease	0
radicchio	sciatica	0
brassica	inflammatory bowel disease	0
grilled meat	chronic disease	0
wild celeries	mild neurocognitive disorders	0
hibiscus	autosomal recessive juvenile parkinson disease 2	0
citrus reticulata	galactosemia 3s	0
crabapple	diabetic autonomic neuropathies	0
cumin	ankylosing spondylitis	0
contaminated foods	sea sickness	0
apricot tree	inflammatory bowel disease 1	0
triticum turgidum subsp. durum	vitamin deficiencies	0
fagopyrum	endometriose	0
hypericum	non-hodgkin lymphoma	0
rubus	kidney neoplasm	0
know nuts	hypesthesia	0
toxic plant	megacolon	0
nuclear power plant	medical conditions	0
dietary sugars	arterial fatty streak	0
solanum tuberosums	laron dwarfism	0
low-sodium diet	congenital myxedema	0
roughage	aphthous stomatitis	0
food supplementations	foreign objects	0
gum acacia	paralysis agitans	0
crowberry	stokes-adams syncopes	0
chamomile oils	vulva cancers	0
holy basils	neurocysticercosis	0
soy beans	kidney insufficiency	0
potassium-rich foods	varice	0
ribes nigrum	sea sickness	0
safflower oil	early-onset parkinsonism	0
grape juice	mild neurocognitive disorders	0
oxen meat	ph1 negative myelogenous leukemia	0
andropogon nardus	amaurosis	0
rooibo	regional ileitides	0
pumpkin	hemangioblastic meningioma	0
milk	infant botulism	0
ilex paraguarienses	numbness	0
red cabbage	disseminated sclerosis	0
black rice	chronic pain	0
hydroponic basil	thrombus	0
rheum rhaponticum	hepatic failure	0
pummelo tree	joint pain	0
dairy eggs	guillain-barré syndrome	0
navy beans	pyrose	0
texturized vegetable proteins	autosomal recesssive juvenile parkinsonism	0
pistachio	disk degenerations	0
ficus	amyotrophic lateral sclerosis-parkinsonism-dementia complex 1	0
soft drinks	avitaminosis	0
convenience foods	kahler disease	0
dried peas	penis cancers	0
fagopyrum tataricum	fusiform aneurysms	0
pancake	fibroid	0
english walnuts	sleep initiation and maintenance disorders	0
vitis vinifera	study cancer	0
weekly meat	small noncleaved-cell lymphomas	0
lima beans	cognitive dysfunction	0
bottled water	drug dependence	0
citrus paradisi	marek's disease virus	0
avocado fruit	craniocerebral trauma	0
tomato juice	plasma-cell myelomas	0
sardine	hiccup	0
apium graveolens	back pain with radiation	0
whole wheat	paraesophageal hiatal hernias	0
lens plants	headache syndrome	0
fenugreek	polyarthritide	0
carica papayas	cluster headache syndromes	0
black walnut	memory losses	0
citrus hystrices	mad cow diseases	0
unfiltered coffee	semantic memory disorder	0
rubberplant	cancer of the stomach	0
saint johns wort	familial dementias	0
spice turmeric	kidney failure	0
goji berry plant	apnea	0
garlic sauce	syncopal episode	0
food additives	gut dysfunction	0
eat flax	ciguatera fish poisoning	0
pithecellobium	newborn gynecomastia	0
mandarin orange trees	drug allergies	0
shorten	hemangiopericytic meningiomas	0
euterpe oleracea mart.s	sleep disorders	0
seed	ekbom delusional parasitosis	0
açai berry	sensory seizures	0
sea food	coma	0
sesamum	adenomatous polyps	0
irritable bowel kiwi fruit	perforated appendicitis	0
confection	esophageal reflux	0
red yeast rice	parkinsonism-dementia complex of guam amyotrophic lateral sclerosis	0
cookie	liver dysfunctions	0
specific nuts	multiple sclerosis	0
jambolan plum trees	long sleeper syndrome	0
black teas	dementia	0
bellis	leprosy	0
kiwi fruit	respiratory tract infections	0
raw food	disrupted in b-cell malignancy	0
betel nut	celiac disease	0
actual fruit	congenital defect	0
prenatal vitamins	spinal meningioma	0
citron trees	malignant brain neoplasm	0
plantago lanceolata	cervical neoplasm	0
soft drink	barrett metaplasia	0
prebiotic	palmoplantaris pustulosis	0
vaccinium ashei	neurodegenerative disorders	0
table sugar	thyroid disease	0
neu5gc-rich food	human influenza	0
ground beef	drug abuse	0
carbonated drink	bacterial vaginoses	0
chili	transmissible spongiform encephalopathies	0
aquatic food	near-death experience	0
hot pepper	burkitt lymphoma virus	0
billion eggs	infarction	0
drinking orange	creutzfeldt jacob disease	0
areca nuts	hypoxemia	0
cranberry juice	subfertility	0
sustenance	royal free disease	0
syzygium malaccense	chronic obstructive pulmonary disease	0
arachis hypogaea	recrudescence	0
andean blackberry	semantic memory disorders	0
garlic	angiomatous meningiomas	0
cannabis sativa	benign brain neoplasms	0
cardamom	hemangioblastic meningioma	0
apricot trees	breast carcinoma	0
baby carrots	cancer of tongue	0
black pepper	gnathostomiase	0
organ meats	communicable disease	0
venison	lymphoblastic leukemia	0
taraxacum officinale	nonorganic insomnia	0
exotic fruit	clear cell meningiomas	0
solanum dulcamaras	infectious disease	0
healthiest vegetable	male breast enlargement	0
rose berries	peanut hypersensitivity	0
food and drug administration	impaired sensation	0
agaricaceae	forehead traumas	0
white mallows	postoperative emeses	0
edible grains	passive tremor	0
citrus grandis	amnesia	0
frozen fruit	lymphocytic lymphomas	0
herr	age-related bone losses	0
black coffee	gossypiboma	0
tea hibiscus	visual seizure	0
cola acuminata	spindle cell sarcoma	0
origanum majorana	small non-cleaved-cell lymphomas	0
cold-steeping tea	meningotheliomatous meningiomas	0
neutraceutical	huntingtons disease	0
oregano plant	acute infectious polyneuritis	0
syrup	skin cancer	0
red tea	gasser's syndrome	0
ready soybeans	prostatic hyperplasia	0
barley	cataract	0
frier	thyroid disease	0
ganja	senile plaque	0
raphanus	benign prostatic hyperplasia	0
dinnertime	contusion	0
carica papaya	left sided heart failure	0
origanum	foodborne illnesses	0
chestnut	gestational diabetes mellitus	0
ale	small lymphocytic lymphomas	0
decaf	undifferentiated lymphomas	0
dried apricots	arthropathy	0
almond	colon neoplasm	0
allspice	todd's paralysis	0
pecan trees	sarcopenia	0
whortleberry	left-sided heart failure	0
brewed coffee	right sided heart failure	0
seville orange trees	convulsive seizure	0
soy beverage	anosmia	0
althaea officinalis	cervical cancer	0
molasses	fights cancer	0
honeybush tea	precordial catch syndrome	0
melissa	irritable colon	0
black currant	rabies	0
big meals	ms (multiple sclerosis)	0
pepper	fine tremors	0
triticum vulgare	cognitive retention disorder	0
lettuce	retained surgical instruments	0
humulus	substance-induced organic mental disorders	0
energy drinks	lyssa	0
abelmoschus esculentus	infectious mononucleosis virus	0
entree	multiple sclerosis	0
assai palm	small cleaved-cell lymphoma	0
fennel	urticarias	0
black sapotes	aneurysm	0
hemp plant	spinal cord diseases	0
cicer arietinums	drug hypersensitivity	0
coriander	dehydration	0
citrus bergamias	auditory seizure	0
stevia rebaudiana	intertrochanteric fractures	0
oolong tea	postoperative vomiting	0
cooked tomatoes	auriculo-ventricular dissociation	0
snack	generalized headaches	0
lemon balm	bovine spongiform encephalopathy	0
glucose-fructose syrup	esophagus cancer	0
plantago ovata	colon neoplasms	0
rise	joint pain	0
java plum tree	hypesthesia	0
orange	acidose	0
different seed	infectious diseases	0
paprika	guillaine-barre syndrome	0
pretzel	necrotizing fasciitis	0
maize syrup	familial creutzfeldt-jakob disease	0
official vitamin	intraorbital meningiomas	0
bok choy	cardiac disease	0
dried food	chronic fatigue syndrome	0
arginine-rich foods	schizophreniform disorder	0
red meat	post-traumatic osteoporosis	0
breakfast cereals	lymphatic sarcoma	0
frozen broccoli	gustatory seizure	0
little saffron	mixed small and large cell lymphoma	0
tisane	bacterial vaginitides	0
allium porrum	lou gehrig's disease	0
almond milk	fibromyalgia	0
poenumgraecum	sleeplessness	0
sweet foods	parkinson disease	0
cabbage	kill cancer	0
meal times	throbbing headaches	0
horse beans	tumor viruses	0
fruit juice	human cancer	0
corylus	paratuberculosis	0
measuring food	breast cancer	0
soy cheese	degenerative intervertebral disks	0
açai berries	uterine leiomyoma	0
chinese rhubarb	paroxysmal atrial fibrillation	0
common bean plant	cirrhosis	0
vaccinium angustifolium	mental deteriorations	0
indian laburnums	chronic pain	0
skim milk	condylomata acuminata	0
amlas	celiac disease	0
soya milk	vertebrogenic pain syndrome	0
chinook salmon	pregnancy-induced diabetes	0
sesame	intervertebral disk degenerations	0
citrus bergamia	mild cognitive impairment	0
boiled broccoli	auricular fibrillation	0
common plant	e-b viruses	0
phaseolus vulgari	malignant neoplasm of breast	0
vegetable oil	neuralgic migraine	0
sea bilberries	autoimmune disease	0
turmeric	kahler disease	0
last meal	meningioma	0
grape	childhood obesity	0
dioscorea polystachya	arthropathy	0
poisonous plants	bovine spongiform encephalitis	0
betel nuts	cervix cancers	0
eragrostus	galt deficiencies	0
lactuca sativa	fatty liver	0
white rice	chronic gum disease	0
tulsi tea	familial creutzfeldt jakob disease	0
flammulina	hyperventilation syncope	0
rose hips	weight gains	0
fuji apples	cancer of the thyroid	0
cilantro	mental deterioration	0
powdered ginger	cancer of lung	0
experience food	myocardial failure	0
macadamia nut	lyme disease	0
solanum laciniatums	campylobacter infection	0
jalapeno peppers	preterm births	0
cucumis sativus	vitamin deficiency	0
kale	seizure disorder	0
petroselinum crispum	oncornavirus	0
artificially-flavored corn	amyloidose	0
brazil nut tree	sneezing	0
monosodium glutamate	feline leukemia virus	0
thyme	nonspecific vaginitis	0
bitter nightshades	lung inflammation	0
chili pepper	colorectal neoplasm	0
chicken salad	herpesvirus	0
herbal tea	tonsil cancers	0
rye	cancer of the lung	0
common foxgloves	marie struempell disease	0
cassia fistula	nonhodgkin lymphoma	0
saffron	mixed cell lymphoma	0
cultivated oat	male subfertility	0
carbonated water	overeat	0
peppermint oil	galactosemia	0
pepsi	eye diseases	0
little meat	bacteriophage	0
cured meats	acquired immuno-deficiency syndromes	0
olea	blv	0
prunus domestica	semirhythmic tremors	0
sweet marjoram	epithelial cancer	0
purslane	breast malignant tumors	0
squash seeds	aphthous stomatitis	0
whole grain cereals	venous thromboses	0
coriandrum sativum	situational syncopes	0
toronja	ketosis prone diabetes mellitus	0
illicium anisatum	appendicitis	0
oregano plants	broken bone	0
infant formulas	basal cell epithelioma	0
hordeum vulgare	fibroatheromatous plaque	0
apricot	endothelial dysfunction	0
erythroxylon	back pain with radiation	0
cannabis	myocardial ischemias	0
melissa officinali	steatohepatitide	0
vaccinium bracteatum	transmissible dementia	0
ready-to-eat meals	premenstrual tension	0
citrus aurantium	semirhythmic tremor	0
narrow-leaved plantain	lymphosarcoma	0
low meat	high-grade lymphoma	0
elephant garlic	male breast carcinoma	0
stem vegetables	uterine leiomyoma	0
squashe	leukemogenic viruses	0
japanese plum	oral cancer	0
kangaroo meat	diarrhea	0
kidney bean	zoonotic diseases	0
high-fiber food	lymphocytic leukemia	0
eating fruits	esophagitis	0
lens culinaris	heart attacks	0
carya	crohn’s disease	0
beverage	gorlin syndrome	0
fed beef	galactosemia iii	0
citrus x paradisi	early diagnosis of cancer	0
sunflower seeds	viral infections	0
cauliflower	dental plaque	0
ground meat	endothelial dysfunction	0
color	posterior fossa meningiomas	0
breakfast	upper respiratory tract infections	0
bad foods	migraine variants	0
juglan	multiple myelomas	0
food companies	fatigue	0
suggesting apple	brains cancer	0
cymbopogon nardus	carcinomatose	0
ultra-processed food	rodent ulcers	0
actual licorice	retained surgical tools	0
common fruits	mild cognitive impairments	0
silybum marianums	premature aging	0
replenish nutrients	hepatic neoplasms	0
sugar-sweetened beverages	radiating pains	0
red lentils	sid	0
kawa kawa	spindle-cell carcinoma	0
eupatorium rebaudianums	anoxia	0
ephedra	venereal warts	0
melissa officinalis	small noncleaved cell lymphoma	0
fiddlehead ferns	gut dysfunction	0
almond butter	human mammary neoplasm	0
breakfast cereal	colonic inertia	0
amorpha	retro-ocular headache	0
shan yao	paroxysmal atrial fibrillations	0
rooibos	visual seizure	0
fake meat	subacute spongiform encephalopathy	0
hickory nut	occipital trauma	0
colorful foods	cysticercose	0
chilli pepper	weight reduction	1
cruciferous vegetable	brain benign neoplasm	0
seville orange tree	dental fluorosis	0
anti-inflammatory foods	sliding hiatal hernia	0
spearmint	ovarian neoplasms	0
greenery	cancer-causing herpesvirus	0
powdered sugar	gout	0
fermented cabbage	infantile colic	0
fava beans	short sleeper syndromes	0
rice milk	gallbladder disease	0
holy basil tea	social anhedonias	0
illicium verums	multiple myositis	0
malus domestica	gastric cancer	0
unhealthy food	gut dysfunction	0
pistachio nut tree	barretts syndrome	0
areca catechus	persistent tremors	0
diospyros digynas	atypical diffuse small lymphoid lymphoma	0
red peppers	small and large cleaved-cell lymphoma	0
baker's yeast	muscular rheumatism	0
vegetable proteins	parkinsonism	0
cranberry	stomatognathic diseases	0
ananas	disk degradations	0
endive	hormonal dysfunction	0
oreo	auriculo ventricular dissociation	0
processed food	tactile hypesthesias	0
beef	muscle disease	0
mastic tree	action tremors	0
sea bilberry	deaf-mutism	0
apium graveolens var. dulce	deglutitional syncopes	0
steamer	fatigue	0
sour orange trees	intracranial neoplasms	0
rabbit meat	microcephaly	0
milk proteins	lymphadenopathy-associated viruses	0
tempeh	bone fracture	0
marshmallow	gout	0
empty calorie foods	gluten-sensitive enteropathies	0
muffin	rabies	0
split peas	salmonellosis	0
coffee	somatotropin (acromegaly) hypersecretion syndromes	0
soybean proteins	colorectal neoplasm	0
belladonna	primary malignant brain tumors	0
anise seed	penis neoplasms	0
fruit-shaped marshmallows	benign meningiomas	0
rosa	salmonella infections	0
monkfish	neurodegenerative disorders	0
opium poppy	ekbom dermatozoic delusions	0
raw foods	bacterial infection	0
noncaloric sweetener	lymphosarcoma	0
kaffir lime	leiomyoma	0
hamburger	acute coryza	0
usda poultry	hemolytic uremic syndrome	0
warm milk	high blood pressure	0
solanum	halitose	0
cacao	cardiovascular strokes	0
french fries	galactose 1 phosphate uridyl transferase deficiency disease	0
antioxidant fruits	brain diseases	0
junk foods	retained surgical item	0
dried yeast	epimerase deficiency galactosemia	0
calling eggs	parkinsonism-dementia complex of guam amyotrophic lateral sclerosis	0
portulaca oleracea	lymphatic sarcomas	0
star anise	abdominal obesity	0
star anises	cancer of the lung	0
vaccinium corymbosum	cryptogenic epilepsy	0
isoglucose	auricular fibrillation	0
alcohol	scurvy	0
horse bean	tick bites	0
crocus sativus	prevent and reverse heart disease	0
fabaceae	ankylosing spondylarthritides	0
petroselinum crispums	familial tremor	0
rosemary	neonatal tremor	0
sugar maple	familial atrial fibrillations	0
sesame oils	muscle disease	0
plant embryo	bladder neoplasms	0
vegetable protein	fibrous meningioma	0
larder	uterine fibroid	0
lard	diffuse lymphomas	0
wort	deep venous thrombosis	0
anti-inflammatory plant	sensory seizure	0
carrot	breast fibrocystic changes	0
including cloves	unhealthy conditions	0
dried fruits	coad	0
hordeum	kidney insufficiencies	0
cocoa plant	age-related memory disorder	0
silybum marianum	food hypersensitivity	0
mock meats	low backaches	0
junk food	lumbago	0
white wine	peripheral arterial disease	0
added sweeteners	abdominal pains	0
oyster mushroom	acquired deafness	0
brown sugar	hhv-4	0
bitter nightshade	muscle soreness	0
granny smith apples	age-related memory disorder	0
raw cranberries	galactosemia	0
citrus sinensis	amyloid deposits	0
soy bean curd	ankylosing spondyloarthritides	0
food additive	breast disease	0
lavender	esophageal hernia	0
pineapple juice	gluten enteropathy	0
bergamot	spinal cord disorder	0
piper methysticum	menstrual disorders	0
hypericum perforatum	penile neoplasm	0
papaver somniferum	anthrax	0
deli meats	temporal region trauma	0
halibut	spinal cord diseases	0
pomelo tree	manic-depressive psychosis	0
blueberry plants	biliary calculi	0
sea vegetables	thrombus	0
purple cabbage	small lymphocytic lymphoma	0
brassica nigra	brain cancers	0
dietary fibers	small noncleaved-cell lymphomas	0
filtered coffee	water-borne hepatitides	0
punica granatum	bovine spongiform encephalitis	0
bitter orange tree	urticarias	0
ribe	grave’s disease	0
thymus plants	cancer of the skin	0
no coffee	constrictive bronchiolitides	0
cocoa plants	bacteria-eating viruses	0
flounder	weight loss	0
sesame seeds	memory deficits	0
popcorn	pregnancy induced diabetes	0
probiotic	auto-immune diseases	0
healthy fruit	malignant epithelial neoplasm	0
frozen spinach	coarse tremors	0
cereal	back ache	0
horsenettle	olfaction disorders	0
paella	zoonotic infectious diseases	0
cocoa butter	vaginal discharge	0
dinner time	confusion	0
fennel seeds	common bile duct gallstones	0
maize	uterine cancer	0
kohlrabi	airsickness	0
eugenia malaccensis	visceral steatoses	0
salad	nafld	0
pithecolobium	epithelial cancer	0
sugar water	intervertebral disk degenerations	0
sweet potatoes	lung cancers	0
whole grain cereal	cancer of ovary	0
olive oil	lewy body parkinson's disease	0
tepary bean	catarrh	0
mustard plant	rheumatoid arthritis	0
plaice	galactosemia 2	0
raisin	visceral obesities	0
marihuana	brief reactive psychoses	0
phaseolus	carcinomatosis	0
peach tree	chronic b-cell leukemia	0
carya illinoensis	galactosemia iii	0
legume family	hepatic neoplasms	0
chicken meat	autistic disorder	0
justicia	plasmodium infection	0
amomum cardamomums	galactose 1 phosphate uridyl transferase deficiency disease	0
higher vegetable	salmonellosis	0
bitter orange trees	spinal cord disorder	0
thousand foods	colon cancer	0
foenumgraecum	hansen's disease	0
cortland	retained surgical instrument	0
ready-to-eat meal	cervical neoplasm	0
fermented foods	common cancers	0
english plantain	numbness	0
dress	arterial dysfunction	0
restrict food	early onset parkinson disease autosomal recessive	0
frying meat	sore throats	0
chard	cancer of the kidney	0
nettle tea	uterine leiomyoma	0
dried pomegranate	papillomaviridae	0
green peppers	global amnesia	0
dried apple	dysosmia	0
liquorice	disorder	0
fresh ginger	vestibular seizures	0
yogurt	schizophreniform disorders	0
cow's milk	nausea	0
chamomile	cluster headache	0
ocimum sanctum	psychogenic parasitoses	0
morning meal	deformity	0
flavourer	plasma-cell myeloma	0
salmonella food	kanner's syndrome	0
avoid peanuts	aphthous ulcers	0
portulaca	complete blindness	0
diospyros digyna	perioral tremor	0
ready-prepared food	abdominal pains	0
sweetener	relapse	0
chocolate pudding	transient blindness	0
sushi	galactosemia iiis	0
alcoholic beverage	pill rolling tremors	0
sorrel	cancer of uterus	0
prosopi	degenerative diseases	0
different fruits	uterus cancer	0
vaccinium uliginosum	prostatic intraepithelial neoplasm	0
cream cheese	necrotizing fascitides	0
sprout	pattern baldness	0
food coloring	syncopal vertigos	0
illicium anisatums	lung diseases	0
suggesting fruit	focal seizures	0
fryer	cancer of the liver	0
colocasia	fibroatheroma	0
calendula officinali	infection	0
cacao bean	chronic airflow obstructions	0
kiwi fruits	transmissible spongiform encephalopathies	0
anchovy	sleep initiation dysfunction	0
crataegus	diverticulosis	0
piper methysticums	intracranial central nervous system disorders	0
store licorice	oral cancers	0
fig	vulvar neoplasm	0
curry powder	gastric cancer	0
lunch time	atherosclerotic plaque	0
infant formula	throat cancer	0
high fructose maize syrup	sliding esophageal hernia	0
pimenta officinali	vertex headache	0
woodland strawberries	condylomata acuminata	0
alfalfa	clonic seizure	0
english plantains	huntington’s disease	0
brazil nuts	neoplasm metastases	0
soda pops	tubal abortions	0
crataegus monogyna	myeloid leukemia	0
croaker	tonsil neoplasms	0
conventional food	bovine lymphomas	0
thymus	focal seizure	0
sticker	diabetic polyneuropathies	0
pimenta officinalis	asymmetric diabetic proximal motor neuropathy	0
filbert	degenerative intervertebral disk	0
andira	perforated appendicitis	0
mint tea	cancer of the penis	0
granny smith	postural syncope	0
acid-binding vegetables	tumor viruses	0
cooked meats	sleep initiation dysfunctions	0
emblica officinali	symptom cluster	0
raw tomatoes	circulatory failure	0
myristica fragran	ciliary neuralgias	0
nutriceutical	prediabete	0
nutmeg	philadelphia-negative myeloid leukemia	0
mackerel	mixed lymphocytic-histiocytic lymphomas	0
veggie	wound botulism	0
recommend tea	infectious diseases	0
own vitamin	generalized seizure	0
dandelion	breast fibrocystic disease	0
golden delicious	alopecia	0
tachigalia	ekbom delusional parasitoses	0
healthy snack	recurrence	0
vitamin pills	lymphocytic leukemia	0
grecian foxglove	uterine fibroma	0
processed meat	colorectal carcinoma	1
crunch berries	liver dysfunctions	0
spore	malignant lymphoma	0
safflower	wart viruses	0
garcinia mangostanas	iritide	0
seafood	hemorrhoid	0
dietary supplementations	virus	0
fava bean	fatty liver	0
cinnamomum verum	parkinsonian disorders	0
golden glow	aphthous stomatitis	0
treat	gorlin-goltz syndrome	0
uncooked food	strains and sprains	0
persea americanas	neoplasm	0
soy bean	non hodgkin's lymphoma	0
so-called meat	kidney neoplasm	0
flower	endometrioma	0
red delicious	physical anhedonia	0
citrus medicas	reduced sensations	0
sweetened cereal	human t-cell leukemia virus type iii	0
radish	diarrhea	0
guacamole	degenerative intervertebral discs	0
fresh fruits	strains and sprains	0
use sweeteners	deformity	0
raw alfalfa	nausea	0
natto	bechterew disease	0
good soybeans	guillain barre syndrome	0
squash plant	bovine lymphoma	0
baby formulas	unilateral headache	0
kawa kawas	carcinomatose	0
pork	colorectal carcinoma	1
atropa belladonna	human herpesvirus 4 (gamma)	0
aloe	uterine neoplasm	0
chipotle	generalized headache	0
edible grain	chromosome 6-linked autosomal recessive parkinsonism	0
incorporate cloves	renal failure	0
fried foods	esophageal neoplasms	0
hazelnut	osteoporosis	0
potato	occipital region traumas	0
punicaceae	tying disease	0
eating meat	brain conditions	0
vegetable juice	endometriosis	0
maize oils	motor seizures	0
healthiest snack	amentia	0
ginger ale	cancer of liver	0
added nuts	bladder diseases	0
broad beans	thermal hypesthesia	0
rose	flatus	0
blueberry	familial tremor	0
cocos nucifera	infarction	0
anise tea	non alcoholic fatty liver disease	0
betel	malaria	0
plantago	forehead traumas	0
sour orange tree	fibrosis	0
apple trees	chronic fatigue disorder	0
plum trees	myocardial ischemias	0
hibiscus cannabinus	senile plaques	0
antioxidant-rich food	reduced sensations	0
bibhitaki fruit	venereal wart	0
prunus salicina	tubal abortions	0
atropa belladonnas	neurological condition	0
poppy seeds	sleep initiation dysfunctions	0
peach trees	virus infections	0
durum wheat	cervical neoplasms	0
common olive trees	aortic aneurysm	0
unfertilized eggs	weight gains	0
cuminum cyminums	plasma-cell myeloma	0
shan yaos	constipation	0
bean	virus disease	0
mangifera indicas	retained surgical sponges	0
cucumis melo	kahler disease	0
trace mineral	fibrosis	0
jerusalem artichokes	human flu	0
high-fructose corn	strain	0
indian laburnum	malignant melanoma	0
health nuts	darkness tremor	0
snack food	experimental lung inflammations	0
bread	inflammatory disease	0
gluten	acquired deafness	0
century plants	colonic inertia	0
baking chocolate	dissociative amnesias	0
sunchoke	age related memory disorders	0
golden raisins	throbbing headaches	0
cucumber	confusional states	0
texturized soy proteins	cerebrovascular stroke	1
bread mold	spatial memory disorder	0
new york coalition for healthy school food	diabetic asymmetric polyneuropathy	0
emphasizes vegetables	testis cancer	0
lunchtime	common cancer	0
psidium guajavas	gorlin-goltz syndrome	0
thymus vulgari	low back pains	0
acai berry	lymphatic sarcomas	0
marjoram plant	hepatic neoplasm	0
dietary plant protein	cardiovascular disease	0
tuna fish	cancer of thyroid	0
common olive tree	oral disease	0
coca	muscle sorenesses	0
lentinus edodes	als (amyotrophic lateral sclerosis)	0
pizza	multiple myeloma	0
fatty foods	diverticula	0
illicium verum	variant creutzfeldt jakob disease	0
kenaf	chronic b-cell leukemia	0
rye bread	breast cancers	0
calendula officinalis	rectal tumor	0
shiitake	migraine	0
soy protein	soft tissue sarcoma	0
berry	marsh fever	0
yoghurt	unilateral headache	0
plant-based nutrients	peripheral autoimmune demyelinating disease	0
soy sauce	colorectal carcinomas	1
crave chocolate	cancer of thyroid	0
organic plants	degenerative neurologic disorders	0
beetroot	neurotic anxiety states	0
whole foods	penis neoplasm	0
alfalfa sprout	exanthema	0
vodka	bowel disease	0
narrow-leaved plantains	death	0
kava kavas	chronic fatigue-fibromyalgia syndromes	0
artichoke	acute autoimmune neuropathies	0
healthiest beverages	retro-ocular headaches	0
raphanus raphanistrum	crushing skull injuries	0
cereal grain	cancer of the vagina	0
jasmine tea	uterine neoplasm	0
preserved foods	diabetic asymmetric polyneuropathy	0
solanum laciniatum	cerebral convexity meningiomas	0
broccoli	cervix neoplasms	0
yam	situational syncopes	0
green peas	male subfertility	0
cappari	salmonellosis	0
pinto beans	fibromyalgia fibromyositis syndrome	0
aspalathus linearis	endometrial neoplasm	0
dog rose	amnesia-memory losses	0
nicotiana tabacums	cancer of the uterus	0
maize oil	penile neoplasms	0
national pork	ovarian cancers	0
artificial sweeteners	thyroid cancer	0
chinese food	ekbom psychogenic parasitoses	0
red onions	weight gains	0
contaminated meat	female sub fertility	0
fagopyrum sagittatum	non b hepatitis epidemic non a	0
cod	diabetes complications	0
cocos nuciferas	lyme arthritis	0
processing meat	tactile hypesthesias	0
da huang	senile paranoid dementias	0
energy drink	elevated cholesterol	0
flowering shrub	spinal meningioma	0
drink	sudden cardiac arrest	0
dinner times	autosomal dominant. juvenile parkinson disease	0
yeast rice	disorders of initiating and maintaining sleep	0
food poisonings	pseudocoma	0
tuna	foodborne diseases	0
butter milk	myeloma multiple	0
lemon balms	cancer of endometrium	0
tarragon	adenomatous polyp	0
leguminosae	renal calculi	0
dried plums	barrett's syndrome	0
malus	cancer of endometrium	0
soybean	lung neoplasm	0
anacardium	liver failure	0
fat milk	impaired sensations	0
wild celery	atheroma	0
triticum	regional enteritis	0
diospyro	epileptic seizures	0
curcuma zedoaria	macular degenerations	0
red meats	cervical migraine syndrome	0
hawthorn	cancer of lung	0
poultry products	sudden cardiac arrest	0
majorana hortensis	cancer-causing viruses	0
pickled vegetables	gastric acid reflux	0
curry	regional ileitides	0
purine-rich plant	myelomatose	0
animal food	mild cognitive impairments	0
regular carrots	visceral obesities	0
jalapeno	inflammatory polyneuropathy acutes	0
amla	dysosmia	0
plant embryos	postviral fatigue syndrome	0
potable water	cellulite	0
pasta	uterus neoplasms	0
wolfberry	uterine cancers	0
tea	gallbladder disease	0
nut butters	study cancer	0
vitis	atherosclerose	0
lavandula	diabetic complications	0
bertholletia excelsa	graves disease	0
mandarin orange tree	chronic fatigue syndromes	0
marjoram plants	non-epileptic convulsions	0
delonix	liver injury	0
bean sprouts	crushing skull injuries	0
dietary supplement	small round structured viruses	0
carica	cephalgia syndromes	0
kombucha tea	common bile duct gall stones	0
collard green	malignant epithelial neoplasm	0
club soda	psychotic disorders	0
elettaria cardamomums	lymphoblastic leukemia	0
nitrate-rich vegetables	back pain	0
oatmeal	small-cell lymphomas	0
berberi	unilateral headaches	0
mentha x piperita	bronchial asthma	0
iceberg lettuce	marie-struempell disease	0
pistachio nut trees	classic galactosemias	0
herbal teas	hypoascorbemia	0
curcuma zedoarias	undifferentiated carcinomas	0
anacardium occidentales	myalgic encephalomyelitis	0
chia seeds	intestinal disease	0
andean blackberries	ekbom psychogenic parasitoses	0
caramel	sudden infant death syndrome	0
currant	multiple meningioma	0
mangosteen	substance-related disorders	0
licorice	colonic cancers	0
baby spinach	urinary tract infection	0
brain-invasive pork	udpglucose 4-epimerase deficiency disease	0
okra	blv	0
solanum lycopersicum	carcinogenese	0
dried apples	carcinoma	0
sandwich	osteoarthrosis	0
sea vegetable	congenital myxedema	0
brewing tea	ph1-negative myeloid leukemia	0
black sapote	manic disorder	0
chinese cinnamon	long sleeper syndromes	0
phytonutrient-rich food	tactile hypesthesias	0
eugenia caryophyllata	esophageal reflux	0
chai tea	adenomatous polyp	0
opium poppies	tumorigenese	0
solanum melongenas	nonorganic insomnia	0
cymbopogon	zoonotic diseases	0
stryphnodendron	hepatitis	0
fruit and vegetable juices	atheroma	0
taro	renal insufficiencies	0
glucose fructose syrup	gluten enteropathies	0
jelly beans	prostatic adenomas	0
bamboo shoots	hhv-4	0
healthiest foods	bipolar depression	0
food supplements	senile tremor	0
nori	intermediate grade lymphoma	0
eragrostis	nonhodgkin lymphoma	0
romaine lettuce	strain	0
soy	rectal cancers	1
hickory tree	endocrine breast disease	0
chinese yam	age-related maculopathies	0
proteus mirabilis	disc degenerations	0
pine nuts	intractable headaches	0
bagel	relapse	0
barberry	johnes disease	0
acai berries	iritide	0
vaccinium myrtillus	philadelphia-negative myeloid leukemias	0
citrullus	infant obesity	0
citron tree	rabies viruses	0
lamb chops	liver failure	0
antioxidant-rich foods	brain neoplasm	0
plant capsules	craniocerebral injury	0
psidium	brief reactive psychosis	0
nicotiana	chronic airflow obstructions	0
dietary proteins	congenital defects	0
green pepper	small cleaved-cell lymphoma	0
cassia tree	pulmonary cancer	0
bacon	oncogenesis	0
poultry meat	necrotizing fasciitides	0
porgy	tonsillar cancers	0
nutraceutical	disc degradations	0
healthy food	delusional parasitosis	0
kombucha teas	central nervous system degenerative diseases	0
milkshake	jakob creutzfeldt syndrome	0
rice	burkitts lymphoma virus	0
dietary soybean proteins	pyrosis	0
cured meat	galactose-1-phosphate uridylyltransferase deficiency	0
bran flakes	orthostatic headache	0
meal time	brain disease	0
taking vitamin	breast malignant neoplasm	0
olive family	bacteriophage	0
carbonated beverage	craniocerebral injuries	0
healthiest apple	pancreas cancers	0
watercress	abdominal migraines	0
barley coffee	somatotropin (acromegaly) hypersecretion syndrome	0
machaerium	penile cancers	0
sweet pepper	intermittent tremor	0
cocoa powder	long sleeper syndrome	0
pomegranate seeds	pulmonary inflammation	0
fragaria	inflammatory polyneuropathy acute	0
sell meat	gastric ulcers	0
cherry	delusory parasitosis	0
areca catechu	autosomal recessive juvenile parkinson disease 2	0
scrambled eggs	diabetic polyneuropathy	0
teff	macular dystrophies	0
persea americana	infant gynecomastia	0
digitalis	jakob creutzfeldt disease	0
jelly	heart diseases	0
black raspberries	meningotheliomatous meningiomas	0
caryophyllus	epithelial cancer	0
cupcake	physical suffering	0
contamination meat	senile plaques	0
guibourtia	cognitive decline	0
amygdalus communis	transient insomnia	0
fatty meal	wart viruses	0
drug administration united states food	diabetic retinopathy	0
squid	parkinsonism dementia complex of guam amyotrophic lateral sclerosis	0
density foods	memory disorders	0
steak	primary insomnia	0
applesauce	chronic fatigue syndromes	0
adding blueberries	pill rolling tremor	0
pimenta	hernia	0
snacktime	recurrent low back pain	0
tap water	atrioventricular dissociations	0
soy beverages	menstrual disorders	0
silken tofu	terminal cancer	0
cooked carrots	hiatal hernia	0
leaf lettuce	pruritis	0
national meat	uterine fibromas	0
plantago arenaria	eczematous dermatitides	0
baked potato	hypoxemia	0
durum wheats	childhood obesity	0
fungus	gallbladder disease	0
dairy yogurt	amyloidosis	0
ready-prepared foods	focal seizures	0
dietary fiber	intervertebral disk degenerations	0
holy basil	chronic fatigue-fibromyalgia syndrome	0
placenta	pseudocoma	0
sockeye salmon	fifth phacomatosis	0
citrus fruits	post-ictal confusion	0
dietary sucrose	intractable headache	0
macadamia nuts	complete blindness	0
tomato sauce	autosomal dominant juvenile parkinsonism	0
sugar	high-grade lymphoma	0
kawa	parkinsonian diseases	0
areca	malignant tumor of breast	0
peppermint	acidose	0
rosehip	water borne hepatitis	0
trace element	hair losses	0
red pepper	tremor	0
dark chocolate	insomnia disorders	0
solanum melongena	hot flashes	0
tea leaves	paratuberculosis	0
high-phytate foods	crohn's disease	0
linum usitatissimums	diabetic retinopathies	0
nut	polyradiculoneuropathy	0
cocoanut	tactile hypesthesias	0
citrus aurantiums	acquired blindness	0
dairy products	urinary bladder cancer	0
pleurotus ostreatus	prion protein diseases	0
ceylon cinnamon	salmonella infection	0
dietary plant proteins	spindle-cell carcinomas	0
mustard greens	cephalgia syndrome	0
sweet basil	stokes-adams syncopes	0
lucerne	benign brain neoplasms	0
gmo soybeans	anal fissure	0
pistacia lentiscus	palsy	0
trompillo	artery disease	0
norus	male breast tumors	0
red delicious apples	semantic memory disorders	0
buckwheat	premenstrual tensions	0
cultivated radish	colorectal tumor	0
cannabis indica	limb cramp	0
raw meat	burkitts lymphoma virus	0
corn sugar	weight gains	0
target vitamin	abdominal cramp	0
beta vulgaris	udp-galactose-4-epimerase deficiency	0
olive trees	disorder	0
goiaba	psammomatous meningiomas	0
berberis	celiac sprue	0
euterpe edulis	bovine leukemias	0
seven nutrients	iron deficiency	0
sea-food	acne vulgaris	0
noni fruit	hepatic cancer	0
carbonated beverages	hair losses	0
amaranth	spindle cell carcinoma	0
chervil	metabolic acidosis	0
orange trees	cancer of the tonsil	0
elettaria	kanner syndrome	0
caffeinated coffee	hyperemesis gravidarum	0
sun-dried raisin	ovarian neoplasms	0
nut bar	anxiety disorders	0
dressing	obesity in childhood	0
canned fruit	hypercholesteremia	0
chocolate	pancreas neoplasms	0
raphanus sativus	thyroid diseases	0
anacardium occidentale	plasma-cell myeloma	0
pisum sativum	stomach ulcers	0
raw poultry	deep-vein thrombosis	0
extracted fruit	breast cystic disease	0
espresso	lightheadedness	0
celeriac	hepatic cancer	0
amomum cardamomum	ulcerative colitis type inflammatory bowel disease	0
banana plant	headache disorders	0
mastic trees	papillary meningiomas	0
vaccinium macrocarpon	influenza in humans	1
pistacia	cardiac arrhythmia	0
chenopodium quinoas	schizophreniform disorders	0
oryza sativa	cancer of the ovary	0
deli meat	breast cancer	0
french bean plants	oncornavirus	0
tumeric	carcinomatosis	0
chinese cassia	cancer of the thyroid	0
pleurotus	diarrhea	0
buttermilk	psychogenic parasitosis	0
reason food	carcinomatose	0
oryza	palmoplantaris pustulosis	0
flesh foods	prostatic neoplasms	0
black beans	hypercholesteremia	0
vegetable juices	menstrual disorders	0
frying foods	environmental cancer	0
hop	familial juvenile parkinsonism	0
true nut	endometriose	0
purple rice	pulmonary embolisms	0
healthier meat	renal failures	0
aloe vera	gastro oesophageal reflux	0
basil	bladder tumors	0
gui zhi	colonic neoplasm	0
moose meat	cattle leukemia virus	0
concord grapes	schilling-type myeloid leukemia	0
rutabaga	bipolar disorder	0
assai palms	influenza	0
zea	fibrositide	0
sweetleaf	polyradiculoneuritis	0
food manufacturers	hypermelanosis	0
rubus glaucus	severe mental disorder	0
swordfish	thrombosis	0
trigonella foenum-graecum	abdominal aortic aneurysm	0
vaccinium bracteatums	ekbom psychogenic parasitoses	0
bolete	cancer of the skin	0
syzygium cumini	bipolar disorder	0
milk protein	intraepithelial prostatic neoplasia	0
cantaloupe	dental diseases	0
dried cranberries	male pattern baldness	0
cocoa	myalgia	0
no meat	bovine lymphomas	0
capsicum	circulatory collapse	0
green lentils	schizoaffective disorder	0
dessert	sleep initiation and maintenance disorders	0
stuff	galactose-1-phosphate uridylyltransferase deficiencies	0
avocado	cranial pain	0
ranking foods	diabetic retinopathy	0
drinking tea	anal fissure	0
healthier foods	galactosemia iii	0
aspalathus	sudden cardiac death	0
gluten-free diet	colorectal carcinomas	0
citrus maxima	olfaction disorder	0
zingiber officinale	visual seizures	0
high-fat meal	autosomal dominant juvenile parkinsonism	0
mangifera	death	0
vinegar	nutritional disease	0
pomegranate fruit	bronchiolitis obliterans	0
acer	htlv-iii	0
rheum tanguticum	car sickness	0
crab apples	deep venous thrombosis	0
refined olive	breast carcinomas	0
sweet almonds	acute autoimmune neuropathy	0
poroporo	proteinuria	0
secale	post-ictal confusion	0
breakfast times	broken bones	0
flavoring	vaginal cancer	0
jalapeno pepper	acute monoblastic leukemias	0
decrease meat	cerebrovascular stroke	0
food colors	skin diseases	0
peanut butter	posterior fossa meningiomas	0
coconut	sneeze	0
convenience food	paraesophageal hiatal hernias	0
herb	cancer of lung	0
arecas	pituitary dwarfism iis	0
chewing gums	ovary neoplasms	0
pimpinella	male sub-fertility	0
snail meat	deglutitional syncope	0
cranberry sauce	impotence	0
rhubarb	testicular cancers	0
phaseolus vulgaris	ketosis-prone diabetes mellitus	0
morinda citrifolia	parietal region traumas	0
soy food	liver injury	0
common foxglove	relapse	0
processed apples	chronic pain	0
cinnamomum aromaticum	periadenitis mucosa necrotica recurrens	0
glycine max	carcinoma of endometrium	0
thymus vulgaris	male sexual impotence	0
high-fructose maize syrup	back aches	0
hashish	human t-lymphotropic virus type iii	0
saint john's wort	cerebrovascular accidents	0
veal	recurrent brain tumor	0
tangerine tree	hiatal hernia	0
sugary foods	uterine cancers	0
cannabis sativas	sciatica	0
yerba mates	neurocysticercose	0
dark meat	philadelphia-negative myeloid leukemias	0
tangerine trees	hansens disease	0
chewing fruit	premature aging	0
morning meals	lens opacity	0
butternut squash	schizoaffective disorders	0
black tea	galactosemia iii	0
weed	jakob-creutzfeldt disease	0
bhang	inflammatory polyneuropathy acute	0
soy cheeses	manic disorders	0
acacia tree	epstein-barr virus	0
cynara scolymus	brain benign neoplasms	0
baptisia	pernicious vomiting of pregnancy	0
cayenne	sprain	0
oat	prion-associated disorders	0
thymus plant	symmetric diabetic proximal motor neuropathy	0
hemp plants	ebv	0
white potatoes	cancer of lung	0
tofu	visceral obesity	0
goji berry	neoplasia	0
ground ginger	macular dystrophy	0
rubus idaeus	rash	0
apple juice	arthritis	1
anana	pulmonary inflammation	0
blueberry plant	diverticulitis	0
decaffeinated tea	nonspecific vaginitis	0
theobroma cacao	epimerase deficiency galactosemia	0
pease	weight reductions	0
cycad trees	diffuse mixed small and large cell lymphoma	0
food supplement	posterior compartment low back pain	0
snack foods	peripheral arterial disease	0
oats	fibrocystic disease of breast	0
blackberry	auto-immune diseases	0
poppy	cancer of esophagus	0
organic milk	cll lymphoplasmacytoid lymphomas	0
include fennel	auriculo ventricular dissociation	0
mango	convulsion	0
blossom	back pain with radiation	0
trigonella	spondylitis ankylopoietica	0
anise	blv	0
prunus armeniaca	pleomorphic lymphoma	0
psidium guajava	deglutitional syncope	0
clove	acute stroke	0
healthiest nuts	substance-related disorders	0
mirobalanus embilica	colorectal neoplasm	0
plant zygote	convulsion	0
dietary protein	migraine variants	0
seltzer waters	acute cerebrovascular accident	0
sugar maples	amnesia	0
wheat	develop cancer	0
açaí berries	acidosis	0
artificial sweetener	hysterical amnesias	0
soda waters	cancer of the lung	0
malabar nut	hemangioblastic meningioma	0
prunus cerasifera	postpartum sterility	0
colophospermum	pregnancy pernicious vomiting	0
brassica napus	cancer of the mouth	0
whole grain	atypical diffuse small lymphoid lymphoma	0
nuclear power plants	cancer of testis	0
red wine	spindle cell sarcomas	0
green beans	menstrual pains	0
syzygium aromaticum	chronic headaches	0
ice creams	idiopathic proctocolitis	0
mentha spicata	age related macular degeneration	0
chenopodium quinoa	deep-venous thrombosis	0
citronella	sick headache	0
baby formula	thrombus	0
cashew	nonspecific vaginitis	0
kiwi	coarse tremors	0
fagopyrum esculentum	pulmonary disorder	0
wild bananas	symptom cluster	0
processed meats	guillaine barre syndrome	0
retail poultry	gluten enteropathies	0
lipomul	broken bones	0
eating almonds	zoonotic infectious disease	0
brinjal	postoperative emesis	0
cider	age-related osteoporoses	0
soda water	chronic b lymphocytic leukemia	0
papaver	substance induced organic mental disorders	0
emphasize plant	intervertebral disc degenerations	0
incorporates cloves	vulva cancer	0
curcuma longa	human papilloma viruses	0
foeniculum vulgare	huntingtons disease	0
sour cream	soft tissue sarcoma	0
roselle	chronic insomnia	0
wheat bran	felv	0
vaccinium virgatum	semantic memory disorder	0
goji berries	intermittent tremors	0
marijuana	nonhodgkins lymphoma	0
grapefruit	experimental parkinson diseases	0
white pepper	mixed lymphoma	0
mayo	amyloid plaque	0
cinnamomum zeylanicum	limb cramps	0
handling meat	severe congenital microcephaly	0
trigonella foenum-graecums	vagina neoplasms	0
laciniate nightshade	age-related bone losses	0
cucumis melos	tongue neoplasm	0
carduus marianus	atrophy	0
coconut oil	water-borne hepatitides	0
pureed apples	muscle tremors	0
indian gooseberry	posterior compartment low back pain	0
commercial milk	brain conditions	0
consumer protection scientific committee on food	autistic disorders	0
watermelon	hysterical blindness	0
nonfat meal	vulva neoplasm	0
persea	coarse tremors	0
parsley	bacterial infections	0
salami	cognitive retention disorder	0
lemon grass	intraorbital meningioma	0
peach	irritable bowel syndromes	0
high fructose corn syrup	atypical cluster headache	0
green teas	peanut hypersensitivity	0
mangifera indica	familial atrial fibrillations	0
whole grains	hemicrania	0
spice saffron	anosmia	0
citrus grandi	cardiac failure	0
acaí berries	macular dystrophies	0
kavas	micturition syncope	0
acer negundo	complete hearing loss	0
wild radish	tactile hypesthesias	0
avena sativa	peanut hypersensitivity	0
plantago seed	galactose-1-phosphate uridylyltransferase deficiencies	0
kidney beans	malignant meningioma	0
intoxicant	eczema	0
dragon fruit	transmissible spongiform encephalopathies	0
wild yam	bone cancer	0
black walnuts	undifferentiated carcinomas	0
smoked foods	rachitide	0
spinacia oleracea	intervertebral disk degeneration	0
corn syrup	hypercholesterolemia	0
green onions	cysticercosis	0
clathrotropis	breast carcinoma	0
nettle	auditory seizures	0
lycium barbarum	peanut hypersensitivity	0
trace elements	fibroatheromatous plaque	0
licorice root	lyme borreliosis	0
breast milk	udp-galactose-4-epimerase deficiency diseases	0
prunus salicinas	udpglucose 4 epimerase deficiency disease	0
fragaria vesca	uterine cancer	0
linseed	lung inflammation	0
hot sauce	human t-lymphotropic virus type iii	0
cycad	virus	0
horse nettle	kidney insufficiency	0
fenugreek seeds	migraine variants	0
prettiest fruit	urinary bladder diseases	0
faba bean	atypical cluster headache	0
nutritional yeast	arterial fatty streaks	0
asparagus	female sub-fertility	0
alcoholic beverages	diabetes complication	0
glycyrrhiza glabra	contagious pustular dermatitides	0
sesame oil	acquired deafness	0
individual candy	sensory seizure	0
cayenne pepper	cancer of prostate	0
chanterelle	vaginal discharge	0
roasted almonds	substance use disorders	0
whipped cream	ulcerative colitis	0
virgin olive	influenza	0
lycopersicon esculentum	multiple head injury	0
sausage	sleep-related neurogenic tachypnea	0
diabetic diets	involutional osteoporosis	0
pomelo trees	sensory seizures	0
low-calorie diet	terminal ileitis	0
coleslaw	nonalcoholic steatohepatitis	0
mint	acidosis	0
adhatoda	high cholesterol levels	0
chinese cassias	gall stone	0
pudding	diffuse mixed cell lymphoma	0
carrot juice	cervical cancer	0
spicy food	brain disease	0
euterpe precatoria	anaplastic carcinomas	0
whale meat	hepatitis	0
zucchini	neurocysticercosis	0
study lavender	rebound insomnia	0
international nut	symptom clusters	0
althaea	joint pains	0
chinese cinnamons	multiple meningioma	0
pimiento	seizure disorder	0
hibiscus sabdariffa	hhv-4	0
unrefined plant	breast malignant tumors	0
healthy foods	creutzfeldt jacob disease	0
bt corn	fibrocystic breast disease	0
soy bean proteins	nonalcoholic fatty liver disease	0
mentha spicatas	zoonotic infection	0
pear	common cold	0
retail meat	multiple sclerosis	0
pinto bean	kidney stone	0
soup	udp galactose 4 epimerase deficiency disease	0
dairy product	orthostasis	0
malabar-nut	halitosis	0
food allergy	autoimmune disorders	0
callerya	bone neoplasm	0
shoot	acute monocytic leukemia	0
plant zygotes	orthostatic headache	0
eggnog	hypercholesterolemia	0
squash	human t-cell leukemia virus type iii	0
healthy snacks	cognitive retention disorder	0
antioxidant food	brain vascular accident	0
celebration meal	diabetic mononeuropathy simplices	0
flax	uterus cancer	0
citrus fruit	inflammatory bowel diseases	0
corn oil	bronchiolitis	0
supper	fibroid	0
cherry plum trees	oxygen deficiency	0
raw garlic	intertrochanteric fractures	0
prunus dulcis	clear cell meningiomas	0
carbonated mineral waters	endometrium carcinoma	0
dasheen	cancer of colon	0
cooking meat	allergic diseases	0
secale cereale	retinitis	0
lens culinari	tubal abortions	0
flax seed	epithelioid sarcoma	0
cuminum	galactose-1-phosphate uridylyltransferase deficiencies	0
poultry	atherosclerotic plaques	0
deep-fried foods	benign brain neoplasms	0
hickory trees	intractable headaches	0
bell peppers	gastro-esophageal reflux	0
indian gooseberries	regional enteritis	0
white mallow	pulmonary embolisms	0
camomile	cryptogenic epilepsies	0
carya illinoenses	dna injury	0