
red cabbage	retroviridae	0
exotic fruit	seizure	0
dessert	severe congenital microcephaly	0
plantago lanceolata	nonalcoholic steatohepatitides	0
citrus maxima	oncovirus	0
sparkling water	breast neoplasm	0
carbonated drinks	e-b virus	0
sea food	preventable cancers	0
rabbit meat	bacterial vaginoses	0
cardamon	insulin-dependent diabetes mellitus	0
snack	bronchiolitis	0
avena sativa	mastitis	0
fragaria	jacksonian seizure	0
hibiscus tea	forehead trauma	0
pummelo tree	male sub-fertility	0
texturized soy protein	tactile amnesia	0
syzygium sandwicense	steatosis of liver	0
mirobalanus embilicas	lou-gehrigs disease	0
soy beverages	hysterical amnesias	0
filtered coffee	retro-ocular headaches	0
black tea	hydrophobia	0
new candy	bladder neoplasm	0
amomum cardamomums	ulcerative colitis type inflammatory bowel disease	0
red delicious	female pattern baldness	0
jambolan plum trees	paralysis	0
laciniate nightshade	irritable bowel syndrome	0
origanum	penis cancers	0
eating nuts	rectal tumor	0
soy beans	penis cancers	0
nettle	neurotic anxiety states	0
refined olive	lichen rubra planus	0
narrow leaved plantain	bilateral sciatica	0
oolong tea	carcinomatose	0
sparkling waters	auriculo-ventricular dissociations	0
sweet marjoram	poisoning	0
baby spinach	rachitide	0
morning meals	brains cancer	0
mackerel	germinoblastic sarcomas	0
adhatoda vasica	bacterial vaginoses	0
regular carrots	low-grade lymphoma	0
carya illinoenses	plasma-cell myeloma	0
buckwheat	intestinal disease	0
official vitamin	tonsillar neoplasm	0
reason food	alopecia cicatrisata	0
açaí berries	testis cancer	0
zingiber officinale	cardiovascular disease	0
garbanzo	colonic cancers	0
green tea	periorbital headaches	0
low-fat diet	ekbom psychogenic parasitoses	0
pepsi	lymphadenopathy-associated viruses	0
citrus hystrices	painful menstruations	0
salami	continuous tremor	0
syzygium aromaticum	obesity in adolescence	0
horse bean	male sub fertility	0
organic milk	carcinoma	0
malus	superficial head injury	0
collard green	psoriasis	0
lentinus edodes	odontogenic keratocysts multiple basal cell nevi	0
skim milk	aphthous stomatitides	0
low-salt diet	prostatic neoplasms	0
belladonna	carotid sinus syncope	0
prunis communis	brain benign neoplasms	0
bok choy	bladder tumor	0
hordeum	brain cancers	0
corn	pregnancy-induced diabetes	0
soy protein	diffuse lymphocytic lymphoma	0
allium cepa	orf	0
fruit juices	liver steatosis	0
curcuma	pulmonary disease	0
sugar-sweetened beverages	barrett metaplasia	0
olive family	emphysema	0
pancake	milk sugar intolerance	0
oyster mushroom	emphysema	0
chinese cassia	infectious mononucleosis virus	0
triticum vulgare	western diseases	0
green onions	abdominal cramp	0
hickory tree	syncopal episode	0
tomato sauce	corpse	0
poppy	orf	0
breakfast cereal	ulcer	0
real chocolate	senile plaque	0
whole foods	cervix cancer	0
bell peppers	endothelial dysfunction	0
iv vitamin	intervertebral disc degeneration	0
lunch time	infant obesity	0
rooibo	muscle spasms	0
flavoring	fibrosis	0
catfish	meningiomatose	0
tepary bean	ciliary neuralgia	0
dietary protein	intracranial cns disorder	0
celery root	meningotheliomatous meningiomas	0
flax seeds	insulin deficiency	0
horse beans	male pattern baldness	0
carya illinoensis	memory deficit	0
healthiest foods	reduced sensation	0
fruit and vegetable juices	androgenic alopecia	0
replenish nutrients	copd	0
potable water	amyotrophic lateral sclerosis motor neuron disease	0
energy drink	hirsutism	0
radicchio	juvenile parkinson disease	0
actual licorice	back pain	0
lactuca sativa	juvenile parkinsonism	0
holy basil tea	liver disease	0
lemon balms	allergy	0
ground meat	diabetes mellitus complication	0
dark meat	familial creutzfeldt jakob disease	0
rise	marie-struempell disease	0
majorana hortensis	back aches	0
black pepper	nonhodgkin's lymphoma	0
lemon balm tea	muscle sorenesses	0
faba beans	infantile autism	0
glycyrrhiza glabra	acute inflammatory polyneuropathies	0
organic food	fibroatheromatous plaque	0
coriandrum sativums	male breast cancer	0
specific foods	alactasia	0
sweet pepper	cervix cancers	0
crocus	dyslipoproteinemia	0
persimmon	ocular headaches	0
morning meal	autoimmune condition	0
overpriced vitamin	chronic fatigue disorder	0
punica granatums	poisoning	0
grape seeds	study cancer	0
target vitamin	inner ear cancer	0
apple	convulsive seizure	0
chamomile tea	nonalcoholic steatohepatitides	0
hypericum	psychogenic parasitoses	0
red wine	rheumatoid spondylitis	0
dried fruit	bilateral sciatica	0
lens culinaris	uterus neoplasms	0
phaseolus vulgaris	mouth neoplasms	0
solanum melongenas	cranial pain	0
isoglucose	stomach ulcer	0
entree	postoperative emeses	0
prettiest fruit	cancer of the thyroid	0
philadelphia cream cheese	anaplastic carcinoma	0
restructured meat	fight cancer	0
lettuce	cerebrovascular accidents	0
carica papayas	cervix cancers	0
white wine	gout	0
cilantro	gorlin syndrome	0
prunus persica	diffuse well-differentiated lymphocytic lymphoma	0
food poisoning	feline leukemia virus	0
animal-based foods	diabetic mononeuropathy simplices	0
sweeten	chronic headache	0
green teas	hysterical amnesia	0
decaffeinated tea	amnestic state	0
dioscorea batatas	continuous tremor	0
glucose-fructose syrup	cryptogenic epilepsies	0
flowering shrub	degenerative diseases	0
consumer protection scientific committee on food	fibroatheromatous plaques	0
rheum tanguticum	diabetic autonomic neuropathies	0
oryza	sleep initiation and maintenance disorders	0
breakfast times	diffuse mixed-cell lymphoma	0
holy basil	salmonella infection	0
barley	olfactory groove meningiomas	0
pretzel	trochanteric fractures	0
teosinte	degenerative intervertebral disks	0
milk thistles	drug hypersensitivities	0
noncaloric sweetener	retained surgical tool	0
horse nettle	anemia	0
turnip	muscle spasm	0
agaricaceae	heartburn	0
quinoa	stroke	0
powdered sugar	persistent tremors	0
ginger	oncornavirus	0
ice cream	sclerosis	0
maize syrup	upper respiratory infections	0
baking chocolate	botulism	0
zedoary zedoaria	jaundice	0
broccoli	lung inflammation	0
eating fruits	metabolic acidosis	0
coconut milk	nonhodgkin lymphoma	0
euterpe oleracea	sclerosis	0
vitamin pills	cervical migraine syndromes	0
thousand foods	retinitis	0
illicium verums	galactosemia 3s	0
peach trees	hemicrania	0
tachigalia	acute strokes	1
acai berries	urinary tract infections	0
kawa kawas	intracranial meningiomas	0
plantago indica	esophagus neoplasm	0
citrus medicas	t virus	0
fructose corn	sleep initiation and maintenance disorders	0
romaine lettuce	gestational diabetes mellitus	0
table sugar	androgenetic alopecia	0
organ meats	intractable headaches	0
good soybeans	rodent ulcer	0
healthy fruit	landry-guillain-barre syndrome	0
lucerne	intracranial neoplasms	0
pistachio nut tree	acute cerebrovascular accident	0
sea-food	diabetic mononeuropathy simplex	0
corylus	atypical chronic myeloid leukemia	0
edible grains	stomatognathic diseases	0
dangerous plants	brain benign neoplasms	0
cuminum	chronic diseases	0
legume family	cjd (creutzfeldt jakob disease)	0
cherry plum tree	gastro esophageal reflux	0
crab apples	classic galactosemias	0
anti-inflammatory plant	halitose	0
own vitamin	acquired immunologic deficiency syndrome	0
acer negundo	muscular cramps	0
food supplement	diffuse well differentiated lymphocytic lymphoma	0
goji berry plants	ph1-negative myelogenous leukemia	0
poisonous plant	intraepithelial neoplasm	0
ready-prepared food	autoimmune diabetes	0
kava kavas	autoimmune condition	0
tepary beans	infection	0
lamb chops	radiating pains	0
thymus vulgari	dyschezia	0
shan yao	zoonosis	0
blossom	burning pain	0
diospyros digynas	cancer of the skin	0
kawa	substance addiction	0
narrow-leaved plantain	frontal region traumas	0
rose	neurodegenerative disorders	0
store licorice	colorectal carcinoma	0
piper methysticums	fine tremors	0
added nuts	splitting pains	0
horse nettles	sid	0
glycine max	breast fibrocystic change	0
herb	penile neoplasms	0
garlic	polyarthritis	0
plum trees	semantic memory disorder	0
seed	vestibular seizures	0
beet	substance addiction	0
snacktime	orthostatic headache	0
wild bananas	apoplexy	0
citrus fruits	respiratory tract infection	0
canned food	dysosmia	0
warm milk	tonsillar neoplasm	0
lime	western diseases	0
raw cranberries	malignant epithelial tumors	0
pumpkin	anticancer	0
hamburger	myocardial ischemia	0
prunus salicina	nonhodgkin lymphoma	0
chewing gum	liver injury	0
soda water	inflammation	0
anise tea	central obesity	0
mussel	guam form of amyotrophic lateral sclerosis	0
cannabis sativas	retained surgical item	0
triticum	symptom cluster	0
vital nutrients	cervical neoplasm	0
capparis	anticancer	0
bitter nightshades	fibromyalgia fibromyositis syndrome	0
california avocado	toxic megacolon	0
raw broccoli	spiral fracture	0
allium sativum	back ache	0
irritable bowel kiwi fruit	a v dissociation	0
yoghurt	clear cell meningiomas	0
multivitamin	jaundice	0
clove	tactile amnesia	0
parsley	basal cell nevus syndrome	0
stuff	penile neoplasms	0
banana	diffuse small cleaved cell lymphoma	0
plant embryo	preterm birth	0
triticum durum	hepatocellular cancers	0
macadamia	fine tremors	0
chipotle	guillain barre syndrome	0
pumpkin pie	human papilloma viruses	0
pithecolobium	ph1-negative myeloid leukemias	0
carica	food-borne diseases	0
drinking orange	megacolon	0
prunus dulcis	feline lymphoma virus	0
high-fructose corn	insulin dependent diabetes mellitus 1	0
acer saccharum	manic disorder	0
indian laburnums	chest pain	0
fermented cabbage	throat cancer	0
confection	phlebothrombosis	0
kombucha tea	genital warts	0
white rice	hyperventilation syncopes	0
include flaxseed	airsickness	0
star anise	human t cell leukemia virus type iii	0
prunus amygdalus	variant creutzfeldt jakob disease	0
experience food	early onset parkinsonism	0
cinnamomum zeylanicum	brief reactive psychoses	0
pithecellobium	muscle disease	0
olive oils	galactose-1-phosphate uridyl-transferase deficiency disease	0
pomegranate fruit	disrupted in b-cell malignancy	0
phaseolus acutifolius	common cancers	0
cocos nuciferas	spinal cord disorder	0
watermelon	throat cancer	0
no noni	crushing pain	0
uncooked food	exudative bronchiolitis	0
dried apricots	visceral steatoses	0
brassica nigra	breast malignant neoplasms	0
flax	occipital traumas	0
cocktail	anemia	0
artificially-flavored corn	tonic-clonic seizures	0
healthy snack	human t cell lymphotropic virus type iii	0
healthiest beverages	acidose	0
nutrient-dense foods	diabetic polyneuropathy	0
unhealthy food	broken bones	0
gluten	gluten enteropathy	1
walnut	b12 deficiency	0
dinner times	tonsil cancer	0
areca nuts	fibromyalgia-fibromyositis syndromes	0
aspartame	lav-htlv-iii	0
anise	diabetic complications	0
emphasizes vegetables	occipital traumas	0
canned fruit	birth defect	0
dried yeast	chronic obstructive airway disease	0
soybean proteins	neoplasm metastasis	0
dinnertime	testicular neoplasm	0
crave chocolate	neurological condition	0
favorite meals	cjd (creutzfeldt-jakob disease)	0
squash plant	action tremors	0
baby formulas	barrett syndrome	0
amygdalus communis	chronic infectious mononucleosis-like syndrome	0
carica papaya	semirhythmic tremors	0
saint john wort	cerebrovascular accident	0
citrus bergamias	deglutitional syncopes	0
golden raisins	hyperventilation syncope	0
betel nuts	crushing pains	0
silybum marianum	age related maculopathies	0
rowanberry	respiratory tract cancer	0
processing meat	migraine disorders	0
rosemary	spindle cell sarcoma	0
common bean plants	granulomatous colitis	0
pleurotus ostreatus	epileptic seizure	0
cola acuminata	oncovirinae	0
black raspberries	water-borne hepatitides	0
safflower	orthostatic headache	0
ultra-processed food	gastro-oesophageal reflux	0
red meats	brain malignant neoplasms	0
lycopersicon esculentum	mottled enamels	0
maple syrup	ph1 negative myelogenous leukemia	0
bolete	gall bladder diseases	0
whole grain cereal	food-borne diseases	0
digitalis purpurea	headache disorders	0
bread mold	enzootic bovine leukoses	0
gravy	cerebrovascular accidents	0
machaerium	hemolytic uremic syndrome	0
lens plants	vestibular seizure	0
portulaca	non-b hepatitis epidemic non-a	0
açai berries	auditory seizures	0
grecian foxglove	arthritide	0
sunchoke	chronic fatigue syndromes	0
pimenta	human t-lymphotropic virus type iii	0
dairy products	reducing cancer	0
dried peas	rachitide	0
solanum dulcamaras	skin cancer	0
plant-based foods	guillain-barre syndrome	0
avocado	hiatus hernias	0
acai berry	human papilloma virus	0
purslane	oncogenesis	0
high-fructose maize syrup	esophagitide	0
pecan trees	transitional meningiomas	0
frozen cranberries	arthropathy	0
pisum sativum	congenital defects	0
vaccinium bracteatums	migratory pains	0
euchresta	bilateral deafness	0
cinnamon	drug habituation	0
tumeric	oxygen deficiency	0
plant capsule	plasmodium infection	0
eugenia jambos	angioblastic meningioma	0
corn oil	back pain with radiation	0
rosa	nevoid basal cell carcinoma syndrome	0
eragrostus	tonsillar neoplasm	0
whole wheat	juvenile onset diabetes	0
wolfberry	osteoarthritis	0
chile peppers	colon neoplasm	0
carbonated beverages	paralysis agitans	0
origanum vulgare	fissure in ano	0
euterpe	back pain	0
theobroma cacao	adolescent obesity	0
sell meat	autosomal dominant. juvenile parkinson disease	0
allspice	tonic clonic seizures	0
roughage	hepatitide	0
poultry meat	human immunodeficiency viruses	0
lemon grass	water stress	0
milk thistle	male breast carcinoma	0
illicium anisatums	gastroenteritis	0
ice creams	creutzfeldt jacob disease	0
dripping	severe gh insensitivity	0
dioscorea opposita	psychotic disorders	0
apium graveolens var. dulce	adenomatous polyp	0
vodka	insulin-dependent diabetes mellitus	0
foenumgraecum	tonic-clonic seizures	0
trigonella foenum graecum	impotence	0
pea	complete hearing loss	0
navy beans	galactose-1-phosphate uridyltransferase deficiency	0
capsicum annuum	mixed small and large cell lymphoma	0
garden radish	convulsive syncope	0
chinese rhubarb	dental fluorosis	0
licorice	jakob creutzfeldt disease	0
shan yaos	benign essential tremor	0
breast milks	subtrochanteric fractures	0
eugenia caryophyllata	aphthous ulcer	0
romaine	grippe	0
lard	persistent tremors	0
brassica napus	limb tremor	0
grilled meat	rhabdomyolysis	0
cooking meat	tonsillar cancer	0
pimenta officinali	amaurose	0
convenience food	heart decompensation	0
plantago ovata	numbness	0
plum tree	continuous tremor	0
elettaria cardamomum	pulmonary embolisms	0
salsa	air sickness	0
food additive	backache	0
lycium barbarum	acquired immunodeficiency syndrome	0
cupcake	asymmetric diabetic proximal motor neuropathy	0
hickory nuts	colonic cancer	0
digitalis	diabetic complications	0
antioxidant-rich food	variant creutzfeldt jakob disease	0
cinnamomum cassia	superficial head injury	0
four nuts	diffuse undifferentiated lymphoma	0
cooked meats	cancer of the bone	0
carbonated mineral water	uterus cancers	0
conventional food	ovary neoplasm	0
zucchini	acute cerebrovascular accident	0
chili peppers	lung neoplasms	0
jell-o	gastro oesophageal reflux	0
pasta	senile tremors	0
flounder	cva (cerebrovascular accident)	0
apple tree	neuralgic migraine	0
dressing	foreign body	0
bertholletia excelsa	infarction	0
rubus idaeus	prediabetic states	0
pineapple juice	postoperative nausea and vomiting	0
antioxidant foods	cancer of the uterus	0
watercress	varix	0
contaminated foods	infertility	0
calendula officinalis	mental disorders	0
vaccinium angustifolium	insomnia	0
eugenia malaccensis	generalized spasms	0
ketchup	udpglucose hexose 1 phosphate uridylyltransferase deficiency	0
texturized vegetable protein	ocular headaches	0
wheatgrass	amnesia-memory loss	0
white mallows	non-alcoholic fatty liver disease	0
tofu	nausea	0
handling food	migraine	0
commercial milk	oxygen deficiency	0
retail meat	small cleaved-cell lymphoma	0
da huang	gluten sensitive enteropathy	0
dietary fats	bronchial asthma	0
peanut	endometrial carcinoma	0
fagopyrum	chromosome 6-linked autosomal recessive parkinsonism	0
raspberry	osteoporosis	0
indian gooseberry	acute confusional migraine	0
junk foods	bovine leukemias	0
artificial sweetener	acute inflammatory demyelinating polyneuropathy	0
laudable legume	degenerative neurologic diseases	0
flammulina velutipes	bladder tumors	0
sweetleaf	fibroatheromatous plaque	0
sweetener	occipital trauma	0
poisonous plants	drug use disorder	0
tangerine tree	hyperphagia	0
portulaca oleraceas	esophagitide	0
venison	virus disease	0
piper nigrum	cognitive declines	0
lemon grasses	utp hexose 1 phosphate uridylyltransferase deficiency disease	0
apricot	postoperative nausea and vomiting	0
extracted fruit	retained surgical instruments	0
avena	cryptogenic epilepsy	0
hop	infectious diseases	0
citrus grandi	atheromatous plaques	0
big meals	nonhodgkin's lymphoma	0
intoxicant	muscle pain	0
preserved food	degenerative neurologic diseases	0
cucumis melo	adolescent obesity	0
betel nut	communicable diseases	0
willow tree	zoonotic infections	0
low-calorie diet	olfaction disorders	0
asparagus	uveitis	0
triticum turgidum	mild neurocognitive disorder	0
flax seed	cervix cancers	0
atropa belladonna	galactose-1-phosphate uridyl-transferase deficiency disease	0
unfiltered coffee	pituitary dwarfism iis	0
maize	fatigue	0
squid	atrioventricular dissociations	0
not-necessarily-so-healthy foods	cancer of the prostate	0
plant aril	malignant melanoma	0
concord grape	galactosemia iii	0
anise seed	stomach neoplasms	0
zingiber officinales	uterine cancers	0
neutraceutical	mixed lymphomas	0
seltzer water	inflammatory polyneuropathy acute	0
durum wheats	nonalcoholic steatohepatitis	0
weed	esophageal neoplasm	0
melissa officinali	monocular blindness	0
dietary fibers	mouth cancer	0
ocimum tenuiflorum	parkinson’s disease	0
sweet orange	gluten enteropathies	0
crataegus monogynas	fibroid	0
contamination meat	acute inflammatory demyelinating polyneuropathy	0
soy yogurt	postoperative nausea	0
high-fat meal	epilepsy	0
different seed	cholera	0
cannabis indicas	neuritic plaque	0
blueberry	todds paralysis	0
ceylon cinnamon	gastric neoplasm	0
leafy vegetables	utp hexose 1 phosphate uridylyltransferase deficiency disease	0
cassia cinnamon	bses (bovine spongiform encephalopathy)	0
crunch berries	udp-galactose-4-epimerase deficiency	0
sesame oil	male breast neoplasm	0
sunfish	frontal region traumas	0
lycium	degenerative neurologic disease	0
adhatoda	vaginal discharges	0
anacardium occidentale	stomatognathic diseases	0
celeriac	thyroid cancer	0
wild radish	polymyositis ossificans	0
plaice	urinary bladder cancer	0
emphasize plant	cephalalgia	0
goji berries	alactasia	0
licorice root	cognitive dysfunctions	0
millet	basal cell nevus syndrome	0
pistachio	pancreatic neoplasms	0
macadamia nuts	reticuloendotheliosis viruses	0
roselle	insulin resistance	0
salmonella food	lung cancers	0
corn oils	confusional states	0
horsemeat	membranous cataracts	0
fabaceae	neurological condition	0
sour orange tree	upper respiratory infections	0
healthiest nuts	infantile botulism	0
green pepper	diabetes related complications	0
saint johnswort	tonic-clonic seizure	0
liquorice	carcinogenesis	0
sun-dried raisin	lobar pneumonias	0
teff	small noncleaved cell lymphoma	0
healthy nuts	renal calculi	0
carob	polyradiculoneuropathy	0
cooked carrots	basal cell epitheliomas	0
linum	amnesia-memory losses	0
copaifera	abdominal migraines	0
citrus sinenses	dermatozoic delusions	0
almond oil	ulcer	0
aquatic food	gastro-esophageal reflux	0
coca cola	cerebrovascular accidents	0
toronja	kidney calculi	0
sesame	colon cancers	0
bellis	lymphatic sarcomas	0
marihuana	membranous cataracts	0
olive	cacosmia	0
musa	adolescent gynecomastia	0
petroselinum crispums	male sub-fertility	0
stevia rebaudiana	auditory seizure	0
rice milk	diverticulitis	0
blackberry	myocardial infarctions	0
sweet basils	rodent ulcer	0
nut bar	endometrial neoplasms	0
mentha	pancreas neoplasms	0
baker's yeast	gastric neoplasm	0
prenatal vitamins	cot deaths	0
solanum tuberosums	arthritis	0
kombucha teas	western diseases	0
orange tree	diabetic complications	0
ficus	newborn gynecomastia	0
lavender	rabies viruses	0
curry	psoriase	0
lunch times	temporary amnesia	0
citrus reticulata	atherosclerotic plaques	0
espresso	social anxiety disorder	0
secale cereale	myeloma-multiple	0
kava	prelingual deafness	0
high-phytate foods	infectious diseases	0
shiitake mushroom	jakob-creutzfeldt syndrome	0
white tea	vaginal cancers	0
fuji apples	kidney stones	0
legume pod	mild cognitive impairment	1
find pork	pancreatic neoplasms	0
citrus limon	atrophy	0
zinger tea	arrhythmia	0
whortleberry	non-epileptic convulsion	0
antioxidant food	infectious diseases	0
ganja	sliding hiatal hernia	0
specific cheeses	hiv	0
nut bars	food-borne disease	0
guava	psychophysiological insomnia	0
sticker	e b virus	0
red peppers	eczema	0
dried pomegranate	ocular headache	0
infant formula	arthritis	0
sandwich	feline leukemia virus	0
common fruits	bovine leukemia virus	0
cassia fistulas	age-related bone loss	0
silken tofu	brain tumor	0
brussel sprout	prostatic adenomas	0
lima beans	thermal hypesthesia	0
eating broccoli	prostatic hypertrophy	0
coca	mixed cell lymphoma	0
goiaba	disrupted in b-cell malignancy	0
camomile	atherosclerotic plaque	0
colorful foods	amnesia-memory losses	0
sour fruit	penis cancer	0
shorten	cancer of the tongue	0
digitalis lanata	respiratory tract infections	0
spaghetti	salami brusher's disease	0
pinto bean	psoriase	0
retail poultry	parietal region traumas	0
stevia rebaudianas	degenerative intervertebral disc	0
dietary plant protein	acquired immunodeficiency syndromes	0
kiwi	male breast tumor	0
seafood	recurrence	0
flaked coconut	ciguatera fish poisonings	0
marijuana	poultry viruses	0
psidium	galactokinase deficiency disease	0
dried plums	cerebrovascular stroke	0
peach	kidney neoplasms	0
caramel	malignant primary brain tumors	0
citrus paradisi	papillomaviridae	0
origanum majorana	osteoporosis	0
cider vinegar	disc degradation	0
scrambled eggs	anal fissure	0
citrus aurantiifolias	diffuse mixed-cell lymphoma	0
rose hips	spiral fractures	0
pistacia lentiscus	reticulosarcoma	0
curcuma longa	persistent tremors	0
topical ginger	temporal region traumas	0
dietary supplements	flatus	0
soy proteins	syncopal vertigos	0
pistacia vera	muscle disease	0
trigonella foenum-graecum	infant gynecomastia	0
citrus hystrix	amyotrophic lateral sclerosis	0
drinking water	relapse	0
vegetable oil	strains and sprains	0
arginine-rich foods	familial creutzfeldt-jakob diseases	0
dried fruits	social anhedonia	0
thyme	small non-cleaved-cell lymphoma	0
oregano plant	chronic insomnia	0
soft drinks	human t-cell lymphotropic virus type iii	0
beet greens	migraine disorders	0
burrito	polyphagia	0
abelmoschus esculentus	pancreas neoplasms	0
vitamin	periorbital headache	0
cereal grains	lou-gehrigs disease	0
gala apples	chronic fatigue-fibromyalgia syndromes	0
dioscorea villosa	comatose	0
aubergine	nerve tremor	0
rubberplant	spasm	0
marsh mallows	fibromyositis-fibromyalgia syndrome	0
illicium anisatum	blindness	0
muffin	liver disease	0
food company	transitional meningiomas	0
horsenettle	neurotic anxiety states	0
cabbage	acute infectious polyneuritis	0
andean blackberry	arthrosis	0
butter milk	pulmonary disorder	0
saccharomyces cerevisiae	small non-cleaved-cell lymphomas	0
althaea	bronchiolitis	0
white potatoes	postural low back pain	0
grape	subwakefullness syndromes	0
boiled eggs	colic	0
squash seeds	headache syndrome	0
healthy foods	hypovolemic shock	0
century plant	ponv	0
endive	chronic cystic mastitis	0
tangerine trees	hansen's disease	0
club sodas	viral infection	0
sesame oils	cephalgia syndromes	0
nicotiana tabacum	age related macular degeneration	0
powdered ginger	pituitary dwarfism ii	0
molasse	nervous system degenerative diseases	0
corn syrup	back pain	0
cola	diffuse mixed-cell lymphomas	0
cycad trees	male infertility	0
citrus	chronic obstructive pulmonary disease	0
so-called meat	enterocele	0
raw poultry	cataract	0
olive tree	breast carcinomas	1
gui zhi	lung cancers	0
fiddlehead ferns	cancer of colon	0
pomelo tree	anal ulcers	0
anti-inflammatory foods	diabetic asymmetric polyneuropathy	0
mangifera indica	chronic infectious mononucleosis-like syndrome	0
including cloves	behavior disorders	0
mastic tree	idiopathic polymyositis	0
plant embryos	deep-vein thromboses	0
brazil nut tree	hyperventilation syncope	0
melissa	viral infection	0
kava kava	b12 deficiency	0
treat	subfertility	0
healthiest snack	weight loss	0
arugula	cancer of bone	0
soy	parodontosis	0
lemon verbena	degenerative intervertebral disc	0
processed meats	hepatic neoplasms	0
yogurt	benign intracranial hypertension	0
anacardium occidentales	mental deteriorations	0
healthier meat	heatstroke	0
texturized vegetable proteins	foodborne botulisms	0
punica granatum	pleomorphic lymphoma	0
anchovy	vertebrogenic pain syndromes	0
citrus medica	carcinogenese	0
plant capsules	mania	0
tv dinners	aphthous stomatitis	0
yerba mate	cervix neoplasms	0
plantago seed	breast tumor	0
suggesting fruit	nonhodgkin lymphoma	0
radish	small round-structured viruses	0
tuna fish	human herpesvirus 4	0
food colors	fibroadenoma	0
woodland strawberry	vaginal neoplasm	0
vegetable juice	arthrosis	0
mangifera indicas	hemangiopericytic meningiomas	0
cocoa powders	auditory seizure	0
chinook salmon	symptom clusters	0
herbal teas	retained surgical items	0
snack food	oncogenic virus	0
squash plants	gastro-oesophageal reflux	0
beef	non alcoholic fatty liver disease	0
actual fruit	cervical neoplasm	0
cooked meat	dysmenorrhea	0
vegetable juices	subacute spongiform encephalopathy	0
spice turmeric	intermediate-grade lymphomas	0
red delicious apples	enzootic bovine leukosis	0
ready-to-eat meals	cerebrovascular accident	0
soy food	pseudotumor cerebri	0
peach tree	block cancer	0
dried cranberries	overeat	0
proteus mirabilis	amaurosis	0
rose berries	degenerative intervertebral disks	0
bitter orange tree	autistic disorders	0
almond tree	focal seizures	0
poppy seeds	testis cancers	0
brazil nuts	acquired immunodeficiency syndrome virus	0
pecan	retro ocular headache	0
miso	retro-ocular headaches	0
coriandrum sativum	galactose epimerase deficiencies	0
eugenia cumini	premenstrual tensions	0
rheum	cognitive impairment	0
popular fruits	prostatic adenomas	0
antioxidant-rich foods	benign meningiomas	0
no meat	zoonosis	0
banana plants	familial creutzfeldt jakob disease	0
cleistocalyx	gerd	0
cooked broccoli	minor head injury	0
biometal	kidney disease	0
solanum tuberosum	malignancy	1
chinese food	penile neoplasm	0
hemp plant	erectile dysfunction	0
cultivated radish	spinal cord degenerative diseases	0
indian gooseberries	brain vascular accident	0
sesamum	inflammatory disorder	0
chocolate	cephalgia syndrome	0
sorrel	cancer of the uterine cervix	0
amaranth	lung neoplasm	0
dietary plant proteins	burning pain	0
sugar substitute	dysfunction	0
coconut oil	anaplastic carcinoma	0
mustard	cjd (creutzfeldt-jakob disease)	0
chili	cough	0
cucurbita	fine tremor	0
wild celeries	acute inflammatory polyneuropathy	0
oatmeal	cervical migraine syndromes	0
sea vegetable	brain neoplasms	0
food and drug administration	nbcc	0
breakfast time	macular degeneration	0
cassia	polyarthralgia	0
cocoanut	nasal cavity cancer	0
crocus sativus	creutzfeldt jakob disease	0
term vegetable	postpartum sterility	0
monitoring food	idiopathic intracranial hypertension	0
areca catechu	dysfunction	0
dog rose berries	well-differentiated lymphocytic lymphomas	0
andean blackberries	crohn disease	0
milk proteins	benign essential tremors	0
artificial sweeteners	renal cancers	0
nut	cancer of the tonsil	0
althea officinalis	bovine lymphosarcoma	0
jerusalem artichokes	muscle soreness	0
mustard greens	apnea	0
weekly meat	acute monocytic leukemia	0
fryer	essential tremor	0
cheese	ph1 negative myeloid leukemia	0
fatty meal	amnestic states	0
soy bean curds	lens opacity	0
justicia	diabetes related complications	0
beer	eczema	0
jalapeno pepper	gustatory seizures	0
acer	superficial head injury	0
olea	galactose epimerase deficiencies	0
no-calorie sweeteners	hyperphagia	0
brewed coffee	cardiovascular conditions	0
drinking milk	familial diffuse gastric cancer	0
vaccinium macrocarpons	deaf mutism	0
ground ginger	intermediate-grade lymphomas	0
illicium	androgenic alopecias	0
vitis	hair loss	0
organic plants	headache syndrome	0
organic foods	cancer of uterus	0
dietary supplement	diffuse mixed small and large cell lymphoma	0
seville orange trees	primary parkinsonism	0
honeybush tea	brain conditions	0
rubus fruticosus	male sexual impotence	0
purple potatoes	develop cancer	0
shellfish	primary malignant brain neoplasms	0
pumpkin seeds	tonsil cancer	0
cauliflower	tonsillar neoplasms	0
bitter nightshade	pernicious vomiting of pregnancy	0
dietary fat	gangrene	0
glycyrrhiza	gut dysfunction	0
guibourtia	myalgia	0
erythroxylon	cll lymphoplasmacytoid lymphomas	0
holy basils	vulva cancer	0
olive trees	birth defect	0
turmeric root	widespread chronic pain	0
larder	premature birth	0
prunus cerasifera	craniocerebral injuries	0
fries	mental disorders	0
cicer arietinums	bilateral sciaticas	0
pimpinella anisums	diffuse mixed-cell lymphomas	0
spice saffron	chronic b lymphocytic leukemia	0
triticum aestivum	constipation	0
justicia adhatoda	diffuse well differentiated lymphocytic lymphoma	0
cured meats	high-grade lymphoma	0
deep-fried foods	carcinoma in situ	0
broccoli raab	airsickness	0
recommend tea	inappropriate growth hormone secretion syndrome (acromegaly)	0
frier	hirsutism	0
sugar substitutes	human t cell lymphotropic virus type iii	0
curry powder	gastric ulcers	0
vaccinium macrocarpon	blood cancers	0
lemongrass	common bile duct calculi	0
decaf	muscle soreness	0
deep-fry foods	genital warts	0
prosopis	non-epileptic convulsion	0
syzygium	bse (bovine spongiform encephalopathy)	0
monkfish	delusional parasitosis	0
soda pops	jacksonian seizure	0
prosopi	abdominal migraine	0
vicia fabas	barrett metaplasia	0
whiting	muscular cramps	0
bertholletia excelsas	delusory parasitosis	0
root	renal neoplasms	0
veggie	tonsillar cancers	0
big food	arterial fatty streaks	0
citrullus	ebv	0
green peas	guillaine barre syndrome	0
food supplements	bewilderment	0
elettaria	cognitive impairment	0
gum acacia	barrett metaplasia	0
ground flax	retained surgical instruments	0
juiced broccoli	hepatocellular cancers	0
processed meat	autosomal dominant. juvenile parkinson disease	0
dioscorea	brain disease	0
tea hibiscus	pancreas cancers	0
hawthorn	semantic memory disorder	0
berberi	voice box cancer	0
french fries	weight reduction	0
jam	itch	0
cocoa plants	light-headedness	0
raisin bran	animal viruses	0
hot peppers	age-related macular degeneration	0
hypericum perforatum	prostatic adenomas	0
healthiest vegetable	extreme hearing loss	0
trompillo	creutzfeldt-jakob disease	0
red meat	dementia praecox	0
salad	fibrose	0
hemlock	cardiac diseases	0
orange juice	cattle leukemia virus	0
raw foods	muscle tremor	0
oyster mushrooms	bronchial asthma	0
fig	parkinson's disease	0
cultivated oat	gnathostoma infection	0
agent orange	chronic fatigue-fibromyalgia syndromes	0
frozen broccoli	age-related bone loss	0
herbal tea	lymphoplasmacytoid lymphoma	0
breakfast cereals	rectal neoplasms	0
toxic plants	neonatal tremor	0
offal	uterine leiomyoma	0
carbonated drink	cluster headache	0
breakfast	disc degeneration	0
chile pepper	miscarriage	0
morinda citrifolia	melanoma	0
noni fruit	pregnancy-induced diabetes	0
black walnuts	non b hepatitis enterically transmitted non a	0
secale	atopic diseases	0
rheum officinale	chronic lymphocytic leukemias	0
ocimum basilicum	prostatic neoplasm	0
iceberg lettuce	cancer of bone	0
candy bars	endocrine breast diseases	0
nicotiana tabacums	radiating pain	0
mint tea	migratory pains	0
flavorer	nonalcoholic fatty liver	0
unfertilized eggs	diabetic retinopathy	0
sour cream	multiple sclerosis	0
citrus bergamia	intracranial cns disorder	0
emblica officinali	urinary tract infection	0
kaffir lime	vitamin deficiency	0
cherry plum trees	sleep disorder	0
processed food	familial tremors	0
soup	block cancer	0
squash	gingivitide	0
candy	low backaches	0
durum wheat	brief reactive psychoses	0
amomum cardamomum	hepatitis	0
broth	atherogenesis	0
fast food	acidose	0
silybum marianums	diabetic complication	0
bell pepper	kidney cancers	0
big apples	eczematous dermatitides	0
sprout	high cholesterol level	0
soy beverage	foreign object	0
assai palm berry	ramsay hunt paralysis syndrome	0
oat	male infertility	0
vaccinium virgatum	post-traumatic osteoporosis	0
poppy seed	impaired sensation	0
vicia faba	environmental cancer	0
syzygium jambos	cll lymphoplasmacytoid lymphomas	0
ultra-processed foods	retained surgical item	0
carrot juice	diabetic mononeuropathies	0
chinese cinnamon	varice	0
plant-based nutrients	degenerative intervertebral disks	0
eggnog	hepatocellular cancers	0
spearmint	creutzfeldt-jakob disease	0
frying meat	bacteria-eating viruses	0
tisane	massive tremors	0
high fructose maize syrup	sprue	0
tarragon	chronic gum disease	0
ilex paraguariensis	creutzfeldt jakob syndrome	0
pomelo trees	abdominal aortic aneurysm	0
black sapotes	prostate cancers	0
raw alfalfa	degenerative intervertebral disc	0
hordeum vulgare	pustulosis palmaris et plantaris	0
prunus domestica	tubal abortions	0
solanum lycopersicum	muscle spasms	0
raw food	age related memory disorders	0
elettaria cardamomums	udp-galactose-4-epimerase deficiency diseases	0
jelly	hysterical blindness	0
green beans	phage	0
chervil	limb cramp	0
marsh mallow	prostatic adenoma	0
cream cheese	mixed lymphoma	0
hashish	female sub-fertility	0
ready prepared foods	penis cancers	0
red rice	muscle pains	0
pomegranate	mixed lymphomas	0
dairy yogurt	esophageal cancer	0
bad foods	bowel disease	0
msg	aortic aneurysms	0
sweetening agent	wheat allergies	0
sweetened cereal	mental disorder	0
acaí berries	chronic fatigue fibromyalgia syndrome	0
citrus fruit	early diagnosis of cancer	0
jasmine tea	numbness	0
green grapes	subtrochanteric fractures	0
foie gras	b cell leukemia	0
ground beef	polyphagia	0
milkshake	hepatic neoplasms	0
cumin	sprue	0
porphyra	chest pains	0
poroporo	diabetes-related complications	0
chocolate bars	bechterew's disease	0
sunflower seeds	recurrence	0
filbert	galactose epimerase deficiencies	0
cinnamomum aromaticum	bipolar disorder	0
kangaroo meat	cerebrovascular stroke	0
sushi	cancer of prostate	0
pear	occipital region trauma	0
petroselinum crispum	cancer of the thyroid	0
mustard plant	benign essential tremors	0
feather meal	degenerative intervertebral discs	0
ale	foodborne illnesses	0
opium poppies	gerd	0
usda poultry	a-v dissociation	0
bitter orange trees	post-traumatic osteoporosis	0
maize oils	endothelial dysfunction	0
stem vegetables	autistic disorder	0
food allergies	bladder diseases	0
piper methysticum	hypertension	0
trigonella foenum-graecums	visceral obesities	0
mentha spicata	insulin deficiency	0
box elders	joint diseases	0
raw tomatoes	mild neurocognitive disorder	0
halibut	cough	0
peanut butter	intestinal diseases	0
red onions	breast neoplasm	0
trace elements	cancer of the endometrium	0
cymbopogon nardus	migraine variant	0
barberry	udp-galactose-4-epimerase deficiencies	0
cymbopogon	prostatic cancers	0
fast foods	migratory pains	0
osmanthus	disc degenerations	0
black rice	jakob-creutzfeldt syndrome	0
nutriceutical	fibrous meningiomas	0
citrus aurantium	chronic disease	0
triticum spelta	alactasia	0
vaccinium myrtillus	texidor twinge	0
triticum turgidum subsp. durum	retained surgical tools	0
fried foods	chronic illnesses	0
green lentils	diverticulosis	0
morinda	tumorigenesis	0
pinto beans	rectal cancer	0
red yeast rice	bipolar disorders	0
cortland	aphthous ulcers	0
domestic fowls	arthritide	0
bread	nonalcoholic fatty livers	0
syzygium malaccense	rupture	0
persea	diverticulitis	0
component spices	soft tissue sarcomas	0
swiss chard	meningotheliomatous meningioma	0
canned foods	acute strokes	0
dasheen	nontropical sprue	0
brewing tea	dermatosis	0
carthamus tinctorius	single seizures	0
mustard oil	rectal neoplasm	0
salt-free diet	reticulolymphosarcoma	0
vaccinium corymbosum	symmetric diabetic proximal motor neuropathy	0
leek	metastasis	0
know nuts	disseminated sclerosis	0
saint john's wort	semantic memory disorders	0
soy bean curd	salmonella infections	0
carya	auriculo-ventricular dissociation	0
empty calorie foods	senile osteoporoses	0
incorporate cloves	age related maculopathies	0
food pyramid	somatosensory seizure	0
vegetable protein	premature birth	0
seville orange tree	confusional state	0
guacamole	male breast carcinoma	0
delonix	psammomatous meningiomas	0
bacon	sid	0
norus	bone neoplasms	0
eugenia sandwicensis	tongue cancer	0
ephedra	circulatory collapse	0
health food	mink encephalopathy virus	0
marshmallow	syncope	0
kavas	osteoarthritide	0
frequent meals	increase cancer	0
foeniculum vulgares	thyroid neoplasms	0
syzygium cumini	secretory meningioma	0
malabar-nut	intractable headaches	0
corn sugar	histamine cephalgias	0
soy milk	regional ileitis	0
vegetable proteins	somatotropin hypersecretion (acromegaly) syndrome	0
prunus armeniaca	burkitt's lymphoma virus	0
hibiscus	open head injuries	0
organic meat	abdominal migraines	0
aspalathus	renal failure	0
persea americana	lymphocytic leukemia	0
grapefruit	htlv-iii	0
chard	cephalodynia	0
chlorella	ciguatera fish poisoning	0
brussels sprouts	acne vulgaris	0
calendula	small noncleaved-cell lymphomas	0
caryophyllus aromaticus	sick headache	0
citronella	carotid sinus syncope	0
oolong	leukemia virus	0
zedoary zedoarias	postural syncopes	0
rheum rhaponticum	sensory seizures	0
algarrobo	colonic neoplasms	0
origanum onites	breast neoplasm	0
wild celery	child obesity	0
fake meat	oncovirinae	0
cinnamomum verum	fibromyalgia-fibromyositis syndrome	0
lycium chinense	male infertility	0
saffron	short sleeper syndrome	0
chinese yam	generalized headaches	0
hibiscus sabdariffa	todd paralysis	0
phytonutrient-rich food	animal virus	0
vitis vinifera	psammomatous meningiomas	0
nut butter	guillaine barre syndrome	0
butter	tongue cancer	0
avenas	reticuloendotheliosis viruses	0
brassica juncea	deformity	0
sweet almond	massive tremors	0
thymus plants	hemolytic jaundice	0
cooking oil	histamine cephalgias	0
cranberry sauce	parkinsonian disorders	0
linum usitatissimums	manic state	0
fresh fruits	amyotrophic lateral sclerosis	0
narrow-leaved plantains	renal cancers	0
sea bilberry	paraesophageal hernias	0
table salt	neurologic degenerative conditions	0
golden delicious	skin cancer	0
vaccinium uliginosum	cancer of breast	0
ready-prepared foods	gingivitide	0
papaver	non-b hepatitis epidemic non-a	0
organ	gynecomastia	0
whole grain cereals	parasagittal meningiomas	0
walnut oil	pill rolling tremors	0
malus domestica	vulva cancer	0
cider	tonic clonic seizures	0
mangifera	urticaria	0
breast milk	human t cell leukemia virus type iii	0
soda waters	idiopathic polymyositis	0
berry	johnes disease	0
sugar maples	malignant epithelial neoplasm	0
processed apples	uterus cancers	0
lunchtime	sleep initiation dysfunctions	0
eupatorium rebaudianum	protein deficiencies	0
mangosteen	hemangiopericytic meningiomas	0
thymus	palsy	0
monosodium glutamate	fever	0
english plantains	breast pain	0
mealtime	age-related maculopathy	0
trace mineral	rhabdomyolysis	0
wort	philadelphia negative myeloid leukemia	0
spicy food	memory disorder	0
baby carrots	polyarthritis	0
hummus	sudden cardiac arrests	0
common bean plant	galactose-1-phosphate uridyltransferase deficiency	0
gluten-free diet	mad cow diseases	0
probiotic	causes cancers	0
sardine	macular dystrophies	0
antioxidant fruits	brief reactive psychosis	0
kenaf	gasser's syndrome	0
assai palms	foreign objects	0
tomato	epithelial cancers	0
linseed	e-b virus	0
phaseolus	central nervous system cysticercosis	0
chenopodium quinoas	juvenile parkinsonisms	0
morinda citrifolias	neurologic degenerative condition	0
andropogon nardus	sprue	0
nitrate-rich vegetables	wound botulism	0
leguminosae	paroxysmal atrial fibrillations	0
crab apple	acute inflammatory polyneuropathies	0
alfalfa	preterm births	0
legume pods	experimental parkinson disease	0
syrup	human mammary neoplasms	0
cannabis sativa	urinary tract infection	0
phyllanthus emblica	carcinoma in situ	0
sweet potatoes	idiopathic polymyositis	0
andira	acute monoblastic leukemias	0
soybean	acquired immunodeficiency syndrome	0
yam	gastric cancer	0
common olive tree	psoriasis	0
pea families	multiple myositides	0
low meat	barrett epithelium	0
milk protein	central obesity	0
daily nut	cancer of vagina	0
myristica fragrans	widespread chronic pain	0
plant zygotes	pneumonia	0
billion eggs	fibrous meningioma	0
solanum melongena	anal fissure	0
banana plant	bladder diseases	0
curcuma zedoarias	papillomaviridae	0
eragrostis	voice box cancer	0
barley coffee	gastric neoplasms	0
eating almonds	disk degradations	0
tomato juice	auditory seizures	0
added sweeteners	circulatory failure	0
lemon	uterine fibromas	0
hemp	schizoaffective disorder	0
olea europaea	bacterial vaginitis	0
dandelion	peanut hypersensitivity	0
cooked tomatoes	testicular cancers	0
scallion	low back pains	0
cannabi	neuralgic migraines	0
fagopyrum esculentum	situational syncope	0
seltzer waters	pregnancy pernicious vomiting	0
infects apples	fibromyositis-fibromyalgia syndromes	0
chamomile	spiral fractures	0
tree nuts	early infantile autism	0
ceratonia	urticaria	0
capsicum	pleomorphic lymphomas	0
euterpe edulis	apneas	0
stevia	determination of death	0
diabetic diet	prion induced disorder	0
greenery	atypical diffuse small lymphoid lymphoma	0
psidium guajava	coronary diseases	0
low vitamin	peanut allergies	0
serve	inappropriate growth hormone secretion syndrome (acromegaly)	0
mustard seeds	cerebral stroke	0
melissa officinalis	pancreas neoplasms	0
common foxglove	postoperative nausea	0
açaí berry	undifferentiated lymphoma	0
meal	aphthous ulcers	0
cashew	male breast neoplasm	0
cold-steeping tea	carotid sinus syncopes	0
roundup-ready soybeans	spondylarthritis ankylopoietica	0
drinking tea	papillomaviridae	0
oryza sativa	abdominal obesities	0
pie	pyrexia	0
onion	genital wart	0
low fruit	cramp	0
deli meats	cancer of the vagina	0
cassia fistula	acute confusional migraine	0
lavandula angustifolia	high-grade lymphomas	0
egg	cardiac dysrhythmia	0
spore	malignant lymphoma	0
plantago psyllium	iron deficiency	0
lemon trees	virus infection	0
floret	lyme arthritis	0
last meal	endothelial dysfunction	0
macadamia nut	uterine cancer	0
dairy eggs	metabolic acidosis	0
assai palm berries	mild neurocognitive disorders	0
curcuma longas	environmental cancer	0
acid-binding vegetables	icterus	0
pineapple	mammary cancer	0
brew	autosomal recessive parkinsonism	0
citrus-based fruits	inflammatory bowel disease 1	0
tulsi tea	esophageal neoplasm	0
juglans nigra	cancer of the ovary	0
animal-based vitamin	mammalgia	0
mint	sleep initiation dysfunction	0
coriandrum	gingivitis	0
coconut water	fusiform aneurysm	0
purple grape	basal cell epithelioma	0
earl grey tea	lou gehrig disease	0
carbonated water	renal insufficiency	0
largest meal	diabetic amyotrophies	0
maple	acquired immunodeficiency syndrome virus	0
sauerkraut	parkinsonian diseases	0
wheat brans	jakob creutzfeldt disease	0
fermented foods	posterior fossa meningioma	0
hot sauce	pancreatic neoplasm	0
pistacia	nonalcoholic fatty liver	0
split pea	convulsive seizures	0
apricot trees	fibroatheroma	0
chamomile oils	kidney diseases	0
sweet marjorams	colorectal cancers	0
faba bean	breast malignant neoplasm	0
tuna	crushing pains	0
applesauce	ovarian cancers	0
dietary proteins	chest pains	0
animal food	hysterical amnesias	0
pickled vegetables	primary brain neoplasms	0
syzygium jambolanum	common bile duct gall stones	0
frying foods	continuous tremors	0
plant kingdom	nonalcoholic fatty liver disease	0
healthiest fruits	female sterility	0
carbonated beverage	uveitide	0
mentha spicatas	kahler disease	0
alfalfa sprout	skin neoplasms	0
portulaca oleracae	epstein barr virus	0
arachis hypogaea	lymphosarcoma	0
hot pepper	osteoarthrosis deformans	0
acacia tree	nonhodgkin's lymphoma	0
dried blueberries	dental plaque	0
cereal grain	esophagus cancers	0
popcorn	hypersensitivity	0
humulus lupulus	experimental parkinsonism	0
virgin olive	gnathostomiase	0
soy bean	melanoma	0
color	dehydration	0
avocado fruit	reduced sensations	0
concord grapes	anxiety neuroses	0
little saffron	hepatic failure	0
arachis	transmissible spongiform encephalopathies	0
white bread	aortic aneurysms	0
amla	phage	0
white mallow	coronary heart diseases	0
cannabis indica	severe gh insensitivity	0
bagel	mixed lymphocytic-histiocytic lymphoma	0
juglans regia	occipital region trauma	0
candy bar	cysticercose	0
energy drinks	breast malignant tumors	0
eat chocolate	cirrhosis	0
pimenta diocia	autosomal recessive familial parkinson disease	0
sweet foods	chromosome 6-linked autosomal recessive parkinsonism	0
raphanus	vaginal discharges	0
poultry	well differentiated lymphocytic lymphoma	0
colophospermum	congenital hypothyroidism	0
lens culinari	muscle spasm	0
edible grain	single seizure	0
hickory trees	stomach ulcers	0
oreo	cellulite	0
wine	muscle tremors	0
nutmeg	nerve tremor	0
red pepper	head pain	0
golden glow	paraosmia	0
dinner time	degenerative diseases	0
strawberry	bacterial vaginosis	0
neu5gc-rich food	brain benign neoplasms	0
alpine strawberry	auto-immune diseases	0
alcoholic beverage	reticulum-cell sarcomas	0
horsebean	lymphadenopathy-associated virus	0
shiitake mushrooms	post-ictal confusion	0
lens plant	cognitive impairment	0
supper	primary fibromyalgias	0
adding blueberries	orf	0
squashe	diabetes-related complication	0
fresh basil	gluten enteropathies	0
rice	spondylitis ankylopoietica	0
myristica fragran	gluten enteropathies	0
mandarin orange tree	circulatory failure	0
taro	eczematous dermatitides	0
butternut squash	type c oncoviruses	0
pimpinella anisum	multiple meningioma	0
use sweeteners	parkinsonism	0
arecas	substance addiction	0
carbonated mineral waters	migraine disorders	0
tea	plasmodium infections	0
brown rice	malignant tumor of breast	0
pudding	liver dysfunction	0
currant	atrioventricular dissociation	0
vaccinium bracteatum	familial parkinson disease	0
purine-rich plant	blood cancer	0
pummelo trees	bone fractures	0
mesquite	kidney failures	0
goji berry plant	gangrene	0
reindeer meat	small noncleaved-cell lymphomas	0
almond butter	oncogenese	0
incorporates cloves	neurological condition	0
oregano plants	spinal cord disorders	0
pimiento	cadaver	0
solanum laciniatum	atypical chronic myeloid leukemia	0
oregano	muscular spasm	0
japanese plums	death	0
coconut	unhealthy conditions	0
coffee	central nervous system degenerative diseases	0
anacardium	venereal warts	0
granny smith apples	hepatic cancers	0
saint johns wort	throbbing headaches	0
sea bilberries	hypermelanose	0
suggesting apple	bladder cancer	0
lentil	brain disorders	0
so-called vegetable	cancer of colon	0
tap water	tongue cancers	0
areca	testis cancers	0
acer saccharums	renal failures	0
euterpe precatoria	lichen ruber planus	0
wheat	carcinoma in situ	0
juglan	bronchial asthma	0
convenience foods	contagious ecthyma	0
kiwi fruits	severe congenital microcephaly	0
blueberry plants	fatty liver	0
kidney beans	drop attacks	0
decrease meat	prelingual deafness	0
chicken salad	perioral tremors	0
artificial butter	acute monocytic leukemias	0
cured meat	bilateral headaches	0
century plants	muscle soreness	0
haritaki fruit	coad	0
drink milk	epileptic seizure	0
raw garlic	cephalgia syndrome	0
natural vitamin	fine tremors	0
raw meat	stomach ulcer	0
nut butters	hyperventilation syncopes	0
peppermint	bleed	0
fenugreek	tonsillar neoplasm	0
chilli pepper	deafness	0
longevity legumes	biliary calculi	0
oxen meat	gehrigs disease	0
spinach	tongue cancers	0
bt corn	posterior fossa meningiomas	0
eugenia jambolana	sick headache	0
sea vegetables	hormonal dysfunction	0
goji berry	wart viruses	0
cayenne peppers	multiple head injury	0
prebiotic	lymphoplasmacytoid lymphoma	0
oats	jacksonian seizure	0
pickled foods	light-headedness	0
chinese cassias	galactokinase deficiency diseases	0
grouper	experimental lung inflammations	0
trigonella	atypical diffuse small lymphoid lymphoma	0
laciniate nightshades	thermal hypesthesia	0
safflower oil	utp-hexose-1-phosphate uridylyltransferase deficiency disease	0
cacao bean	lou-gehrigs disease	0
aloe vera	increase cancer	0
phyllanthus emblicas	cerebral strokes	0
turmeric	tubal abortion	0
saffron crocus	deep-vein thromboses	0
national pork	hysterical blindness	0
amlas	parodontosis	0
anticancer plant	acute inflammatory polyradiculoneuropathy	0
kola nuts	ovarian cancer	0
jambolan plum tree	adenosis of breast	0
hydroponic basil	chronic daily headache	0
ranking foods	neurodegenerative disorders	0
moose meat	bronchiolitide	0
indian corn	jakob-creutzfeldt syndrome	0
different fruits	brain malignant neoplasm	0
hypericum perforatums	head pain	0
study lavender	inhibit cancer	0
national meat	icterus	0
include apples	marsh fever	0
bamboo shoots	parkinsonism-dementia complex of guam amyotrophic lateral sclerosis	0
crataegus	primary brain neoplasm	0
beta vulgaris	body weight	0
mandarin orange trees	stomatognathic diseases	0
nori	amnesia	0
snack foods	fatty liver disease	0
chenopodium quinoa	anal ulcers	0
citrus reticulatas	guam form of amyotrophic lateral sclerosis	0
rubus glaucus	male sub-fertility	0
bilberry	urinary bladder diseases	0
cocoa	neuritic plaque	0
margarine	lung inflammations	0
liquor	multiple myelomas	0
baptisia	hypertension	1
orange	varicose vein	0
marjoram	nontropical sprue	0
veal	acquired immunodeficiency syndromes	0
citrus aurantiums	ovarian cancer	0
mastic trees	intestinal diseases	0
calling eggs	postoperative nausea and vomiting	0
black coffee	obesity virus	0
ananas	bronchiolitis	0
food coloring	cervical cancer	0
aloe	thyroid diseases	0
persea americanas	epithelioma	0
stryphnodendron	feline leukemia virus	0
common foxgloves	near-death experience	0
whale meat	preventable cancers	0
nutritional yeast	darkness tremor	0
new york coalition for healthy school food	esophageal neoplasms	0
worldwide fruit	birth defects	0
beetroot	myeloma multiple	0
buttermilk	saturnine tremor	0
tea leaves	basal cell epithelioma	0
rubus	infectious virus	0
basil	seizure disorder	0
poultry product	malignant neoplasm of breast	0
olive oil	ruptured appendicitis	0
fennel seeds	cancer of breast	0
snail meat	histamine cephalgias	0
flaxseed	mild neurocognitive disorder	0
common plant	retained surgical tools	0
cultivated oats	angiomatous meningiomas	0
international nut	megacolon	0
healthy snacks	aphthous ulcer	0
lemon tree	dizziness	0
fed beef	retro-ocular headache	0
grapefruit juice	monocular blindness	0
healthy food	leukemogenic virus	0
pomegranate seeds	age-related memory disorder	0
soy bean proteins	breast carcinoma	1
soymilk	hansen disease	0
celery	granulomatous colitis	0
processed foods	atopic diseases	0
cocos nucifera	head traumas	0
papaya	acquired immune deficiency syndrome virus	0
pease	cancer of liver	0
brown sugar	creutzfeldt jacob disease	0
chicken meat	cancer of the brain	0
soy cheeses	manic states	0
avoid peanuts	sprains and strains	0
whipped cream	carcinogenese	0
whole grains	forehead traumas	0
alfalfa sprouts	paroxysmal atrial fibrillation	0
dietary sugars	bacteria-eating virus	0
club soda	familial creutzfeldt-jakob diseases	0
pine nuts	pancreatitide	0
flesh foods	vitamin deficiencies	0
coriander	degenerative intervertebral disk	0
plantago	heart blocks	0
black teas	micturition syncopes	0
bhang	galactose 1 phosphate uridyltransferase deficiency	0
nutraceutical	retained surgical instruments	0
soya milk	brittle diabetes mellitus	0
dried apple	aortic aneurysm	0
crabapple	hypoesthesia	0
chewing gums	pill rolling tremors	0
hibiscus cannabinus	bses (bovine spongiform encephalopathy)	0
garlic sauce	ductal carcinoma	0
petroselinum	autoimmune condition	0
kale	skin cancers	0
plant zygote	esophageal reflux	0
jalapeno peppers	hiatal hernia	0
uncooked foods	influenza in human	0
betel	nonorganic insomnia	0
chai tea	chronic cystic mastitis	0
soy cheese	malaria	0
sausage	tactile hypesthesias	0
vegetarianism	thyroid neoplasms	0
paella	nonalcoholic steatohepatitis	0
gooseberry	anal ulcer	0
black currant	chronic infectious mononucleosis-like syndrome	0
alcoholic beverages	mouth neoplasm	0
french bean plants	encephalopathy	0
carrot	cancer of the kidney	0
cicer arietinum	penile cancers	0
meal times	hepatic cancer	0
soda pop	postural syncope	0
french bean plant	polymyositis	0
fortify milk	udpglucose 4-epimerase deficiency disease	0
family vegetables	diabetic neuropathy	0
clathrotropis	periorbital headache	0
morel	chronic b-cell leukemia	0
density foods	basal cell epithelioma	0
seven nutrients	deep-venous thrombosis	0
common olive trees	jacksonian seizure	0
fresh meat	sciatic neuralgia	0
flower	human t cell lymphotropic virus type iii	0
almond trees	birth defect	0
tobacco	complications of diabetes mellitus	0
pork	chronic b lymphocytic leukemia	1
croaker	renal failure	0
bottled water	cot death	0
nuclear power plants	parietal region trauma	0
flammulina	nervous system degenerative diseases	0
brain-invasive pork	premenstrual syndrome	0
illicium verum	tonic seizures	0
placenta	autosomal dominant parkinsonism	0
yellow vegetables	dysfunction	0
rooibos tea	infant obesity	0
frozen fruit	oral neoplasm	0
true nut	atrioventricular dissociation	0
nuclear power plant	sleep initiation dysfunction	0
alcohol	inhibit cancer	0
black sapote	penis cancer	0
atropa belladonnas	disrupted in b-cell malignancy	0
happy meal	nanism	0
fatty foods	infant obesity	0
fungus	acute cerebrovascular accidents	0
norovirus food	todds paralysis	0
split peas	myalgic encephalomyelitis	0
preserved foods	pancreatic neoplasms	0
citrus grandis	dermatosis	0
fragaria vesca	juvenile-onset diabetes	0
ocimum basilicums	cardiovascular conditions	0
higher vegetable	childhood onset obesity	0
food supplementations	hypovolemic shock	0
food additives	acidose	0
carbonated waters	crushing skull injury	0
dried foods	cysticercosis	0
mentha piperita	myocardial ischemia	0
thymus vulgaris	intermediate grade lymphoma	0
taking vitamin	paludism	0
fenugreek seeds	rupture	0
sweet peppers	increased cancer	0
food allergy	human t lymphotropic virus type iii	0
high-fiber food	lav-htlv-iii	0
solanum laciniatums	chicken viruses	0
bertholletia	toxic megacolon	0
marjoram plant	amnestic states	0
ready soybeans	early-onset parkinsonism	0
açai berry	static tremor	0
psyllium	premenstrual syndromes	0
drug administration united states food	human papilloma viruses	0
plantago arenaria	skin neoplasms	0
mango	rectal neoplasm	0
artichoke	acute inflammatory polyneuropathies	0
frozen spinach	bruise	0
linum usitatissimum	chronic fatigue syndromes	0
poultry products	b cell leukemia	0
raphanus sativus	forehead trauma	0
fava beans	colitide	0
healthier foods	auto-immune diseases	0
pimenta officinalis	amentia	0
vaccinium ashei	breast diseases	0
sugary foods	anemia	0
individual food	iritide	0
apple trees	neoplasm metastasis	0
mushroom	infectious virus	0
low-sodium diet	small cleaved cell lymphoma	0
white meat	cervical migraine syndrome	0
eggplant	aphthous stomatitides	0
beta vulgari	pancreas neoplasms	0
chickpea	small noncleaved-cell lymphomas	0
amorpha	familial atrial fibrillations	0
cocoa powder	papillary meningiomas	0
shoot	gale deficiencies	0
plant arils	cancer of brain	0
apium graveolens	male pattern baldness	0
portulaca oleracea	texidor twinge	0
molasses	cataract	0
kola nut	headache syndromes	0
chia seeds	cerebral strokes	0
antioxidant vitamin	massive tremors	0
eating eggs	abdominal aortic aneurysms	0
chicken	alzheimer’s disease	0
pureed apples	semantic memory disorder	0
infant formulas	unilateral headache	0
black beans	anaplastic carcinoma	0
chewing fruit	germinoblastic sarcoma	0
indian laburnum	memory loss	0
nonfat meal	fibrous meningioma	0
dress	b cell chronic lymphocytic leukemia	0
specific nuts	ekbom delusional parasitoses	0
ribes nigrum	cancer of penis	0
pepper	renal cancer	0
assai palm	mammary cancers	0
tempeh	intention tremors	0
coleslaw	effort syncope	0
rhubarb	syncopal vertigo	0
thymus plant	rectal tumors	0
texturized soy proteins	low grade lymphoma	0
sour orange trees	fibrocystic changes of breast	0
bean sprout	cardiac diseases	0
wheat bran	tonic-clonic seizures	0
spinacia oleracea	social phobia	0
inadequate fruit	syncopal vertigo	0
daucus carota	non-hodgkins lymphoma	0
cynara scolymus	cysticercose	0
granny smith	non-b hepatitis epidemic non-a	0
cruciferous vegetable	drug habituation	0
celebration meal	peripheral demyelinating autoimmune disease	0
althaea officinalis	marie-struempell disease	0
cassia tree	manic disorders	0
abelmoschus	feline leukemia virus	0
ribe	lung cancer	0
apium graveolens var. rapaceum	progressive disorder	0
aspalathus linearis	uterine cervical neoplasm	0
callerya	neurocysticercosis	0
food poisonings	malignancy	0
individual candy	a-v dissociations	0
eugenia aromatica	ankylosing spondylarthritis	0
fresh ginger	secretory meningiomas	0
dragon fruit	tubal abortions	0
whole grain	back ache	0
potassium-rich foods	sexual dysfunction	0
tea plant	eczematous dermatitides	0
healthiest beverage	gingivitis	0
fruit-shaped marshmallows	age related macular degeneration	0
drink tea	vitamin deficiencies	0
blueberry plant	apnea	0
poenumgraecum	congenital hypothyroidism	0
alpine strawberries	visceral steatoses	0
citron trees	periorbital headache	0
fat foods	pyrexia	0
frosting	brain vascular accidents	0
shiitake	body weights	0
milk	irritable colon	0
sweetening agents	guillaine-barre syndrome	0
collard greens	cattle leukemia virus	0
potato	hyperpigmentation	0
diabetic diets	central obesities	0
dioscorea polystachya	early onset parkinson disease autosomal recessive	0
garcinia mangostanas	fights cancer	0
glucose fructose syrup	circulatory failure	0
wild yam	renal calculus	0
cycad	pattern baldness	0
sweet almonds	cognitive declines	0
eupatorium rebaudianums	social phobia	0
berberis	brain vascular accident	0
diospyro	prostatic adenoma	0
hazelnut	heatstroke	0
solanum	vulva cancer	0
smoked food	hepatitide	0
chinese cinnamons	intervertebral disk degeneration	0
bibhitaki fruit	mouth cancers	0
curried tofu	marsh fever	0
human milk	mastodynia	0
cucumber	nonalcoholic fatty livers	0
plum	cephalalgia	0
fat milk	single seizures	0
cucumis melos	left-sided heart failure	0
java plum trees	cardiac arrhythmia	0
citrus x paradisi	amyloid plaques	0
no coffee	alopecia cicatrisata	0
golden delicious apples	colorectal carcinoma	0
trace element	bewilderment	0
caffeinated coffee	female pattern baldness	0
citron tree	senile tremors	0
cola nitida	passive tremor	0
trace minerals	diffuse well-differentiated lymphocytic lymphoma	0
peppermint oil	neurodegenerative disease	0
malabar nut	bovine leukoses	0
pea family	blood clots	0
cuminum cyminums	thermal hypesthesia	0
cacao	precordial catch syndrome	0
sweet basil	psoriasis	0
bergamot	malaria	0
sugar	cholera	0
dark chocolate	bovine leukosis	0
cicer	halitose	0
cannabis	carcinomatosis	0
fenugreek seed	chronic fatigue disorder	0
chilli peppers	forehead trauma	0
potato chips	female sub fertility	0
chewed coca	bse (bovine spongiform encephalopathy)	0
prunus salicinas	enzootic bovine leukoses	0
cookie	reticulum-cell sarcoma	0
english walnuts	malaria	0
curcuma zedoaria	kill cancer	0
hemp plants	retained surgical instruments	0
sustenance	frontal region traumas	0
zea	high blood pressures	0
pimenta diocias	deep vein thromboses	0
mayo	lightheadedness	0
foeniculum vulgare	salmonella infection	0
mentha x piperita	spatial memory disorders	0
drink	sleep initiation dysfunction	0
lavandula	skin rash	0
contaminated meat	drug use disorder	0
fagopyrum sagittatum	virus disease	0
marjoram plants	disk degeneration	0
rutabaga	age-related maculopathies	0
fruit juice	sid	0
medicago sativa	torsion fractures	0
consumed chocolate	heart disease	0
cruciferous foods	cjd (creutzfeldt jakob disease)	0
broad beans	regional enteritis	0
restrict food	influenza in human	0
safflower oils	muscular spasms	0
pimpinella	familial tremor	0
mock meats	feline lymphoma viruses	0
punicaceae	serious disease	0
anana	idiopathic intracranial hypertension	0
mother cell	somatotropin (acromegaly) hypersecretion syndrome	0
steamer	back aches	0
ilex paraguarienses	fusiform aneurysm	0
sugar maple	bipolar disorders	0
little meat	massive tremors	0
papaver somniferum	anoxia	0
cardamom	primary malignant brain tumors	0
porgy	rectal cancer	0
almond	dental diseases	0
exotic fruits	testis cancer	0
high fructose corn syrup	vulvar neoplasms	0
black walnut	pulmonary cancers	0
cassia trees	creutzfeldt-jakob disease	0
group foods	cancer of the breast	0
sockeye salmon	polyradiculoneuritis	0
boiled broccoli	male infertility	0
meal time	disk degeneration	0
lipomul	fighting cancer	0
foxglove	cramp	0
honey	asymmetric diabetic proximal motor neuropathy	0
cappari	celiac sprue	0
soft drink	bacterial vaginosis	0
cocoa plant	milk sugar intolerance	0
nicotiana	prediabete	0
maize oil	primary fibromyalgias	0
pistil	artery disease	0
yerba mates	non-b hepatitis enterically-transmitted non-a	0
foeniculum	male sterility	0
cocoa butter	gorlin-goltz syndrome	0
american meat	fight cancer	0
humulus	chronic cluster headaches	0
purple rice	jaundice	0
kiwi fruit	trochanteric fractures	0
eden foods	prostatic intraepithelial neoplasia	0
crowberry	lymphatic sarcomas	0
gmo soybeans	contagious ecthyma	0
beverage	prostatic cancers	0
cherry	meningiomatose	0
yolk	flatulence	0
dietary sucrose	tonsil cancers	0
diospyros digyna	a-v dissociations	0
dried apples	low back pains	0
baby formula	voice box cancer	0
foodstuff	ciguatera fish poisonings	0
black currants	neoplasia	0
taraxacum officinale	type 1 diabetes mellitus	0
eat flax	delusional parasitoses	0
chamomile oil	hiatal hernia	0
apricot tree	insulin dependent diabetes mellitus	0
brewage	intervertebral disc degenerations	0
rye	amyloid plaques	0
junk food	cerebral convexity meningioma	0
opium poppy	thyroid disorders	0
dietary fiber	thyroid carcinomas	0
euterpe oleracea mart.s	familial guillain-barre syndrome	0
fennel	manic-depressive psychosis	0
maraschino cherry	low back ache	0
cayenne pepper	hiatal hernias	0
red lentils	carcinogenese	0
chocolate pudding	rete testis tumor	0
dairy product	pernicious vomiting of pregnancy	0
phaseolus vulgari	spinal cord diseases	0
include fennel	bone cancer	0
handling meat	lymphocytic lymphoma	0
java plum tree	todd paralysis	0
steak	jaundice	0
kidney bean	peripheral autoimmune demyelinating disease	0
pyrus	joint disease	0
plantain	prion protein disease	0
dietary supplementations	polymyositis	0
calendula officinali	drop attacks	0
zea mays	thyroid adenomas	0
apple juice	disc degradations	0
dietary soybean proteins	spinal cord disorders	0
yeast rice	lens opacity	0
cranberry	delusional parasitosis	0
red tea	cancer viruses	0
undercooked meat	e b virus	0
cranberry juice	amyloid deposit	0
wisconsin milk	microcephaly	0
chili pepper	olfactory groove meningioma	0
leaf lettuce	mouth cancer	0
caper	food hypersensitivities	0
pizza	liver neoplasms	0
cow's milk	elevated cholesterols	0
mustard plants	proteinuria	0
carduus marianus	aphthae	0
bran flakes	ekbom dermatozoic delusion	0
jelly beans	udpglucose hexose 1 phosphate uridylyltransferase deficiency	0
acer negundos	hepatitis e	0
brassica	parodontose	0
english plantain	wheat allergies	0
roasted almonds	lead poisoning	0
chinese yams	circulatory failure	0
cantaloupe	corpse	0
solanum dulcamara	urinary bladder diseases	0
sesame seeds	v cjd (variant creutzfeldt jakob disease)	0
taraxacum	pulmonary thromboembolisms	0
pleurotus	short sleep phenotype	0
soy foods	determination of death	0
okra	bacterial infections	0
drinking coffee	eye disease	0
fagopyrum tataricum	seasickness	0
ocimum sanctum	retained surgical items	0
pecan tree	menstrual pain	0
allium porrum	death	0
natto	bses (bovine spongiform encephalopathy)	0
baked potato	sudden cardiac death	0
daily fruit	cancer of the bladder	0
turkey meat	congenital hypothyroidism	0
domestic fowl	skin rash	0
maguey	uterine cervical cancer	0
kohlrabi	precordial catch	0
dried food	influenza in humans	0
cayenne	manic-depressive psychoses	0
measuring food	cardiogenic syncope	0
vinegar	back pain without radiation	0
bean	peripheral arterial diseases	0
brinjal	nonhodgkin lymphoma	0
fava bean	non-epileptic convulsions	0
raphanus raphanistrum	carcinogenese	0
wild yams	mouth cancer	0
raisin	malignant neoplasm of breast	1
grape juice	strain	0
nonus	communicable diseases	0
salmonella-infected eggs	endometriosis	0
jalapeno	osteoporose	0
english walnut	visual seizure	0
mirobalanus embilica	et-nanbh	0
food companies	deep vein thromboses	0
emblica officinalis	small noncleaved-cell lymphomas	0
psidium guajavas	bilateral headache	0
eating meat	leiomyoma	0
orange trees	mammary dysplasia	0
swordfish	premenstrual tension	0
cod	hiccup	0
colocasia	gluten-sensitive enteropathies	0
rosehip	social anhedonia	0
rye bread	cerebrovascular accidents	0
elephant garlic	cognitive retention disorders	0
deli meat	hansen's disease	0
cereal	galk deficiencies	0
chestnut	fibrocystic breast disease	0
ovary	papillary meningiomas	0
herr	metabolic acidoses	0
healthiest apple	brains cancer	0
areca catechus	rickets	0
crataegus monogyna	apoplexy	0
citrus aurantiifolia	arthrosis	0
white pepper	breast adenosis	0
bean sprouts	inflammatory bowel disease	0
caryophyllus	retained surgical tools	0
mashed potatoes	liver injury	0
milk chocolate	precordial catch	0
purple cabbage	congenital abnormalities	0
green peppers	non alcoholic fatty liver disease	0
unrefined plant	juvenile-onset diabetes mellitus	0
collard	reproductive sterility	0
cuminum cyminum	food-borne disease	0
japanese plum	animal virus	0
lemon balm	sinusitide	0
new vitamin	utp hexose 1 phosphate uridylyltransferase deficiency disease	0
mastictree	occipital traumas	0
star anises	bleed	0
nettle tea	polyradiculoneuritis	0
smoked foods	human mammary carcinoma	0
dinner	psychogenic parasitoses	0
agave	kidney cancers	0
eating food	nerve tremors	0
paprika	growth hormone receptor deficiency	0
kawa kawa	alopecia cicatrisata	0
mother cells	chronic gum disease	0
coco	fifth phacomatosis	0
cinnamomum trees	penis cancer	0
soy sauce	food hypersensitivities	0
ready-to-eat meal	rectal neoplasm	0
sugar water	carcinogenese	0
citrus sinensis	stroke	0
mangiferas	jakob-creutzfeldt disease	0
octopus	pyrexia	0
garcinia mangostana	crohn's disease	0
osmanthus tea	male infertility	0
chanterelle	global amnesias	0
cucumis sativus	paralysis agitans	0
almond milk	heatstroke	0
rooibos	udp-galactose-4-epimerase deficiency	0
grecian foxgloves	action tremor	0
nightshade	fibromyalgia-fibromyositis syndromes	0
ginger ale	pleomorphic lymphoma	0
ephedras	baldness	0
toxic plant	tick bites	0
afzelia	eye disease	0
regular olive	utp hexose 1 phosphate uridylyltransferase deficiency disease	0
dog rose	bovine lymphosarcoma	0
hickory nut	galactose-1-phosphate uridyltransferase deficiency	0
woodland strawberries	multiple myositides	0
health nuts	anal ulcer	0
pistachio nut trees	thyroid neoplasm	0
food manufacturers	colorectal carcinomas	0
flavourer	penis cancer	0