
dietary plant proteins	todd paralysis
french bean plant	variant creutzfeldt-jakob disease
mustard greens	status migrainosus
tea	cysticercose
dark meat	cervical migraine syndromes
citrus grandis	obesity in childhood
saffron crocus	meningotheliomatous meningioma
acer negundo	bovine leukemia virus
breast milks	neurocysticercosis
mint tea	diabetic neuropathies
woodland strawberries	terminal ileitis
shiitake mushroom	melanoma
specific cheeses	pustulosis palmaris et plantaris
boiled broccoli	premature aging
vegetarianism	male sexual impotence
hemlock	anaplastic carcinoma
triticum spelta	leanness
deli meat	acidose
berberi	acquired immunodeficiency syndrome virus
asparagus	stomach ulcers
wine	tussive syncope
capparis	vestibular seizure
solanum laciniatums	mixed lymphocytic-histiocytic lymphomas
pithecolobium	water borne hepatitis
density foods	palmoplantaris pustulosis
indian corn	polyarthritis
vaccinium corymbosum	spondylitis ankylopoietica
artificial butter	psoriasis
baby carrots	spinal cord disorders
food allergies	chronic b-cell leukemias
vaccinium bracteatum	johne disease
red meat	rectal cancers
cider	autoimmune disorders
parsley	intermediate-grade lymphoma
punica granatums	schilling type myeloid leukemia
sweetening agent	hiatus hernia
cucumis melos	male subfertility
french bean plants	seizure disorder
apium graveolens var. rapaceum	lymphosarcoma
zinger tea	impotence
grapefruit juice	ulcerative colitis type inflammatory bowel disease
healthy fruit	gingivitis
prunus cerasifera	familial tremor
lunchtime	age-related bone loss
glucose-fructose syrup	delusory parasitosis
moose meat	temporal region traumas
organic plants	royal free disease
sweetleaf	intermediate grade lymphoma
avenas	amyloidose
fragaria	numbness
brown rice	epileptic seizures
national pork	paraesophageal hernia
citrus fruit	nevoid basal cell carcinoma syndrome
decrease meat	communicable disease
amlas	ciguatera fish poisonings
soy bean proteins	inflammatory bowel disease
euterpe precatoria	dehydration
chili	generalized seizure
high-fructose corn	back pains
exotic fruit	breast cystic diseases
dietary sucrose	familial tremor
potassium-rich foods	orthostasis
orange trees	substance use disorders
cold-steeping tea	bladder tumor
chili pepper	human influenza
nicotiana tabacum	chronic cluster headache
brassica juncea	elevated cholesterol
marihuana	benign meningiomas
ultra-processed foods	developed cancer
beta vulgaris	nonalcoholic steatohepatitis
cocoa powders	intracranial neoplasms
spinacia oleracea	migratory pain
artificially-flavored corn	cancer of breast
ground ginger	fibromyoma
peppermint	intention tremor
marjoram	autosomal recessive juvenile parkinson disease
purple potatoes	halitose
plantago psyllium	heat stroke
orange juice	ductal carcinoma
tempeh	sid
isoglucose	huntington’s disease
sour cream	gustatory seizure
food additive	microcephaly
hydroponic basil	tumor
legume pod	gall bladder diseases
cereal grain	tumor
agent orange	carcinogenic retroviruses
persea americanas	head pains
pear	developed cancer
pinto beans	hypoxemia
oyster mushroom	kidney stone
jambolan plum tree	endocrine breast disease
purple grape	chronic cystic mastitis
root	paraesophageal hiatal hernias
specific foods	progressive disorder
reason food	joint diseases
salami	peripheral demyelinating autoimmune disease
vaccinium ashei	breast tumors
porgy	growth hormone receptor defect
andira	meningiomatose
mandarin orange tree	infantile autism
cymbopogon	legal blindness
banana plant	cancer of bladder
zingiber officinale	foodborne botulism
digitalis purpurea	mixed lymphocytic-histiocytic lymphomas
coffee	migraine disorder
wild yam	oxygen deficiencies
whole grain cereal	ileocolitis
fenugreek seed	transmissible dementia
empty calorie foods	syndrome
solanum tuberosums	small lymphocytic lymphoma
prunus salicina	orthostasis
euterpe oleracea	central nervous system intracranial disorders
box elders	cerebrovascular strokes
soy sauce	ischemia
fiddlehead ferns	peripheral arterial diseases
avena	amnesia-memory losses
pea	fibromyalgia
vegetable juices	intracranial cns disorders
butternut squash	dims (disorders of initiating and maintaining sleep)
cured meat	anaplastic carcinomas
almond oil	creutzfeldt jakob disease
toronja	jakob-creutzfeldt disease
assai palms	age-related osteoporoses
so-called vegetable	bacterial vaginosis
thymus vulgaris	ankylosing spondyloarthritis
açaí berries	visceral obesity
incorporate cloves	lung cancers
dripping	brain disease
sweet almond	metabolic acidoses
sea vegetable	peripheral autoimmune demyelinating disease
plant zygote	urticaria
apricot tree	neoplasm metastases
drinking orange	posterior compartment low back pain
california avocado	peripheral arterial diseases
mentha spicata	chronic gum disease
include fennel	ovary cancer
brewed coffee	lobar pneumonias
fresh fruits	lung diseases
handling meat	rectal cancers
golden delicious apples	ankylosing spondylarthritides
black sapote	bipolar affective psychosis
pimenta officinali	rectum cancer
alcoholic beverages	halitosis
tea plant	esophagus cancer
maize oils	vagina neoplasm
jalapeno peppers	lactose intolerance
swiss chard	primary brain tumors
frying meat	coronary disease
whortleberry	hhv-4
chilli pepper	myelopathy
entree	atrophy
saint johnswort	rectal cancer
healthiest foods	et-nanbh
antioxidant fruits	ruptured appendicitis
prunus salicinas	coronary heart diseases
vinegar	bacterial infections
phyllanthus emblicas	cryptogenic epilepsies
horse bean	fibrocystic disease of breast
mustard seeds	stomach cancer
agave	cancer of the rectum
gmo soybeans	histamine cephalgias
aquatic food	monocytic leukemia
cod	johne disease
java plum tree	bladder neoplasms
rose	fibrous meningioma
allium cepa	familial atrial fibrillation
rosa	diffuse well-differentiated lymphocytic lymphoma
nutmeg	regional enteritis
milk thistle	arrythmia
whipped cream	dysmenorrhea
hibiscus tea	rna tumor virus
pimenta diocia	ovarian cancer
marijuana	leukemia virus
common bean plant	chronic fatigue syndromes
walnut oil	tongue neoplasm
clathrotropis	human mammary carcinomas
pie	emphysema
american meat	human influenza
include apples	hypermelanosis
healthy snacks	familial atrial fibrillations
bellis	vulvar neoplasm
different seed	early detection of cancer
ice cream	ileocolitis
avena sativa	lactose intolerance
chia seeds	massive tremor
neutraceutical	nonalcoholic fatty liver disease
molasse	autoimmune diabetes
basil	lymphoblastic leukemia
antioxidant-rich food	lymphadenopathy-associated viruses
kombucha teas	thyroid neoplasms
flavoring	human t cell leukemia virus type iii
margarine	lou gehrig's disease
cynara scolymus	symptom cluster
rheum	meningotheliomatous meningiomas
citrus aurantiifolias	cadaver
buckwheat	germinoblastic sarcomas
poultry meat	breast cystic disease
calendula	amyloid deposits
eat flax	semantic memory disorder
jell-o	inappropriate gh secretion syndrome (acromegaly)
chicken	stomach ulcer
musa	pill rolling tremors
texturized vegetable protein	diffuse small cleaved-cell lymphoma
avocado fruit	muscle pain
component spices	colorectal carcinomas
sorrel	chronic fatigue-fibromyalgia syndrome
pimpinella anisums	degenerative intervertebral disks
anacardium	chronic fatigue and immune dysfunction syndrome
corn oil	ocular headaches
liquorice	human immunodeficiency virus
vicia faba	familial atrial fibrillation
trigonella foenum graecum	rodent ulcers
justicia	male sub fertility
cuminum	brain disease
eupatorium rebaudianum	myelomatosis
cannabi	reverse cancer
jelly	congenital abnormality
abelmoschus esculentus	obesity in childhood
garlic	migraine headaches
caffeinated coffee	tumor virus
oregano	aphthous ulcer
baptisia	rectum neoplasm
ready-prepared foods	mastodynia
whole grains	galactose 1 phosphate uridyl transferase deficiency disease
spore	chronic infectious mononucleosis-like syndrome
food allergy	familial dementia
citrus	ekbom dermatozoic delusion
calendula officinalis	syncope
regular olive	sinusitis
pineapple	deep vein thromboses
mock meats	fibrous meningiomas
soya milk	foodborne botulism
thymus plants	reduced sensations
indian gooseberries	diffuse mixed-cell lymphomas
horsenettle	experimental parkinsonism
cacao bean	tonsil cancers
illicium anisatums	deep venous thromboses
citron tree	experimental parkinson disease
pecan trees	amyotrophic lateral sclerosis parkinsonism dementia complex 1
triticum aestivum	pulmonary embolism
actual licorice	pyrosis
uncooked food	cervix neoplasms
marshmallow	retained surgical needles
sea bilberry	mammary cancer
chewing gums	b-cell chronic lymphocytic leukemia
beta vulgari	contagious pustular dermatitides
red delicious apples	deep venous thromboses
glycyrrhiza glabra	cow disease
decaf	plasma-cell myeloma
food manufacturers	sinusitis
acai berries	insulin sensitivity
antioxidant food	age related memory disorders
pumpkin pie	physical sufferings
norovirus food	barretts syndrome
citrus fruits	polyradiculoneuropathy
almond	hormonal dysfunction
actual fruit	somatosensory seizures
infects apples	gluten enteropathies
fruit and vegetable juices	pulmonary thromboembolisms
lens culinari	action tremors
seven nutrients	semirhythmic tremor
tea hibiscus	fissure in ano
cycad	hypercapnia
frozen cranberries	auditory seizure
afzelia	exanthem
kidney bean	inflammatory demyelinating polyneuropathy
cuminum cyminums	endometrial neoplasm
ready soybeans	age related maculopathies
eugenia jambolana	retained surgical sponge
saccharomyces cerevisiae	severe mental disorders
eugenia cumini	complications of diabetes mellitus
celery	kidney disease
high fructose corn syrup	kidney insufficiency
lard	small non cleaved cell lymphoma
cicer arietinums	sliding hiatal hernia
peppermint oil	age related macular degeneration
english walnut	alopecia cicatrisatas
brown sugar	dairy product intolerance
hot pepper	galactokinase deficiency
espresso	gerd
pistachio	lower back pain
mentha piperita	scurvy
yam	non hodgkin lymphoma
new york coalition for healthy school food	cancer of the rectum
green lentils	bipolar affective psychoses
oregano plants	symptom cluster
pimpinella	right sided heart failure
sesame oil	darkness tremors
pistacia	cancer of the stomach
chard	penis cancers
pumpkin seeds	creutzfeldt jacob disease
mastictree	grave’s disease
baby spinach	allergy
golden delicious	myalgic encephalomyelitis
açaí berry	eczema
paprika	sliding esophageal hernias
petroselinum crispums	cancer of cervix
ephedra	irritable bowel syndromes
rabbit meat	influenza in humans
citron trees	malignant primary brain neoplasms
kiwi fruits	neuritic plaque
pimenta	anal ulcers
origanum onites	virus disease
fagopyrum sagittatum	mechanical low back pain
dried yeast	undifferentiated carcinoma
bread mold	disc degeneration
monitoring food	multiple sclerosis
vegetable oil	colon neoplasm
sun-dried raisin	food hypersensitivities
prunus armeniaca	convulsive syncope
white meat	intraventricular meningioma
eragrostus	flatus
seville orange trees	breast malignant neoplasm
retail poultry	social phobias
capsicum annuum	oral cancers
brazil nuts	lead poisoning
cinnamomum cassia	chronic infectious mononucleosis like syndrome
turmeric root	parkinsonian disorders
marsh mallows	spatial memory disorders
shoot	galactosemia 3
bitter nightshade	leprosy
bertholletia excelsas	cancer of pancreas
caramel	gall bladder diseases
processed apples	episodic cluster headache
eat chocolate	hyperemesis gravidarum
gooseberry	spindle cell sarcomas
illicium anisatum	cervicitis
molasses	dental plaque
pimpinella anisum	central nervous system degenerative diseases
flowering shrub	leukovirus
english plantains	cough
chile peppers	migraine variant
foodstuff	craniocerebral injury
frying foods	somatotropin hypersecretion syndromes (acromegaly)
aubergine	e-b virus
bok choy	cysticercosis
pepper	age related memory disorders
malabar-nut	rest tremor
humulus lupulus	postoperative emesis
table sugar	lung disorders
teff	pyrexia
durum wheat	subtrochanteric fractures
ceratonia	malignant brain neoplasms
noncaloric sweetener	polyp
ganja	acquired immuno-deficiency syndrome
processed food	testicular tumors
cocktail	ovarian cancers
hibiscus	spiral fracture
dairy eggs	carcinoma in situ
brassica nigra	gastric acid reflux disease
fagopyrum tataricum	vulvar neoplasm
calling eggs	igf-1 deficiency
syzygium jambos	alcoholism
spice saffron	cancer of endometrium
plant kingdom	cat leukemia viruses
low-salt diet	chicken embryo lethal orphan virus
syzygium sandwicense	familial guillain-barre syndrome
wheat brans	lumbago
soda pops	infantile autism
mastic trees	senile tremors
cooked meat	recurrent low back pain
pepsi	pyrose
ranking foods	minor head injury
suggesting fruit	postpartum sterility
supper	viral disease
coca cola	effort syncopes
consumer protection scientific committee on food	brain disorder
favorite meals	dental fluorosis
smoked food	fibrous meningioma
sugar substitute	juvenile parkinsonism
tv dinners	myelomatose
mangifera	lyme borreliosis
euchresta	psoriasis
turmeric	kidney cancers
celebration meal	body weights
bolete	malignant neoplasm of breast
dietary soybean proteins	new variant creutzfeldt jakob disease
black teas	leucocythaemia
cabbage	gingivitide
rose berries	secondary fibromyalgias
split pea	orthostatic headache
dasheen	brain diseases
no coffee	bipolar affective psychosis
prunus domestica	acute monocytic leukemias
horse nettle	eczematous dermatitis
humulus	mental deterioration
brassica napus	salmonellosis
maize syrup	renal insufficiency
plantago arenaria	pruritus
white mallow	basal cell carcinoma
plantago ovata	cancer of the liver
organic food	persistent tremors
syzygium cumini	bovine spongiform encephalopathy
bad foods	carotid sinus syncope
eragrostis	sinusitis
rubus	polyradiculoneuropathy
mashed potatoes	malignant meningioma
drinking coffee	drug use disorders
teosinte	guillain barre syndrome
fried foods	ocular headaches
restructured meat	hyperventilation syncopes
concord grapes	cognitive dysfunctions
cassia trees	pancreas cancer
dietary fibers	penis neoplasm
muffin	ductal carcinomas
exotic fruits	alopecia cicatrisatas
sweet basil	wheat allergies
jasmine tea	galactose epimerase deficiencies
lentinus edodes	social anxiety disorders
bagel	exanthem
garcinia mangostanas	gehrig disease
black currant	numbness
macadamia	galactokinase deficiencies
raw poultry	galactose 1 phosphate uridylyltransferase deficiency
dietary supplement	cancer of uterus
red cabbage	anoxia
wild radish	acute confusional migraines
trigonella foenum-graecum	thyroid neoplasm
psidium	human t-cell lymphotropic virus type iii
lemon balms	age-related macular degenerations
carbonated beverages	early-onset parkinsonism
dragon fruit	low backache
coriander	nervous system degenerative diseases
frier	fatty liver
foie gras	neurodegenerative disorders
fries	guam disease
brewing tea	dysfunction
sweet peppers	iritis
rubus fruticosus	prostate disease
uncooked foods	undifferentiated carcinomas
elettaria cardamomum	abdominal pain
eugenia jambos	polyphagia
capsicum	familial dementias
soy food	oncogenic virus
kenaf	confusional state
pleurotus	dims (disorders of initiating and maintaining sleep)
crab apple	skin rash
meal time	rectal cancer
store licorice	barretts esophagus
piper nigrum	long sleeper syndrome
lycium barbarum	cattle leukemia virus
dairy products	vulva cancers
processed meats	pus
corn syrup	peripheral arterial diseases
carbonated drink	stokes adams syncope
cucumber	cluster headache syndrome
alpine strawberry	head trauma
french fries	membranous cataracts
squash	type c oncovirus
natural vitamin	kidney diseases
fake meat	meningioma
apium graveolens var. dulce	colicky pains
bean	lymphoblastic leukemia
banana	stokes-adams syncopes
bergamot	manic-depressive psychosis
so-called meat	aphthous ulcers
club sodas	soft tissue sarcomas
carrot juice	cognitive impairment
zedoary zedoarias	rheumatoid spondylitis
hemp plants	fibromyalgia-fibromyositis syndromes
cicer arietinum	uterine fibroma
floret	tick bites
syzygium jambolanum	amnesia-memory losses
romaine	breast pain
saint john's wort	spindle cell sarcomas
green peas	male pattern baldness
halibut	bovine leukoses
cayenne peppers	malignant tumor of breast
lens plants	pituitary dwarfism iis
aspalathus linearis	nausea
andropogon nardus	age-related memory disorder
human milk	barretts esophagus
healthiest vegetable	suppuration
crataegus monogynas	rete testis tumor
prosopis	aphthous ulcer
overpriced vitamin	prostatic intraepithelial neoplasia
curcuma longas	central nervous system intracranial disorders
bamboo shoots	insulin dependent diabetes mellitus 1
bell peppers	udpglucose 4 epimerase deficiency disease
food pyramid	nevoid basal cell carcinoma syndrome
snacktime	feline lymphoma virus
dried foods	thyroid disorders
solanum dulcamara	hemorrhage
apricot trees	high cholesterol levels
triticum durum	auricular fibrillations
sprout	craniocerebral injuries
snail meat	mental deterioration
cassia fistula	massive tremor
kiwi fruit	oncornavirus
willow tree	psoriase
chickpea	pernicious vomiting of pregnancy
ephedras	air sickness
suggesting apple	cjd (creutzfeldt jakob disease)
meal	gluten enteropathies
althaea officinalis	continuous tremor
cola nitida	inflammatory disorder
wheatgrass	human mammary carcinoma
ready prepared foods	metastatic cancer
peach tree	trochanteric fractures
gluten	cephalgia syndrome
sunchoke	monoblastic leukemia
chinese food	respiratory tract infections
kavas	basal cell carcinomas
areca catechu	cancer of ovary
beef	nausea
squash seeds	paludism
citrus maxima	lymphocytic lymphomas
prosopi	marsh fever
pomegranate	congenital hypothyroidism
smoked foods	pulmonary disorder
chinese cinnamon	growth hormone receptor defect
beet	chronic obstructive lung disease
horse nettles	subacute spongiform encephalopathies
beer	protein deficiency
rose hips	diabetic amyotrophies
milk	brain vascular accident
pancake	low backache
nightshade	human mammary carcinomas
linum usitatissimums	insulin deficiency
soy proteins	food borne illnesses
dog rose	oral cancer
carya illinoensis	complete hearing loss
common plant	human mammary neoplasms
eating food	autoimmune diabetes
dietary fiber	male sexual impotence
coriandrum	atypical cluster headache
healthy foods	oral neoplasms
areca	cancer of the vagina
organ	bipolar affective psychoses
official vitamin	contagious ecthyma
baby formulas	virus infections
radish	cardiovascular stroke
chai tea	vertiginous seizures
hop	fibroid
oatmeal	tubal abortions
citrus hystrix	lymphadenopathy-associated virus
liquor	biliary calculi
hibiscus sabdariffa	brain disease
cruciferous foods	acute coryza
green grapes	chicken virus
mint	cancer of uterus
edible grains	diffuse mixed-cell lymphomas
cultivated radish	male pattern baldness
tuna fish	acute cerebrovascular accidents
portulaca oleracae	bladder disease
maraschino cherry	neuritic plaque
silybum marianum	testis neoplasms
fenugreek	monocular blindness
chestnut	endometriosis
collard greens	severe gh insensitivity
lentil	uterine fibroids
amaranth	hypermelanosis
healthy snack	polyradiculoneuritis
red tea	hemangioblastic meningioma
including cloves	lymphoma
indian laburnum	colitis gravis
sockeye salmon	basal cell epithelioma
abelmoschus	brain tumors
lucerne	zoonotic diseases
red yeast rice	age-related macular degeneration
maple syrup	todd paralysis
gala apples	leukovirus
vicia fabas	tumor virus
elettaria cardamomums	pediatric obesity
junk food	cancer of the colon
jelly beans	pleomorphic lymphoma
celeriac	cancer of ovary
organic meat	impaired sensation
dandelion	cancer of the tongue
extracted fruit	complete hearing loss
acid-binding vegetables	cancer of skin
eugenia malaccensis	delusory parasitoses
poultry products	esophageal hernias
safflower oil	hair loss
anise	psychogenic parasitosis
psyllium	pulmonary diseases
lipomul	intraventricular meningiomas
mirobalanus embilicas	viral hepatitis
sour fruit	multiple meningioma
grape	benign intracranial hypertension
toxic plant	prevent and reverse heart disease
frosting	occipital region trauma
hypericum perforatum	guam form of amyotrophic lateral sclerosis
ready-to-eat meals	guillaine-barre syndrome
purple rice	degenerative arthritides
rosemary	widespread chronic pain
baked potato	schizophreniform disorders
sugar substitutes	endometriose
raw alfalfa	malaria
glycine max	diffuse lymphocytic lymphoma
cinnamon	atherosclerotic plaque
hordeum	cancer of the colon
bran flakes	gastric acid reflux disease
bottled water	pulmonary embolisms
miso	tick bite
dried cranberries	impaired sensation
brewage	pulmonary inflammations
arachis hypogaea	johne's disease
vital nutrients	vertiginous seizure
frozen fruit	fibromyositis-fibromyalgia syndromes
portulaca oleracea	spontaneous abortions
dioscorea polystachya	texidor's twinge
curcuma	gustatory seizures
junk foods	anal ulcer
black coffee	cancer of the ovary
punicaceae	disorder
opium poppies	diabetic neuropathies
purple cabbage	campylobacter infections
black pepper	tying disease
lima beans	htlv-iii
lunch times	diffuse well-differentiated lymphocytic lymphoma
elettaria	somatosensory seizure
nicotiana tabacums	thyroid diseases
brussels sprouts	stroke
nettle tea	syncopal episode
citrus sinenses	sprue
blackberry	gastric acid reflux
coriandrum sativum	endometrial carcinoma
measuring food	halitosis
lactuca sativa	peanut allergy
diospyro	long sleeper syndromes
haritaki fruit	tumor of rete testis
taraxacum	esophagitis
baby formula	abdominal obesities
green teas	different cancer
pomelo tree	breast dysplasia
rubus glaucus	frontal region traumas
fast foods	open head injuries
cucurbita	pulmonary diseases
flax seed	acquired deafness
soy foods	convulsive syncope
ananas	epstein-barr virus
black raspberries	age related memory disorders
irritable bowel kiwi fruit	pulmonary thromboembolism
high-fiber food	fibrosis
cycad trees	congenital myxedema
sea vegetables	liver cancer
plantago lanceolata	phlebothrombose
justicia adhatoda	hypercholesterolemia
soda water	ekbom delusory parasitoses
fruit juice	smell disorder
cookie	rectal tumor
pineapple juice	familial tremor
anacardium occidentales	massive tremor
tomato sauce	juvenile parkinsonism
brew	galactose-1-phosphate uridyl-transferase deficiency disease
curry	bechterews disease
yellow vegetables	heart decompensation
cucumis sativus	myocardial failure
origanum vulgare	bacterial infection
canned food	drug allergies
melissa officinali	hansens disease
purslane	necrotizing fasciitis
okra	cluster headaches
collard green	human mammary carcinomas
citrus hystrices	sudden cardiac arrests
broth	thrombus
frozen spinach	male sub fertility
coleslaw	vagina cancers
cooked meats	adenovirus
sesame oils	atrophy
mangiferas	variant creutzfeldt jakob disease
garbanzo	gastroesophageal reflux
taro	male breast enlargement
eugenia sandwicensis	leukemia
oxen meat	colon neoplasm
carbonated drinks	basal cell carcinoma
natto	small cleaved cell lymphoma
maize	mixed lymphocytic histiocytic lymphoma
citrus sinensis	impotence
solanum melongenas	myalgic encephalomyelitis
snack foods	prostatic cancer
restrict food	cancer of the vulva
food poisonings	colon neoplasm
recommend tea	granulomatous enteritis
curry powder	prion disease
chinese yam	rodent ulcer
white rice	tonsil neoplasm
healthiest nuts	drug use disorders
milk thistles	bladder cancer
pyrus	pancreas neoplasms
pistacia lentiscus	sterility
serve	terminal cancer
vaccinium uliginosum	intracranial cns disorder
vaccinium angustifolium	degenerative diseases
navy beans	cough
antioxidant foods	schizophreniform disorder
cocoa butter	dyslipoproteinemia
pistil	resting tremor
amygdalus communis	degenerative neurologic diseases
fragaria vesca	uterine fibromas
term vegetable	bipolar depression
healthiest fruits	prostatitis
bilberry	regional ileitis
roundup-ready soybeans	rhabdomyolys
malabar nut	parietal region trauma
curcuma longa	retained surgical tools
dietary proteins	deep-venous thrombosis
chinese yams	infection
persea americana	nonalcoholic fatty liver disease
sparkling water	soft tissue sarcoma
milk protein	mental deterioration
cantaloupe	esophagitis
chenopodium quinoa	near-death experience
cooking meat	well differentiated lymphocytic lymphoma
soup	non b hepatitis epidemic non a
raw garlic	spongiform encephalopathies
solanum lycopersicum	meningotheliomatous meningiomas
monkfish	rest tremors
green beans	low backache
unrefined plant	malignant brain neoplasms
andean blackberry	colorectal tumor
low-calorie diet	diffuse lymphomas
hickory trees	prion-induced disorders
orange tree	mild cognitive impairment
eating almonds	unilateral headaches
arachis	small cleaved-cell lymphoma
eden foods	benign brain neoplasm
squashe	allergic diseases
shan yao	myalgia
century plants	breast carcinoma
high-fat meal	endotoxemia
acer negundos	cervical migraine syndrome
black currants	skin neoplasm
sauerkraut	amaurosis
barley	ovarian cancers
low-fat diet	huntington’s disease
croaker	precordial catch
sesamum	muscle sorenesses
wild celeries	schizophreniform disorder
legume family	gestational diabetes
mango	cat leukemia viruses
orange	bovine lymphoma
nicotiana	neuritic plaque
jambolan plum trees	udp-galactose-4-epimerase deficiency
poenumgraecum	infectious disease
chenopodium quinoas	todd's paralysis
pumpkin	low backaches
goji berries	angioblastic meningiomas
oryza sativa	acute inflammatory polyradiculoneuropathy
leguminosae	cervix neoplasms
solanum melongena	weight loss
sugar maples	memory losses
arginine-rich foods	cysticercosis
caryophyllus aromaticus	megacolon
dietary fat	diverticulitide
healthy food	insulin sensitivity
nuclear power plant	intracranial central nervous system disorders
artificial sweetener	pancreatic cancers
fat milk	breast malignant neoplasm
eating fruits	infertility
red onions	pharyngitis
soft drink	idiopathic polymyositis
bitter nightshades	small non-cleaved-cell lymphoma
euterpe	thyroid adenoma
vitamin	lymphoplasmacytoid lymphoma
sell meat	kanners syndrome
maguey	bilateral deafness
millet	hemolytic uremic syndrome
pomegranate seeds	myeloma multiple
daily fruit	atypical chronic myeloid leukemia
dried blueberries	motor seizures
vaccinium myrtillus	peanut allergy
flaxseed	penile cancer
poppy	severe congenital microcephaly
kava kava	cerebrovascular stroke
olive tree	chronic headaches
thyme	diabetes mellitus complication
secale	posterior fossa meningioma
virgin olive	malignant lymphomas
potato chips	cancer of kidney
phaseolus vulgari	tonic seizure
punica granatum	chronic pains
morinda citrifolias	malignant lymphoma
citrus reticulata	mixed-cell lymphomas
fermented foods	schizophrenia
psidium guajava	seizure disorders
althaea	faint
sticker	dyslipoproteinemia
domestic fowls	oral cancers
brain-invasive pork	t virus
pummelo tree	resting tremors
lamb chops	dizziness
indian laburnums	viral hepatitis
papaya	auditory seizure
commercial milk	infant obesity
treat	chronic fatigue disorders
berry	bladder tumors
citrus reticulatas	terminal cancer
solanum tuberosum	long sleeper syndromes
cured meats	painful menstruation
betel nuts	excess cancer
coriandrum sativums	cancer of the penis
zea	polymyositis ossificans
mesquite	mania
tobacco	coronary heart disease
cherry plum trees	diverticulosis
deep-fry foods	small-cell lymphoma
quinoa	acute confusional migraine
fava beans	nonalcoholic steatohepatitides
coconut	situational syncopes
plantago indica	familial tremors
low fruit	animal virus
flax seeds	confusional states
thymus	campylobacter infections
soybean proteins	mesothelioma
rheum rhaponticum	memory disorder
broccoli	manic disorder
linum	status migrainosus
glucose fructose syrup	progressive disorder
potable water	joint diseases
white tea	cancer of tongue
apple	iron deficiency
banana plants	persistent tremors
chlorella	lymphatic sarcomas
dioscorea	ductal carcinomas
poppy seeds	autistic disorder
flavorer	vertex headaches
watercress	head traumas
caryophyllus	prostatic intraepithelial neoplasm
filtered coffee	age-related bone loss
high-fructose maize syrup	vulvar cancer
steamer	heart decompensation
faba bean	intervertebral disk degeneration
specific nuts	regional ileitides
andean blackberries	bladder diseases
candy bars	orthostatic headache
stryphnodendron	non-alcoholic fatty liver disease
dioscorea batatas	cancer of the uterine cervix
citrus grandi	muscular cramps
international nut	lymphocytic lymphomas
cranberry	heat stroke
mirobalanus embilica	ileocolitis
raphanus	acute infectious polyneuritis
green onions	anal ulcer
marsh mallow	lymphoplasmacytoid lymphoma
white potatoes	chronic daily headaches
white bread	essential tremor
big meals	age-related memory disorder
lavandula angustifolia	basal cell epitheliomas
olea	burkitt lymphoma virus
anana	limb tremors
powdered sugar	mixed lymphocytic histiocytic lymphoma
healthiest beverages	cadaver
alfalfa	respiratory infections
salmonella-infected eggs	muscular rheumatism
foeniculum vulgare	gustatory seizures
star anise	inflammatory disease
eggplant	hiatus hernia
apple tree	burning pains
salmonella food	bses (bovine spongiform encephalopathy)
hazelnut	drug dependence
lemon verbena	mastitis
lycopersicon esculentum	acute infectious polyneuritis
big food	chronic headaches
euterpe edulis	weight losses
sugary foods	congenital myxedema
pea family	malignant epithelial neoplasms
diabetic diet	diffuse undifferentiated lymphomas
wort	acute monoblastic leukemia
red delicious	todd paralysis
pimenta diocias	small non-cleaved-cell lymphoma
yerba mate	cancer of the penis
syzygium malaccense	sprue
breakfast	monoblastic leukemia
bibhitaki fruit	barrett syndrome
butter milk	vaginitis
chervil	diffuse myofascial pain syndrome
dried apples	psychotic disorder
fast food	corpse
cinnamomum verum	acute strokes
fryer	drug allergies
nettle	visual seizure
food supplement	suppuration
kawa kawa	peanut hypersensitivity
chipotle	gastric neoplasm
pimiento	endometrial carcinomas
citrus-based fruits	macular degeneration
anticancer plant	skin cancers
rooibos tea	epstein barr virus
fructose corn	ulcerative colitis
health nuts	head injury
drinking water	polyradiculoneuritis
bitter orange trees	insulin-dependent diabetes mellitus
sour orange trees	rectum neoplasm
deep-fried foods	different cancer
tachigalia	intestinal diseases
glycyrrhiza	penile neoplasm
lemon grasses	disorientation
cranberry sauce	gehrigs disease
citrus bergamias	bacterial vaginitides
laudable legume	dental diseases
cleistocalyx	continuous tremor
holy basils	diabetes complications
cooked broccoli	disorders of initiating and maintaining sleep
juglans nigra	foodborne disease
pummelo trees	arterial fatty streaks
lunch time	thrombosis
msg	liver injury
red wine	nontropical sprue
largest meal	sea sickness
soda pop	chronic cluster headache
faba beans	non-b hepatitis enterically-transmitted non-a
cicer	colorectal neoplasm
assai palm	vulvar neoplasm
convenience foods	textiloma
stem vegetables	mental disorder
tisane	massive tremor
olive	tying disease
acer saccharums	nonspecific vaginitis
mayo	uterine cancers
organic foods	multiple meningioma
mother cell	iron overload
cow's milk	foreign bodies
common fruits	autoimmune disease
gluten-free diet	intervertebral disc degeneration
infant formula	cervical migraine syndrome
hickory nut	paratuberculosis
lycium	genital wart
food additives	memory loss
portulaca oleraceas	neurocysticercosis
spearmint	kidney failures
osmanthus	darkness tremor
phaseolus acutifolius	tonic-clonic seizure
table salt	mild neurocognitive disorders
texturized soy protein	non alcoholic fatty liver disease
squid	regional enteritis
vitis	female subfertility
ocimum tenuiflorum	retro ocular headache
apium graveolens	icterus
whole wheat	fibroatheromatous plaques
mangosteen	stomach neoplasms
steak	lymphatic sarcoma
porphyra	gastro-esophageal reflux
japanese plum	pattern baldness
raw food	age-related memory disorders
whole grain cereals	postural syncopes
pretzel	food borne diseases
foenumgraecum	heart attacks
horsemeat	cancer of the colon
topical ginger	anthrax
pecan	virus infections
oolong	oncornavirus
dried fruits	stomach neoplasm
crowberry	cardiogenic syncopes
shellfish	benign essential tremor
turkey meat	age-related osteoporoses
dessert	esophageal cancers
gravy	plasma-cell myeloma
emblica officinalis	insulin-dependent diabetes mellitus 1
high-phytate foods	acute fulminating multiple sclerosis
horsebean	cervical migraine syndrome
carrot	acute autoimmune neuropathies
phytonutrient-rich food	galactokinase deficiency disease
cooked carrots	colicky pain
leaf lettuce	manic disorders
carbonated water	diabetes mellitus complication
egg	esophageal hernia
narrow-leaved plantain	palsy
contamination meat	widespread chronic pain
common olive tree	hiatus hernias
sweet marjoram	autosomal recessive juvenile parkinson disease 2
spice turmeric	tor-driven diseases
yerba mates	lewy body parkinson's disease
purine-rich plant	colitis
olive oil	kidney failures
citrus medicas	acute monoblastic leukemia
salt-free diet	transitional meningioma
juglan	craniocerebral traumas
flaked coconut	hypoascorbemia
narrow leaved plantain	esophageal cancers
cocoa	herpesvirus
true nut	milk sugar intolerance
toxic plants	sleep disorders
preserved food	dementia
pithecellobium	radiating pain
ketchup	myalgia
filbert	brain vascular accident
organ meats	diabetic autonomic neuropathies
cocoa powder	fibroid tumor
pork	vulva cancers
carica	breast malignant neoplasms
iv vitamin	semantic memory disorder
find pork	heart decompensation
nitrate-rich vegetables	cancer of the vulva
dietary supplements	sunburn
papaver	myocardial infarctions
acer	pulmonary cancer
almond milk	venereal wart
medicago sativa	malignant tumor of breast
leafy vegetables	non hodgkins lymphoma
mealtime	pancreas neoplasms
lemon trees	cancer of thyroid
drinking milk	epilepsy
amorpha	sudden onset diabetes mellitus
anchovy	peripheral autoimmune demyelinating disease
fresh basil	infantile botulism
no noni	virus diseases
anise seed	social anxiety disorders
wild bananas	leucocythemia
carbonated waters	stokes-adams syncope
skim milk	cluster headaches
cocoa plant	epithelioid sarcoma
olive oils	polymyositide
citrus limon	diabetic neuropathy
individual food	low-grade b-cell malignancy
cocos nuciferas	protein deficiency
plum tree	nonalcoholic fatty livers
ribe	gastric neoplasm
cocoa plants	tick bites
lavender	autosomal recessive parkinsonism
popular fruits	disorders of initiating and maintaining sleep
soy protein	cancer of thyroid
zedoary zedoaria	hepatitis e
red meats	meningioma
dried food	autoimmune disorders
gui zhi	osteoporosis
snack food	norwalk like viruses
tumeric	burn
tofu	oncovirinae
cooking oil	infertility
kombucha tea	metastasis
biometal	hansens disease
brazil nut tree	benign neoplasms
thymus vulgari	lewy body parkinson's disease
petroselinum crispum	spinal cord disease
açai berries	toxico-infectious botulism
goji berry	fibromyalgia fibromyositis syndrome
cucumis melo	neoplasm metastasis
triticum turgidum	sneeze
pasta	exanthem
refined olive	lens opacities
silybum marianums	cognitive impairment
soy beans	well-differentiated lymphocytic lymphomas
sweet basils	viral infection
noni fruit	galactokinase deficiency disease
flounder	deaf-mutism
ready-to-eat meal	diabetes mellitus complications
eating eggs	male breast neoplasm
almond butter	degenerative disease
rice	fibromyositis-fibromyalgia syndrome
raw tomatoes	essential tremors
almond tree	orthostatic headaches
atropa belladonnas	diabetes-related complications
solanum dulcamaras	human t cell leukemia virus type iii
citrus paradisi	relapse
carica papayas	rabies viruses
marjoram plants	tonsil cancer
low vitamin	low grade lymphoma
majorana hortensis	posterior compartment low back pain
popcorn	aura
cilantro	monocytic leukemia
cumin	fights cancer
hickory nuts	crohns disease
fresh meat	fibrocystic breast disease
shorten	rectal tumor
eating broccoli	sick headache
food companies	type 1 diabetes mellitus
pickled foods	small noncleaved cell lymphoma
taking vitamin	foodborne botulisms
agaricaceae	disk degradation
food supplements	cancer of lung
crocus sativus	diabetes mellitus complication
fennel seeds	acute monoblastic leukemia
olive family	severe mental disorders
jalapeno	arterial fatty streak
plum trees	psychosis
black sapotes	influenza
chamomile	deep vein thromboses
health food	small noncleaved-cell lymphoma
trace mineral	chronic b lymphocytic leukemia
tarragon	insomnia disorder
tulsi tea	bechterew's disease
camomile	pustulosis palmaris et plantaris
not-necessarily-so-healthy foods	foreign bodies
saint john wort	bladder cancer
maize oil	myalgia
nutriceutical	varicose vein
roselle	genital wart
wild celery	hypermelanose
saffron	ankylosing spondylitis
carbonated mineral water	heart failure
real chocolate	phlebothrombosis
juiced broccoli	male sub-fertility
english walnuts	foodborne diseases
rubus idaeus	polyp
sweetening agents	cva (cerebrovascular accident)
dietary fats	venous thrombosis
decaffeinated tea	nonhodgkins lymphoma
potato	cardiovascular conditions
chinese cassias	germinoblastic sarcomas
hypericum	monocular blindness
zea mays	osteoarthrosis deformans
cashew	endometrioma
spicy food	animal virus
plant embryos	diabetes complication
macadamia nut	constrictive bronchiolitis
chamomile tea	chronic fatigue syndrome
cannabis indicas	juvenile parkinson disease
milkshake	neurological condition
legume pods	disk degeneration
ovary	early onset parkinson disease autosomal recessive
pleurotus ostreatus	ketosis prone diabetes mellitus
spinach	light headedness
morel	stomach neoplasms
ocimum basilicum	microcystic meningiomas
chicken meat	pleomorphic lymphoma
daily nut	pill rolling tremors
olea europaea	periorbital headaches
sardine	fatty liver disease
artichoke	paludism
crataegus	secretory meningioma
drink tea	plasmodium infections
rosehip	cancer of the breast
citrus aurantium	disrupted in b-cell malignancy
chinese cassia	protein deficiency
new candy	tumorigenesis
ale	childhood onset obesity
little meat	treat cancer
swordfish	hemicrania migraines
ground flax	drug habituation
cooked tomatoes	post traumatic osteoporosis
soy cheeses	burning pains
squash plant	cervical neoplasms
worldwide fruit	occipital region traumas
lens culinaris	infectious diseases
alcoholic beverage	human mammary neoplasms
ginger	ruptured appendicitis
delonix	blv
prunis communis	urinary tract infections
mentha x piperita	occipital traumas
anacardium occidentale	coronary heart disease
trigonella foenum-graecums	thermal hypesthesia
pine nuts	low backache
inadequate fruit	pancreatitis
tea leaves	craniocerebral injury
poroporo	autosomal dominant. juvenile parkinson disease
vodka	ph1-negative myeloid leukemias
regular carrots	headache disorder
carthamus tinctorius	headache disorder
food poisoning	guam form of amyotrophic lateral sclerosis
dried plums	sleep wake disorders
poultry	disseminated sclerosis
blossom	gum disease
vaccinium bracteatums	growth hormone receptor defect
handling food	cognitive retention disorder
cannabis	fatigue
lens plant	parkinson disease
black walnut	hepatitis
own vitamin	cancer of the testes
beetroot	thermal hypesthesias
piper methysticums	cryptogenic epilepsies
breakfast times	osteoporosis
chamomile oils	kidney disease
sea food	acute myeloid leukemia
psidium guajavas	zoonotic infection
pistachio nut trees	aphthous ulcers
octopus	adolescent obesity
ocimum sanctum	mild neurocognitive disorder
food coloring	deep-venous thrombosis
cereal grains	motor seizures
pease	carotid sinus syncopes
algarrobo	utp-hexose-1-phosphate uridylyltransferase deficiency disease
soy yogurt	parkinsonian syndromes
catfish	ulcerative colitis
cheese	fibrous meningioma
frequent meals	dehydration
plant zygotes	neoplasm metastases
linseed	varice
common olive trees	abdominal pain
little saffron	fetal iodine deficiency disorder
jam	e-b virus
olive trees	reticulum cell sarcoma
retail meat	primary fibromyalgias
juglans regia	unilateral headaches
crunch berries	neurologic degenerative disease
fagopyrum esculentum	malignant primary brain tumors
healthiest beverage	genital warts
sustenance	non-alcoholic fatty liver disease
apple juice	burning pains
goiaba	familial dementias
sea-food	arrythmia
canned foods	burkitt lymphoma virus
ginger ale	deep vein thrombosis
contaminated meat	intermediate grade lymphoma
soy bean	neurologic degenerative diseases
crataegus monogyna	lyme disease
chinook salmon	spinal meningiomas
zingiber officinales	higher cancer
food and drug administration	atherogenesis
bhang	disk degeneration
ocimum basilicums	chicken virus
romaine lettuce	bacterial vaginitis
kaffir lime	carsickness
plant capsules	microcystic meningiomas
tepary bean	small noncleaved-cell lymphoma
soft drinks	poultry viruses
ready-prepared food	atrial fibrillations
beverage	sliding esophageal hernias
cappari	memory losses
star anises	histamine cephalgia
crab apples	microcephaly
syzygium aromaticum	massive tremors
watermelon	chronic insomnia
caper	small-cell lymphomas
kawa kawas	age-related maculopathies
allium porrum	prediabetic states
green tea	legal blindness
holy basil	periadenitis mucosa necrotica recurrens
pudding	wheat allergy
callerya	drop attacks
japanese plums	reticuloendotheliosis virus
colorful foods	heart diseases
happy meal	darkness tremors
green peppers	v-cjd (variant-creutzfeldt-jakob disease)
granny smith apples	malignant epithelial tumor
longevity legumes	non-b hepatitis epidemic non-a
processed meat	ischemic heart disease
gum acacia	psoriase
cuminum cyminum	sneeze
taraxacum officinale	myeloma-multiple
conventional food	growth hormone receptor deficiency
energy drink	mixed lymphocytic-histiocytic lymphomas
indian gooseberry	granulomatous enteritis
kohlrabi	light headedness
neu5gc-rich food	uterine cervical neoplasms
ilex paraguarienses	chronic fatigue-fibromyalgia syndrome
vaccinium macrocarpons	vaginal cancer
eggnog	fibrositis
prenatal vitamins	endometriose
grapefruit	perioral tremors
morinda	renal insufficiencies
areca nuts	familial parkinson disease
citrus bergamia	gastro-esophageal reflux
energy drinks	pancreas neoplasms
herbal teas	autoimmune disease
scrambled eggs	abdominal pain
dairy product	pruritis
poultry product	endometriose
garden radish	epileptic seizure
bertholletia excelsa	blv
texturized vegetable proteins	mixed-cell lymphoma
fatty meal	torsion fracture
black rice	experimental parkinson diseases
breakfast cereal	infectious disease
citrus x paradisi	atrophy
pecan tree	mixed lymphomas
color	elevated cholesterols
soy bean curd	lou gehrig's disease
cream cheese	iritis
mother cells	reticuloendotheliosis virus
candy bar	pancreatic neoplasms
safflower	malignant lymphoma
earl grey tea	arterial dysfunction
low meat	hernia
pistacia vera	psoriase
hummus	paralysis
pizza	substance addiction
soy milk	iddm
laciniate nightshades	cancer-causing herpesvirus
vegetable proteins	endometrial neoplasms
black walnuts	paraesophageal hernia
anise tea	drug allergies
hot peppers	gastric ulcers
sweet marjorams	national cancer
breast milk	exudative bronchiolitides
unfertilized eggs	periodontal disease
lemon grass	diverticulum
concord grape	uterine fibromas
wheat bran	vaginal neoplasm
curcuma zedoarias	infectious mononucleosis virus
fabaceae	experimental parkinsonisms
monosodium glutamate	bladder cancer
drinking tea	renal neoplasm
guava	paraesophageal hernia
rise	back pain
poisonous plants	e-b virus
rye	epstein barr virus
healthiest snack	idiopathic intracranial hypertension
antioxidant-rich foods	manic states
baking chocolate	galactosemia 2
crocus	varicose veins
big apples	dizzyness
atropa belladonna	galactose epimerase deficiency
corn oils	spindle-cell carcinoma
cacao	transitional meningiomas
dressing	non b hepatitis epidemic non a
baker's yeast	pancreas cancers
sugar maple	syncopal episodes
ilex paraguariensis	cataract
arugula	manic depressive psychoses
contaminated foods	diabetic neuralgias
raisin bran	apneas
applesauce	diffuse small cleaved-cell lymphoma
cannabis indica	neurologic degenerative disease
chamomile oil	transmissible dementia
common foxgloves	ms (multiple sclerosis)
veal	male breast cancer
fenugreek seeds	benign prostatic hypertrophy
wolfberry	variant creutzfeldt-jakob disease
rubberplant	pyrose
pistachio nut tree	psychogenic parasitoses
proteus mirabilis	chronic fatigue-fibromyalgia syndrome
curcuma zedoaria	salmonella infection
black tea	wart
chocolate	causes cancers
belladonna	cancer of the mouth
cherry	small noncleaved-cell lymphomas
cola acuminata	cranial pains
lavandula	bovine lymphosarcoma
raw cranberries	early diagnosis of cancer
secale cereale	fibrositis
chinese cinnamons	intracranial cns disorder
dinner time	muscle pain
anti-inflammatory foods	infantile botulism
billion eggs	osteoarthrose
antioxidant vitamin	hemangioblastic meningioma
althea officinalis	anticancer
drink milk	reticuloendotheliosis virus
organic milk	tonsillar cancer
linum usitatissimum	hemicrania migraines
fuji apples	male breast tumors
origanum	manic-depressive psychosis
strawberry	cervix neoplasm
flammulina velutipes	gluten enteropathies
healthier meat	obesity in childhood
intoxicant	polyradiculoneuritide
fresh ginger	b-cell chronic lymphocytic leukemia
aloe	ponv
mustard plant	adenoviridae
collard	dairy product intolerance
prunus persica	cancer of endometrium
use sweeteners	pancreas cancer
sesame seeds	recrudescence
plant-based nutrients	ketosis-prone diabetes mellitus
cayenne pepper	ovary neoplasm
dinnertime	psoriasis
opium poppy	angioblastic meningiomas
stuff	type c oncovirus
nuclear power plants	stokes-adams syncopes
group foods	human mammary carcinoma
corylus	ph1 negative myeloid leukemia
last meal	orthostatic headaches
grecian foxgloves	forehead trauma
oolong tea	lav-htlv-iii
nut	fibrositis
myristica fragrans	diabetes mellitus complication
trompillo	mental deterioration
apple trees	cervical neoplasm
different fruits	prostatic adenoma
phaseolus	hepatic neoplasm
mustard	baldness
black beans	cancer-causing herpesvirus
diospyros digyna	peripheral autoimmune demyelinating disease
shiitake mushrooms	early diagnosis of cancer
barley coffee	reducing cancer
pomelo trees	tonsil cancers
rye bread	oncogenic virus
carya illinoenses	thyroid carcinoma
fortify milk	rectal tumor
plant embryo	mild neurocognitive disorders
sweeten	auditory seizures
tree nuts	nanism
oregano plant	stomach cancers
avoid peanuts	disk degradation
papaver somniferum	meningotheliomatous meningioma
foeniculum vulgares	bilateral headaches
greenery	ekbom delusory parasitosis
rooibos	cellulite
seville orange tree	human mammary carcinomas
squash plants	nontropical sprue
cereal	determination of death
poisonous plant	epithelial cancers
plaice	renal insufficiencies
yoghurt	malignant meningioma
rooibo	varicose vein
sugar	syncopal vertigo
cassia tree	renal insufficiencies
fava bean	vulva neoplasm
dietary plant protein	migratory pains
carduus marianus	testicular cancers
scallion	migratory pain
oyster mushrooms	exudative bronchiolitides
stevia rebaudiana	tonsil neoplasms
dietary sugars	non epileptic convulsion
adhatoda	gastro-oesophageal reflux
fermented cabbage	pancreas neoplasms
pimenta officinalis	foreign object
trace elements	long sleeper syndromes
fungus	liver injury
usda poultry	type c oncoviruses
plant arils	near-death experience
peanut	dental diseases
malus	long sleeper syndrome
emblica officinali	severe gh insensitivity
licorice root	degenerative intervertebral disks
dog rose berries	diffuse mixed cell lymphoma
raw foods	early detection of cancer
butter	delusory parasitosis
brussel sprout	myocardial ischemia
plant capsule	nbcc
sandwich	penis neoplasms
food colors	heart failure
clove	hypercapnia
jerusalem artichokes	diffuse mixed cell lymphoma
pomegranate fruit	plegia
euterpe oleracea mart.s	diverticulum
edible grain	manic states
daucus carota	hypercapnia
fig	central nervous system cysticercosis
no-calorie sweeteners	cancer of the kidney
nut bar	acquired immune deficiency syndrome virus
mussel	human mammary carcinoma
areca catechus	polyradiculoneuropathy
hamburger	urinary bladder neoplasm
mackerel	proliferative bronchiolitides
venison	juvenile onset diabetes
grape seeds	esophagus neoplasm
digitalis lanata	acquired immuno-deficiency syndrome
replenish nutrients	cjd (creutzfeldt-jakob disease)
coconut water	neurological condition
holy basil tea	high cholesterol levels
phaseolus vulgaris	dyslipoproteinemia
hordeum vulgare	sleep initiation and maintenance disorders
dietary protein	rectum cancers
philadelphia cream cheese	gnathostoma infection
brinjal	hemolytic jaundices
phyllanthus emblica	leucocythemia
peach	temporary amnesias
sweetener	reticulum-cell sarcomas
cranberry juice	iritide
salsa	colicky pain
shan yaos	stomach neoplasm
healthy nuts	galk deficiency
myristica fragran	infectious mononucleosis virus
crabapple	lymphocytic lymphoma
rheum tanguticum	lyme disease
dried peas	neoplasm metastases
whole foods	sudden onset diabetes mellitus
raw broccoli	zoonotic infectious disease
seltzer waters	carcinoma of endometrium
seltzer water	early onset parkinsonism
aspalathus	insomnia disorders
spaghetti	low backaches
hawthorn	cancer of prostate
melissa	gastric neoplasms
tomato	head injuries
crave chocolate	skin diseases
meal times	iritis
added nuts	symmetric diabetic proximal motor neuropathy
nonfat meal	cardiogenic syncope
dioscorea villosa	rodent ulcers
blueberry plants	thinness
sweetened cereal	acquired blindness
honeybush tea	food-borne diseases
wheat	polyradiculoneuropathy
fat foods	atypical diffuse small lymphoid lymphoma
chocolate pudding	sick headache
thousand foods	intracranial cns disorder
nutritional yeast	ulcer
seafood	malignant primary brain tumors
amomum cardamomums	udp-galactose-4-epimerase deficiency
new vitamin	pernicious vomiting of pregnancy
kola nut	rabies
good soybeans	occipital region trauma
food supplementations	atopic disease
english plantain	prostatic intraepithelial neoplasms
nonus	cva (cerebrovascular accident)
origanum majorana	ocular headache
cinnamomum trees	kidney insufficiency
fennel	nephrolith
coconut milk	plegia
malus domestica	hansen disease
celery root	early onset parkinson disease autosomal recessive
carya	myocardial failure
citrullus	low-grade b-cell malignancy
kiwi	central obesities
larder	acute confusional migraine
no meat	constipation
animal-based foods	human papilloma viruses
soymilk	small cell lymphoma
copaifera	heart failure
endive	neurocysticercose
jalapeno pepper	galactosemia 2
java plum trees	tumor
dioscorea opposita	breast fibrocystic changes
sweet orange	bewilderment
marjoram plant	lymphocytic lymphomas
aspartame	olfaction disorder
horse beans	spontaneous abortion
nutraceutical	metabolic acidoses
saint johns wort	occipital trauma
dried apricots	dysosmia
nut bars	age related maculopathy
trace element	sliding hiatal hernias
red lentils	anxiety disorder
persimmon	renal insufficiencies
cider vinegar	ciguatera
deli meats	low-grade lymphomas
morning meals	subacute spongiform encephalopathies
goji berry plant	renal failure
iceberg lettuce	pruritus
zucchini	starvation
ground beef	food-borne disease
hemp plant	pruritis
melissa officinalis	lymphadenopathy associated virus
cassia fistulas	transmissible dementia
betel nut	endometrium carcinoma
lemon	cirrhosis
pea families	penis neoplasms
sugar-sweetened beverages	cephalalgia
whiting	lymphocytic leukemia
oat	cow disease
shiitake	breast cystic disease
lemongrass	cerebrovascular accidents
syrup	laron type dwarfism i
dietary supplementations	clonic seizure
dinner	psoriasis
silken tofu	central nervous system degenerative diseases
whole grain	papillary meningioma
pureed apples	hhv-4
prunus dulcis	gorlin-goltz syndrome
fed beef	testicular tumors
cannabis sativas	psammomatous meningioma
carob	disc degradations
illicium verums	premenstrual syndromes
portulaca	persistent atrial fibrillations
hibiscus cannabinus	periadenitis mucosa necrotica recurrens
alpine strawberries	spondylarthritis ankylopoietica
consumed chocolate	ovarian neoplasms
ground meat	exanthem
artificial sweeteners	crohn disease
mentha	post-ictal confusion
healthiest apple	ruptured appendicitis
mastic tree	atopic diseases
hashish	postoperative vomiting
convenience food	familial creutzfeldt-jakob disease
drink	basal cell carcinomas
garcinia mangostana	short sleeper syndromes
acer saccharum	graves disease
radicchio	mental deteriorations
added sweeteners	tick bite
digitalis	tonsil neoplasms
morinda citrifolia	diabetic amyotrophies
calendula officinali	rabies
roasted almonds	rectum cancers
kidney beans	pulmonary neoplasm
family vegetables	renal insufficiencies
chewing fruit	tumor virus
ceylon cinnamon	gale deficiencies
erythroxylon	memory deficit
lemon balm	chicken embryo lethal orphan virus
emphasize plant	headache syndrome
citrus aurantiifolia	ciguatera poisonings
currant	influenza in humans
soybean	meningiomatose
triticum vulgare	nonalcoholic fatty livers
bread	cervical migraine syndrome
paella	atherosclerose
undercooked meat	auditory seizures
assai palm berry	cot deaths
betel	wound botulism
barberry	hypertension
acaí berries	hiccup
bacon	drop attack
morning meal	testicular neoplasm
machaerium	posterior fossa meningiomas
citrus aurantiums	prion protein disease
kale	common bile duct gall stones
thymus plant	oral cancer
nut butters	pancreas cancers
feather meal	parkinsons disease
cultivated oat	hypoxemia
aloe vera	atherosclerosis
plant aril	diabetes-related complications
alfalfa sprout	porcine endogenous retroviruses
cannabis sativa	sprain
cardamom	cancer of tonsil
cardamon	hypospadia
plantain	cervical neoplasms
cassia cinnamon	pulmonary neoplasm
sushi	migraine variant
amomum cardamomum	diabetic autonomic neuropathies
soy	goiter
chile pepper	amyloidose
plum	aortic aneurysms
avocado	lung inflammation
pinto bean	high blood pressure
stevia	gassers syndrome
wild yams	intention tremor
goji berry plants	utp hexose 1 phosphate uridylyltransferase deficiency disease
dinner times	galactosemia 2
sugar water	stokes adams syncope
fatty foods	hemorrhage
grilled meat	myocardial ischemias
citronella	zoonosis
eating meat	primary gh resistance
high fructose maize syrup	airsickness
lycium chinense	premenstrual syndromes
bertholletia	muscle tremor
red pepper	colorectal cancers
guacamole	prostatic neoplasms
candy	sore throats
chilli peppers	tussive syncopes
prettiest fruit	inflammatory disease
higher vegetable	regional enteritis
blueberry plant	microcystic meningiomas
chicken salad	oncogenesis
whale meat	t virus
plantago	fibrocystic changes of breast
bell pepper	htlv-iii
tepary beans	diffuse myofascial pain syndrome
milk proteins	paroxysmal atrial fibrillations
illicium	gastro-oesophageal reflux
coca	infectious mononucleosis viruses
kava kavas	cancer of the bone
cinnamomum aromaticum	drug allergy
food company	renal insufficiencies
adhatoda vasica	human t cell leukemia virus type iii
processed foods	generalized seizure
berberis	fibromyositis-fibromyalgia syndromes
apricot	adolescent gynecomastia
beet greens	symptom cluster
broccoli raab	biliary calculi
walnut	intermediate-grade lymphomas
wisconsin milk	impaired sensation
coco	diabetic autonomic neuropathies
emphasizes vegetables	presyncope
maple	lichen rubra planus
oreo	cluster headache syndrome
colophospermum	eye diseases
salad	bladder tumors
fruit juices	darkness tremor
mangifera indica	hyperemesis gravidarum
herbal tea	preventable cancers
soy beverages	hypospadia
grouper	pancreatic neoplasm
dairy yogurt	hyperventilation syncope
dried pomegranate	spindle-cell carcinomas
study lavender	human mammary carcinomas
mushroom	serious disease
alcohol	utp hexose 1 phosphate uridylyltransferase deficiency
hickory tree	superficial head injuries
almond trees	social anhedonias
raphanus sativus	drug abuse
alfalfa sprouts	delusory parasitosis
osmanthus tea	familial dementia
rice milk	chronic disease
veggie	colic
low-sodium diet	malignant tumor of breast
probiotic	auditory seizures
placenta	central nervous system degenerative diseases
chocolate bars	human t lymphotropic virus type iii
roughage	mixed small and large cell lymphoma
nutrient-dense foods	bovine lymphosarcomas
eupatorium rebaudianums	hyperventilation syncope
confection	unilateral headaches
seed	hypolactasia
cocoanut	burkitt's lymphoma virus
kangaroo meat	burkitt lymphoma virus
warm milk	tussive syncope
allspice	testis neoplasm
raw meat	ph1-negative myeloid leukemias
eating nuts	regional ileitis
prunus amygdalus	uterine neoplasm
elephant garlic	lung inflammations
white wine	water borne hepatitis
eugenia caryophyllata	autistic disorders
carbonated beverage	spiral fractures
boiled eggs	olfactory seizures
split peas	pus
raisin	cancer of the uterine cervix
flower	lung cancer
nut butter	creutzfeldt jacob disease
canned fruit	senile plaque
chanterelle	acute myeloid leukemia
woodland strawberry	bilateral sciaticas
golden raisins	urinary bladder neoplasms
acai berry	persistent tremors
brassica	bechterew's disease
tangerine tree	head pain
cupcake	influenza
sparkling waters	diabetes-related complication
include flaxseed	intervertebral disc degenerations
petroselinum	neurodegenerative disorder
domestic fowl	semirhythmic tremor
buttermilk	monocytic leukemia
lemon balm tea	fibroatheromatous plaques
amla	male pattern alopecia
vaccinium virgatum	cancer of uterus
kawa	urticaria
triticum	diabetic mononeuropathies
flammulina	intracranial cns disorder
reindeer meat	memory losses
tomato juice	uterine leiomyoma
durum wheats	germinoblastic sarcoma
eugenia aromatica	senile osteoporoses
mustard plants	spinal cord disorders
chewing gum	pulmonary embolism
laciniate nightshade	galactose-1-phosphate uridylyltransferase deficiencies
syzygium	ph1-negative myelogenous leukemias
flesh foods	testicular tumors
preserved foods	barretts esophagus
animal food	bacterial infection
garlic sauce	social anxiety disorder
blueberry	posterior fossa meningiomas
ribes nigrum	atrophy
tangerine trees	dims (disorders of initiating and maintaining sleep)
dangerous plants	diffuse mixed small and large cell lymphoma
sweet almonds	posterior fossa meningiomas
cassia	wound botulism
chewed coca	mucous colitides
prebiotic	cerebral convexity meningiomas
trace minerals	disrupted in b-cell malignancy
red rice	gallstone
bt corn	familial tremors
pisum sativum	diffuse mixed cell lymphoma
trigonella	limb tremor
kava	small noncleaved-cell lymphomas
rhubarb	clear cell meningioma
vitamin pills	peripheral artery diseases
hypericum perforatums	fibroatheromatous plaque
raphanus raphanistrum	laron dwarfism
century plant	schizoaffective disorder
sweet potatoes	enzootic bovine leukoses
rheum officinale	salmonellosis
foxglove	endometriosis
snack	schizophrenic disorder
multivitamin	generalized spasms
soy beverage	gastroenteritis
sunflower seeds	fibroid uterus
citrus medica	bewilderment
oryza	carcinogenesis
know nuts	schizophrenic disorder
individual candy	head injuries
cola	age-related maculopathy
solanum laciniatum	acquired immunodeficiency syndrome
sweet foods	foreign objects
corn sugar	malignant brain neoplasms
honey	secretory meningioma
fagopyrum	chronic insomnia
diospyros digynas	intraventricular meningioma
cocos nucifera	somatotropin (acromegaly) hypersecretion syndromes
four nuts	left-sided heart failure
club soda	somatosensory seizure
diabetic diets	insulin dependent diabetes mellitus
vitis vinifera	age related maculopathy
white pepper	chronic fatigue syndrome
breakfast cereals	bechterews disease
adding blueberries	pediatric cancers
theobroma cacao	mixed lymphomas
grape juice	situational syncope
persea	alzheimer’s disease
incorporates cloves	lyssa
lemon tree	bovine leukemias
arecas	essential tremors
chinese rhubarb	micturition syncopes
turnip	cancer of the esophagus
weekly meat	galactose-1-phosphate uridylyltransferase deficiencies
white mallows	autoimmune condition
yogurt	drug allergy
soy cheese	jakob creutzfeldt syndrome
bean sprouts	muscle spasm
cherry plum tree	sleep disorders
piper methysticum	short sleeper syndromes
vegetable protein	breast diseases
stevia rebaudianas	tonsillar cancers
animal-based vitamin	blood clots
cayenne	mouth cancers
raspberry	undifferentiated carcinoma
curried tofu	common cancer
target vitamin	ph1-negative myelogenous leukemia
red peppers	atopic disease
hot sauce	type c oncoviruses
lettuce	apnea
vaccinium macrocarpon	intraventricular meningioma
yolk	uterine neoplasms
drug administration united states food	deglutitional syncopes
national meat	left sided heart failure
carbonated mineral waters	allergic reactions
mentha spicatas	rete testis tumor
vegetable juice	penis neoplasms
dried apple	urinary tract infection
dark chocolate	malignant epithelial neoplasms
tap water	myelomatosis
açai berry	chronic obstructive airway disease
plantago seed	thyroid cancers
frozen broccoli	hay fever
cymbopogon nardus	germinoblastic sarcomas
ficus	diabetes-related complication
hemp	action tremor
mustard oil	tussive syncope
cinnamomum zeylanicum	effort syncope
flax	crohn disease
colocasia	memory loss
unfiltered coffee	weight reductions
sea bilberries	marie-struempell disease
cruciferous vegetable	joint pains
soy bean curds	malignant brain neoplasm
soda waters	polyradiculoneuritide
guibourtia	age related maculopathy
peanut butter	gestational diabetes
green pepper	broken bones
golden glow	vestibular seizure
breakfast time	pediatric obesity
norus	human influenzas
flavourer	mechanical low back pain
bean sprout	atopic disease
infant formulas	unilateral headaches
safflower oils	involuntary quiver
narrow-leaved plantains	coronary diseases
rowanberry	coronary heart disease
dress	dental diseases
granny smith	stomach ulcers
processing meat	gnathostomiase
corn	male sterility
onion	diabetic mononeuropathy
illicium verum	ekbom psychogenic parasitoses
sausage	cancer of the uterus
nori	deaf mutism
coconut oil	pulmonary thromboembolisms
mangifera indicas	back pain without radiation
milk chocolate	somatotropin hypersecretion syndrome (acromegaly)
pickled vegetables	diffuse undifferentiated lymphoma
offal	manic depressive psychoses
common foxglove	thyroid neoplasm
sweet pepper	motion sickness
carica papaya	intermittent tremors
acacia tree	wart viruses
yeast rice	convulsion
cortland	pulmonary cancer
dried fruit	syndrome
healthier foods	head injuries
common bean plants	menstrual pain
ultra-processed food	burkitt herpesvirus
allium sativum	campylobacter infections
texturized soy proteins	mental deterioration
macadamia nuts	foreign object
experience food	infantile obesity
assai palm berries	high grade lymphoma
licorice	respiratory infections
foeniculum	halitosis
burrito	wheat hypersensitivity
kola nuts	bladder neoplasms
sesame	bipolar disorders
mandarin orange trees	migraine
bitter orange tree	tubal abortion
sour orange tree	lymphadenopathy associated virus
rutabaga	peanut hypersensitivity
cauliflower	ischemic heart disease
tuna	reduced sensation
poppy seed	pus
anti-inflammatory plant	eczema
herr	male sub-fertility
powdered ginger	exanthema
cultivated oats	ocular headaches
unhealthy food	diabetes-related complication
weed	allergic reaction
chili peppers	pill rolling tremor
herb	intermediate-grade lymphoma
grecian foxglove	textiloma
oats	back ache
triticum turgidum subsp. durum	manic state
solanum	renal neoplasms
peach trees	spongiform encephalopathies
lime	colorectal tumors
leek	gastric cancers
plant-based foods	brain disorders
sunfish	uterine cervical neoplasm
da huang	brain diseases
fruit-shaped marshmallows	stomach ulcers
broad beans	superficial head injuries
ice creams	norwalk like viruses