
neurotoxin	meat consumption
vegetables	bok choy
beet juice	nitrate
daily diet	vegetarian
saturated fat	beef
sorbitol	sugar
diverticulosis	disease
vegetarians	iodine
multiple sclerosis	beta
american diet	meat
diseases	heart disease
leading killer	parkinson
galactose	milk
who	leaner
drug	aspirin
infants	breastmilk
rose hips	fruits
bone	eaten
herbal teas	fine
caldwell esselstyn	practitioner pioneer
cancer	insulin-like growth
fluoride	poison
salmonella	poultry
ham	pork
colon	butyrate
greens	fat soluble
nutrition	diet
milk	muscles
who	insulin
colic	pain
kids	muscles
nuts	health-promoting
cortisol	stress hormone
vegetable	bell peppers
workers	diseases
death	choline
casein	milk protein
maspin	tumor suppressor gene
fruits	eaten
pcbs	fish consumption
breast cancer survival	flax seeds
table sugar	fructose
supplements	supplement
saturated fat	cheese
odds	label
sweet potatoes	health-promoting
disability	diet
plant-based diets	beta
gmo soy	gmo
calorie	junk
greens	health-promoting
neurotoxins	bmaa
vegetables	potato chips
teens	pizza
longevity	legumes
breast tumors	estrogen receptor
rhubarb	roots
chickens	fatty
antioxidants	dandelion
who	pritikin
atherosclerosis	disease
fruit juice	fiber
grains	seeds
anthocyanins	pigments
omega	bioequivalent
infection	hen
mediterranean diet	diet high
diet	vegetables
who	lactose
streak	baby
pecans	chart
herbal tea	hibiscus
candy	phytonutrient-rich
who	happier
babies	breast fed
snacks	fruit
gluten	fine
iron	pro-oxidant
raw	bell peppers
scurvy	vitamin c
exercise	stress
exercise	medicine
berries	stars
culture	turmeric
specialty	lifestyle medicine
diet	heart-healthy
heart disease	choice
estrogens	milk
smoke	fat soluble
baking soda	sodium bicarbonate
tea	fine
american diet	dairy products
balsamic vinegar	product
brain	fat
tomatoes	water
osteoarthritis	degenerative joint
omega	flax seeds
drink	tea
tea	matcha
abdominal aortic aneurysms	ballooning bulges
antioxidants	plant
milk	skim milk
antioxidants	boiling
birds	chemicals
gluten sensitivity	disease
stones	calcium
diverticulosis	fiber
symptoms	heartburn
salad	fat soluble
odds	suffering
salmon	fish consumption
diet	acid producing
signal	igf
fruit	fine
dietary guidelines	fine
peas	roots
flight	apple juice
citrus fruits	acidic
plant protein	protein
fiber	potassium
disease	exercise
nitrites	preservatives
label	lying
putrescine	chemical
infants	fatter
campylobacter	poultry
tomatoes	billion dollar
taking statins	suffering
strokes	killer
lutein	carotenoid phytonutrient
heart	beating
signal	butyrate
nettle tea	mineral
pesticides	fruits
mediterranean diet	sodium intake
salicylic acid	defense
beans	fruit
mushrooms	vitamin d
milk	trigger
tea	beans
garbanzo bean	legume
aging	disease
drugs	exposures
supplements	bit
vision loss	cataracts
liver cancer	diseases
diverticula	outpouchings
green leafies	roots
cells	dying
dietary supplements	multibillion
urine	acidic
floppy ears	cute
healthiest nuts	pecans
coffee	beans
breastfed infants	diet
fruits	roots
osteoarthritis	rose hips
phytonutrients	fat soluble