
dates	phytonutrients
kiwifruit	folate
who	mgus
u.s	mrsa
u.s	chronic
saturated fat	egg
spice	health benefits
who	prostate enlargement
white women	iron deficiency
dried fruits	preservative
who	eaten
diet	bumped
kids	fatty streaks
fernandez	received
ice	zero
boost	brain damage
vegetarians	thrown
greens	myrosinase
who	apoe
dementia	shot
yogurt	butterfat
vegetables	cancer risk
smoothies	amla
kiwifruits	antioxidants
poultry workers	excess
who	heart attacks
water	zero
who	breast cancer
mom	vitamin d
intake	tobacco
american women	pesticides
gallbladder	gallstones
casomorphin	opioid
sea vegetables	anti-cancer properties
sardines	sardines
hypersensitivity	signs
turmeric	received