
cartilage	inflammation
inflammatory arthritis	crystallization
fever	strep
narrowed arteries	cholesterol
dna mutations	carcinogen
production	cadmium exposure
penis	phthalate
inflammation	muscle cell
calcium intake	dairy consumption
meat	vitamin a
fatty liver	excess
gluten	symptoms
tumor	hpv
coli exposure	bacteria
reaction	seafood
smoke	frying
asthma	breathing
cancer risk	carcinogens
inflammation	kangaroo meat
brain	atherosclerosis
liver toxicity	broccoli
dementia	vitamin
giantism	excess
fecal pathogens	noroviruses
dna mutations	smoking
oxidative stress	pesticide
epidemic	obesity
meat	ddt