
animal protein	cancer
inflammation	depressive symptoms
milk	uric acid
milk	acne
cigarette smoking	lung cancer
liquid smoke	dna
titanium dioxide	inflammation
exercise	free radicals
dental x-rays	brain tumors
fish	heterocyclic amines
cholesterol	blood
cholesterol	atherosclerosis
plants	antioxidants
nitrosamines	cancers
cholesterol	erectile dysfunction
bacteria	bladder infection
platelets	blood clots
x-rays	brain tumors
paratuberculosis	type 1 diabetes
neu5gc	inflammation
eggs	inflammation
raisins	blood sugar
muscle damage	pain
risk	vitamin d
arteries	strokes
blood	insulin resistance
animal foods	inflammation
muscles	cancer
bacteria	plaque
homocysteine	brain damage
celery	nitrites
fish	insulin
carcinogens	dna
insulin resistance	prediabetes
carbohydrates	insulin
inflammation	depression
obesity	diabetes
cell phones	cancer
animal products	inflammation
folate	depression
sucralose	insulin
fat	gut