
oxidant stress	antioxidant
non-alcoholic fatty liver disease	obesity
amyloidosis	leprosy
inflammation	gluten
oils	steam
brain damage	mercury
diabetes	insulin resistance
health	obesity
chickens	genetic manipulation
carcinogens	cooking meat
adverse effects	aspartame
fish	food poisoning
carbohydrates	acrylamide
inflammation	animal protein
premature puberty	chemical pollutants
breast cancer	cooked meat
phytonutrients	plant
dna damage	radiation
skin cancer	arsenic
pathogens	noroviruses
carcinogens	cooking
pain	inflammation
inflammatory response	animal protein
irritation	cetuximab
toxicity	broccoli
inflammation	domesticated animal
ph	short-chain fatty acids
smoke	frying
phytonutrients	nutrient synergy
oxidation	metabolism
brains	mercury
copd	tobacco
toxins	cooking
uric acid	meat
production	cadmium
arteries	cholesterol
inflammation	dioxin
meat	arachidonic acid
cancer growth	exercise
muscle tremors	cooked meat
inflammation	muscle
dementia	vitamin b12
fish	chicken
mutations	carcinogen
allergies	tick bites
cancers	arsenic
egg nutrition center	american egg board
sexual dysfunction	drugs
viruses	manure
plaque	bacteria
mutations	smoking
dna damage	free radicals