
girls	french fries
iron	diabetes
poultry	liver
meat	inflammation
carbs	pancreatic cancer
vomiting	morning sickness
blood	depression
xenoestrogens	birth defects
production	ulcerative colitis
pain	osteoarthritis
animal products	weight gain
sperm counts	processed meat
fertility	saturated fat
cholesterol	nonalcoholic fatty liver
stomach cancer	salt
amino acids	aging
sperm counts	meat
virus	obesity
meats	cancers
farm	blood
pain	rheumatoid arthritis
animal foods	coronary heart disease
deformities	rickets
chronic gum disease	sexual dysfunction
pancreatic cancer	beef
death	nut
pcbs	fats
plant foods	prevotella
chronic diseases	inflammation
processed meat	cancer
bpa	cardiovascular disease
death	galactose
sugar	pancreatic cancer
carbohydrates	prevotella
eggs	diabetes
dental x-rays	brain tumors
saturated fat	semen
side effects	drugs
cholesterol	gestational diabetes
poultry workers	wart
allergy	antibodies
adolescence	breast cancer
symptoms	wheat
doughnuts	prostate cancer
parasites	meat
barbecue	birth weight
food poisoning	sprouts
operations	mrsa
arteries	cardiac disease
protein	anxiety
girls	animal protein
coffee	suicide
vegetable oil	pancreatic cancer
cancers	alcohol
pickled vegetables	multiple myeloma
meat	weight gain
foodborne illness	pork
biomarker	cancer
bladder infections	breast cancer
headaches	aspartame
pumpkin seeds	breast cancer
dna damage	treatment
beverage	infertility
fat	bacteroides
mortality	poultry
brain	memory
symptoms	diabetes